Task ID,Job Name,Start Time,Period,Execution Time,Deadline Time,Priority,Finish Time,Least Finish Time,Time Budget,Idle Task Time,Smart Machine ID,Task Completion Status,Total Number of Tasks for Smart Machine X,Utilization Capacity of Smart Machine (%),Total Workload Capacity Required for Smart Machine X
Task 1,Job 0,5,8,2,9,0,7,14,7,2,1,1,1,35,19
Task 1,Job 1,10,7,1,9,0,11,19,8,1,4,0,1,35,9
Task 2,Job 0,4,9,3,9,1,7,13,6,3,3,1,2,35,10
Task 2,Job 1,9,5,1,9,0,10,18,8,1,1,2,2,35,5
Task 3,Job 0,10,5,2,8,0,12,18,6,2,2,2,3,36,7
Task 3,Job 1,15,4,4,8,0,19,23,4,4,3,0,3,36,5
Task 4,Job 0,3,6,1,11,1,4,14,10,1,2,1,4,38,11
Task 4,Job 1,8,7,3,10,1,11,18,7,3,2,1,4,38,5
Task 5,Job 0,9,5,1,11,0,10,20,10,1,3,1,5,39,16
Task 5,Job 1,14,10,2,11,0,16,25,9,2,4,0,5,39,3
Task 6,Job 0,10,9,1,6,0,11,16,5,1,4,1,6,40,11
Task 6,Job 1,15,4,2,11,0,17,26,9,2,2,2,6,40,6
Task 7,Job 0,1,7,3,12,1,4,13,9,3,2,1,7,41,8
Task 7,Job 1,6,7,3,11,0,9,17,8,3,1,2,7,41,10
Task 8,Job 0,2,7,1,7,0,3,9,6,1,1,1,8,42,11
Task 8,Job 1,7,9,4,9,0,11,16,5,4,3,1,8,42,6
Task 9,Job 0,8,10,2,7,0,10,15,5,2,4,2,9,43,7
Task 9,Job 1,13,7,4,11,1,17,24,7,4,1,0,9,43,19
Task 10,Job 0,2,6,1,10,0,3,12,9,1,2,1,10,43,9
Task 10,Job 1,7,6,2,12,0,9,19,10,2,4,1,10,43,18
Task 11,Job 0,5,8,1,8,0,6,13,7,1,3,2,11,45,4
Task 11,Job 1,10,7,3,9,0,13,19,6,3,1,0,11,45,19
Task 12,Job 0,2,5,4,7,1,6,9,3,4,4,1,12,46,15
Task 12,Job 1,7,10,1,6,0,8,13,5,1,2,2,12,46,13
Task 13,Job 0,1,8,4,12,0,5,13,8,4,4,0,13,46,9
Task 13,Job 1,6,4,3,6,0,9,12,3,3,1,2,13,46,3
Task 14,Job 0,4,8,2,9,0,6,13,7,2,2,0,14,48,7
Task 14,Job 1,9,5,3,10,1,12,19,7,3,1,1,14,48,2
Task 15,Job 0,2,10,4,8,1,6,10,4,4,2,1,15,49,20
Task 15,Job 1,7,5,2,12,1,9,19,10,2,4,1,15,49,15
Task 16,Job 0,5,10,4,7,0,9,12,3,4,1,1,16,49,8
Task 16,Job 1,10,4,4,8,0,14,18,4,4,4,1,16,49,14
Task 17,Job 0,8,10,3,12,0,11,20,9,3,2,2,17,50,2
Task 17,Job 1,13,4,1,9,0,14,22,8,1,3,2,17,50,19
Task 18,Job 0,2,9,4,7,0,6,9,3,4,2,2,18,52,13
Task 18,Job 1,7,6,3,12,1,10,19,9,3,3,1,18,52,15
Task 19,Job 0,1,10,2,12,0,3,13,10,2,1,1,19,52,7
Task 19,Job 1,6,4,3,12,0,9,18,9,3,2,1,19,52,5
Task 20,Job 0,1,8,4,9,0,5,10,5,4,4,2,20,53,12
Task 20,Job 1,6,6,3,10,0,9,16,7,3,2,0,20,53,3
Task 21,Job 0,2,7,3,6,0,5,8,3,3,4,1,21,54,3
Task 21,Job 1,7,5,2,7,0,9,14,5,2,2,1,21,54,2
Task 22,Job 0,1,9,3,12,0,4,13,9,3,1,1,22,56,20
Task 22,Job 1,6,6,4,6,0,10,12,2,4,1,0,22,56,3
Task 23,Job 0,5,7,2,8,1,7,13,6,2,3,1,23,57,9
Task 23,Job 1,10,7,1,8,0,11,18,7,1,2,1,23,57,12
Task 24,Job 0,2,6,4,8,1,6,10,4,4,1,2,24,57,12
Task 24,Job 1,7,10,1,7,0,8,14,6,1,3,1,24,57,2
Task 25,Job 0,7,7,1,6,0,8,13,5,1,2,0,25,59,6
Task 25,Job 1,12,9,3,6,1,15,18,3,3,1,2,25,59,15
Task 26,Job 0,4,6,4,8,0,8,12,4,4,1,1,26,60,15
Task 26,Job 1,9,9,3,8,0,12,17,5,3,2,0,26,60,18
Task 27,Job 0,10,6,2,11,0,12,21,9,2,4,0,27,61,17
Task 27,Job 1,15,7,3,7,1,18,22,4,3,2,1,27,61,19
Task 28,Job 0,3,6,2,9,0,5,12,7,2,4,1,28,62,12
Task 28,Job 1,8,8,1,9,1,9,17,8,1,3,0,28,62,3
Task 29,Job 0,10,4,1,8,0,11,18,7,1,3,0,29,63,2
Task 29,Job 1,15,9,4,7,0,19,22,3,4,1,0,29,63,10
Task 30,Job 0,8,9,3,6,1,11,14,3,3,1,0,30,63,19
Task 30,Job 1,13,9,3,8,0,16,21,5,3,2,2,30,63,10
Task 31,Job 0,1,6,1,11,0,2,12,10,1,1,2,31,65,20
Task 31,Job 1,6,8,3,11,1,9,17,8,3,4,2,31,65,19
Task 32,Job 0,1,6,2,8,0,3,9,6,2,2,1,32,65,19
Task 32,Job 1,6,10,1,12,0,7,18,11,1,1,2,32,65,10
Task 33,Job 0,7,4,1,9,0,8,16,8,1,4,0,33,66,7
Task 33,Job 1,12,4,2,7,1,14,19,5,2,1,1,33,66,12
Task 34,Job 0,7,8,2,10,0,9,17,8,2,1,1,34,68,8
Task 34,Job 1,12,7,1,9,0,13,21,8,1,4,0,34,68,4
Task 35,Job 0,2,6,2,6,1,4,8,4,2,4,0,35,69,5
Task 35,Job 1,7,9,3,8,0,10,15,5,3,4,1,35,69,19
Task 36,Job 0,3,6,4,8,0,7,11,4,4,1,2,36,69,13
Task 36,Job 1,8,4,4,6,0,12,14,2,4,4,1,36,69,4
Task 37,Job 0,8,9,3,10,1,11,18,7,3,3,2,37,71,20
Task 37,Job 1,13,5,2,10,0,15,23,8,2,3,1,37,71,6
Task 38,Job 0,8,8,2,8,0,10,16,6,2,1,2,38,71,3
Task 38,Job 1,13,4,1,10,0,14,23,9,1,3,0,38,71,4
Task 39,Job 0,7,7,1,11,0,8,18,10,1,1,0,39,73,18
Task 39,Job 1,12,6,3,8,1,15,20,5,3,3,0,39,73,6
Task 40,Job 0,5,10,2,7,0,7,12,5,2,3,0,40,73,19
Task 40,Job 1,10,8,4,6,1,14,16,2,4,1,2,40,73,14
Task 41,Job 0,2,5,1,6,0,3,8,5,1,1,2,41,74,15
Task 41,Job 1,7,4,4,6,0,11,13,2,4,4,0,41,74,4
Task 42,Job 0,5,9,1,6,0,6,11,5,1,3,1,42,75,17
Task 42,Job 1,10,5,4,12,0,14,22,8,4,1,2,42,75,20
Task 43,Job 0,2,10,3,6,0,5,8,3,3,1,0,43,76,7
Task 43,Job 1,7,6,2,9,0,9,16,7,2,2,0,43,76,3
Task 44,Job 0,9,7,4,11,0,13,20,7,4,4,0,44,78,6
Task 44,Job 1,14,6,1,7,0,15,21,6,1,4,2,44,78,15
Task 45,Job 0,9,10,1,6,0,10,15,5,1,4,2,45,78,8
Task 45,Job 1,14,10,2,9,1,16,23,7,2,3,2,45,78,4
Task 46,Job 0,8,7,1,11,0,9,19,10,1,1,1,46,79,15
Task 46,Job 1,13,9,3,11,0,16,24,8,3,2,1,46,79,11
Task 47,Job 0,1,9,2,7,1,3,8,5,2,2,0,47,81,7
Task 47,Job 1,6,7,1,6,0,7,12,5,1,4,1,47,81,13
Task 48,Job 0,6,8,1,7,0,7,13,6,1,3,1,48,82,6
Task 48,Job 1,11,9,3,10,0,14,21,7,3,1,0,48,82,8
Task 49,Job 0,4,6,3,6,0,7,10,3,3,3,2,49,83,7
Task 49,Job 1,9,9,4,8,1,13,17,4,4,2,2,49,83,2
Task 50,Job 0,10,8,1,7,0,11,17,6,1,2,1,50,84,15
Task 50,Job 1,15,10,4,9,0,19,24,5,4,1,0,50,84,11
Task 51,Job 0,9,4,2,11,1,11,20,9,2,2,1,51,84,17
Task 51,Job 1,14,9,4,6,0,18,20,2,4,3,1,51,84,9
Task 52,Job 0,10,7,4,8,0,14,18,4,4,1,0,52,86,2
Task 52,Job 1,15,8,4,12,1,19,27,8,4,4,2,52,86,4
Task 53,Job 0,7,5,2,11,1,9,18,9,2,4,0,53,86,18
Task 53,Job 1,12,5,3,12,0,15,24,9,3,2,1,53,86,19
Task 54,Job 0,3,7,3,9,1,6,12,6,3,4,0,54,88,2
Task 54,Job 1,8,10,1,6,0,9,14,5,1,2,2,54,88,18
Task 55,Job 0,8,5,1,11,0,9,19,10,1,2,1,55,88,15
Task 55,Job 1,13,8,1,9,0,14,22,8,1,3,1,55,88,3
Task 56,Job 0,9,9,1,9,1,10,18,8,1,1,2,56,89,16
Task 56,Job 1,14,5,3,12,0,17,26,9,3,3,1,56,89,3
Task 57,Job 0,1,5,3,7,0,4,8,4,3,2,2,57,90,18
Task 57,Job 1,6,4,3,12,1,9,18,9,3,1,2,57,90,18
Task 58,Job 0,4,7,3,11,0,7,15,8,3,3,1,58,91,13
Task 58,Job 1,9,9,4,9,0,13,18,5,4,4,1,58,91,14
Task 59,Job 0,1,8,4,10,1,5,11,6,4,4,2,59,92,10
Task 59,Job 1,6,6,4,9,0,10,15,5,4,2,1,59,92,3
Task 60,Job 0,1,9,2,8,0,3,9,6,2,3,2,60,93,14
Task 60,Job 1,6,6,4,9,0,10,15,5,4,4,0,60,93,2
Task 61,Job 0,1,6,2,11,0,3,12,9,2,4,2,61,94,18
Task 61,Job 1,6,4,3,8,0,9,14,5,3,3,1,61,94,18
Task 62,Job 0,1,10,3,10,0,4,11,7,3,1,0,62,95,16
Task 62,Job 1,6,9,3,12,0,9,18,9,3,4,0,62,95,17
Task 63,Job 0,7,5,3,7,1,10,14,4,3,4,2,63,97,10
Task 63,Job 1,12,8,1,10,1,13,22,9,1,2,2,63,97,17
Task 64,Job 0,3,10,4,11,1,7,14,7,4,2,1,64,98,10
Task 64,Job 1,8,10,3,10,0,11,18,7,3,4,2,64,98,18
Task 65,Job 0,2,4,2,11,0,4,13,9,2,2,0,65,99,19
Task 65,Job 1,7,5,3,10,0,10,17,7,3,3,0,65,99,9
Task 66,Job 0,6,10,2,10,0,8,16,8,2,1,1,66,99,5
Task 66,Job 1,11,4,2,11,0,13,22,9,2,1,0,66,99,13
Task 67,Job 0,5,7,3,10,0,8,15,7,3,2,2,67,101,20
Task 67,Job 1,10,9,4,9,0,14,19,5,4,2,2,67,101,13
Task 68,Job 0,10,4,3,10,0,13,20,7,3,2,0,68,102,2
Task 68,Job 1,15,10,2,10,0,17,25,8,2,4,0,68,102,10
Task 69,Job 0,1,9,1,8,1,2,9,7,1,2,1,69,103,19
Task 69,Job 1,6,4,2,8,0,8,14,6,2,4,1,69,103,11
Task 70,Job 0,5,9,3,9,0,8,14,6,3,3,2,70,103,8
Task 70,Job 1,10,9,2,8,0,12,18,6,2,2,0,70,103,8
Task 71,Job 0,6,10,4,10,1,10,16,6,4,1,2,71,104,5
Task 71,Job 1,11,9,3,6,0,14,17,3,3,3,2,71,104,4
Task 72,Job 0,3,7,2,9,1,5,12,7,2,4,1,72,105,16
Task 72,Job 1,8,9,2,12,0,10,20,10,2,3,1,72,105,17
Task 73,Job 0,4,10,3,6,0,7,10,3,3,2,0,73,106,12
Task 73,Job 1,9,4,2,9,0,11,18,7,2,1,0,73,106,5
Task 74,Job 0,1,5,2,12,0,3,13,10,2,2,2,74,108,5
Task 74,Job 1,6,10,1,7,0,7,13,6,1,1,1,74,108,18
Task 75,Job 0,10,5,4,12,1,14,22,8,4,1,0,75,108,11
Task 75,Job 1,15,5,4,8,0,19,23,4,4,1,2,75,108,3
Task 76,Job 0,1,7,4,6,0,5,7,2,4,4,0,76,109,11
Task 76,Job 1,6,4,2,11,0,8,17,9,2,2,2,76,109,2
Task 77,Job 0,1,9,2,9,0,3,10,7,2,1,1,77,110,6
Task 77,Job 1,6,7,3,11,0,9,17,8,3,2,1,77,110,17
Task 78,Job 0,4,6,2,12,0,6,16,10,2,1,1,78,112,10
Task 78,Job 1,9,9,4,9,0,13,18,5,4,1,0,78,112,5
Task 79,Job 0,3,4,2,9,0,5,12,7,2,3,2,79,112,12
Task 79,Job 1,8,6,2,10,0,10,18,8,2,1,0,79,112,11
Task 80,Job 0,4,6,4,12,0,8,16,8,4,1,0,80,114,18
Task 80,Job 1,9,6,2,6,1,11,15,4,2,4,1,80,114,5
Task 81,Job 0,4,4,4,8,0,8,12,4,4,2,2,81,114,3
Task 81,Job 1,9,8,3,10,1,12,19,7,3,2,2,81,114,19
Task 82,Job 0,1,7,1,10,0,2,11,9,1,4,2,82,116,20
Task 82,Job 1,6,4,2,7,1,8,13,5,2,3,0,82,116,4
Task 83,Job 0,3,10,2,12,0,5,15,10,2,3,0,83,116,2
Task 83,Job 1,8,5,4,7,0,12,15,3,4,2,0,83,116,2
Task 84,Job 0,5,6,3,12,0,8,17,9,3,3,2,84,118,2
Task 84,Job 1,10,7,3,10,0,13,20,7,3,1,0,84,118,6
Task 85,Job 0,2,4,2,6,0,4,8,4,2,2,0,85,119,17
Task 85,Job 1,7,8,2,7,1,9,14,5,2,1,0,85,119,5
Task 86,Job 0,3,6,1,8,0,4,11,7,1,4,1,86,120,7
Task 86,Job 1,8,7,3,11,0,11,19,8,3,1,2,86,120,14
Task 87,Job 0,5,9,1,12,0,6,17,11,1,2,0,87,120,4
Task 87,Job 1,10,4,2,7,1,12,17,5,2,3,0,87,120,4
Task 88,Job 0,8,9,1,9,0,9,17,8,1,2,2,88,121,8
Task 88,Job 1,13,7,2,7,0,15,20,5,2,2,0,88,121,15
Task 89,Job 0,5,10,2,12,0,7,17,10,2,3,0,89,122,8
Task 89,Job 1,10,9,4,9,0,14,19,5,4,1,0,89,122,13
Task 90,Job 0,7,6,3,10,0,10,17,7,3,3,2,90,123,3
Task 90,Job 1,12,10,4,7,0,16,19,3,4,2,0,90,123,15
Task 91,Job 0,8,5,2,7,0,10,15,5,2,1,0,91,125,3
Task 91,Job 1,13,10,4,9,1,17,22,5,4,1,2,91,125,8
Task 92,Job 0,8,7,4,10,0,12,18,6,4,2,1,92,125,9
Task 92,Job 1,13,9,1,8,0,14,21,7,1,4,0,92,125,3
Task 93,Job 0,3,5,3,8,0,6,11,5,3,1,1,93,126,14
Task 93,Job 1,8,6,2,9,0,10,17,7,2,1,1,93,126,19
Task 94,Job 0,6,10,2,10,0,8,16,8,2,1,1,94,127,5
Task 94,Job 1,11,9,4,11,1,15,22,7,4,1,1,94,127,17
Task 95,Job 0,6,10,3,10,0,9,16,7,3,3,2,95,129,17
Task 95,Job 1,11,7,2,12,0,13,23,10,2,4,1,95,129,15
Task 96,Job 0,6,6,3,9,0,9,15,6,3,1,2,96,129,11
Task 96,Job 1,11,4,2,12,0,13,23,10,2,4,0,96,129,8
Task 97,Job 0,5,5,3,10,0,8,15,7,3,4,2,97,130,15
Task 97,Job 1,10,5,4,6,0,14,16,2,4,1,0,97,130,9
Task 98,Job 0,9,9,4,10,0,13,19,6,4,3,2,98,131,2
Task 98,Job 1,14,4,1,6,0,15,20,5,1,1,1,98,131,17
Task 99,Job 0,8,10,4,12,0,12,20,8,4,2,0,99,133,20
Task 99,Job 1,13,7,4,11,0,17,24,7,4,4,2,99,133,18
Task 100,Job 0,4,4,4,9,0,8,13,5,4,1,2,100,134,6
Task 100,Job 1,9,6,4,12,0,13,21,8,4,2,0,100,134,18
Task 101,Job 0,4,4,3,6,0,7,10,3,3,2,1,101,134,7
Task 101,Job 1,9,8,4,6,0,13,15,2,4,2,2,101,134,10
Task 102,Job 0,9,4,1,12,0,10,21,11,1,2,0,102,135,17
Task 102,Job 1,14,8,4,11,0,18,25,7,4,2,0,102,135,13
Task 103,Job 0,9,7,3,10,0,12,19,7,3,1,0,103,137,17
Task 103,Job 1,14,10,4,12,0,18,26,8,4,2,1,103,137,12
Task 104,Job 0,4,5,1,10,0,5,14,9,1,3,2,104,137,10
Task 104,Job 1,9,5,3,9,0,12,18,6,3,1,2,104,137,4
Task 105,Job 0,7,4,1,10,0,8,17,9,1,3,2,105,139,19
Task 105,Job 1,12,10,4,9,1,16,21,5,4,1,1,105,139,17
Task 106,Job 0,5,10,4,12,0,9,17,8,4,2,2,106,140,18
Task 106,Job 1,10,7,4,11,0,14,21,7,4,1,1,106,140,9
Task 107,Job 0,6,8,2,6,0,8,12,4,2,1,2,107,140,17
Task 107,Job 1,11,5,4,8,0,15,19,4,4,4,2,107,140,19
Task 108,Job 0,4,6,4,8,0,8,12,4,4,4,0,108,141,19
Task 108,Job 1,9,6,4,11,0,13,20,7,4,4,1,108,141,15
Task 109,Job 0,8,7,1,7,0,9,15,6,1,1,0,109,142,19
Task 109,Job 1,13,7,3,10,0,16,23,7,3,4,2,109,142,3
Task 110,Job 0,7,8,3,10,1,10,17,7,3,3,0,110,143,17
Task 110,Job 1,12,9,2,12,0,14,24,10,2,1,1,110,143,2
Task 111,Job 0,2,4,1,10,0,3,12,9,1,3,2,111,144,17
Task 111,Job 1,7,7,2,12,0,9,19,10,2,4,2,111,144,9
Task 112,Job 0,10,7,3,12,0,13,22,9,3,1,0,112,145,5
Task 112,Job 1,15,7,2,12,0,17,27,10,2,3,0,112,145,15
Task 113,Job 0,3,9,4,10,1,7,13,6,4,3,0,113,147,2
Task 113,Job 1,8,9,4,9,0,12,17,5,4,1,2,113,147,4
Task 114,Job 0,7,6,2,12,1,9,19,10,2,4,0,114,147,17
Task 114,Job 1,12,4,4,8,0,16,20,4,4,3,0,114,147,20
Task 115,Job 0,5,4,2,10,0,7,15,8,2,4,0,115,149,19
Task 115,Job 1,10,8,1,7,0,11,17,6,1,2,2,115,149,2
Task 116,Job 0,7,5,3,8,0,10,15,5,3,3,0,116,149,6
Task 116,Job 1,12,7,1,12,1,13,24,11,1,3,0,116,149,12
Task 117,Job 0,5,9,3,8,1,8,13,5,3,3,0,117,150,6
Task 117,Job 1,10,8,3,10,0,13,20,7,3,1,2,117,150,3
Task 118,Job 0,8,7,3,9,0,11,17,6,3,3,1,118,151,9
Task 118,Job 1,13,5,1,11,1,14,24,10,1,4,2,118,151,5
Task 119,Job 0,9,10,4,8,1,13,17,4,4,4,2,119,153,17
Task 119,Job 1,14,8,3,12,1,17,26,9,3,4,2,119,153,17
Task 120,Job 0,9,6,4,11,0,13,20,7,4,1,1,120,153,18
Task 120,Job 1,14,8,3,10,0,17,24,7,3,2,1,120,153,12
Task 121,Job 0,9,10,4,10,0,13,19,6,4,4,0,121,154,10
Task 121,Job 1,14,5,4,6,0,18,20,2,4,1,0,121,154,18
Task 122,Job 0,1,5,2,9,0,3,10,7,2,4,2,122,155,12
Task 122,Job 1,6,9,2,7,0,8,13,5,2,2,1,122,155,7
Task 123,Job 0,8,6,4,6,0,12,14,2,4,3,0,123,157,14
Task 123,Job 1,13,6,3,8,0,16,21,5,3,1,0,123,157,20
Task 124,Job 0,7,10,4,9,0,11,16,5,4,1,2,124,157,11
Task 124,Job 1,12,8,1,12,0,13,24,11,1,1,2,124,157,14
Task 125,Job 0,5,7,3,7,0,8,12,4,3,1,0,125,159,20
Task 125,Job 1,10,8,1,10,0,11,20,9,1,3,1,125,159,15
Task 126,Job 0,8,9,3,8,0,11,16,5,3,1,0,126,159,2
Task 126,Job 1,13,7,4,9,0,17,22,5,4,4,1,126,159,11
Task 127,Job 0,3,4,3,8,0,6,11,5,3,3,1,127,161,10
Task 127,Job 1,8,10,1,9,0,9,17,8,1,4,1,127,161,8
Task 128,Job 0,6,9,4,12,1,10,18,8,4,3,0,128,162,9
Task 128,Job 1,11,10,2,7,0,13,18,5,2,3,1,128,162,12
Task 129,Job 0,6,4,1,6,1,7,12,5,1,3,2,129,163,19
Task 129,Job 1,11,6,3,10,0,14,21,7,3,2,1,129,163,2
Task 130,Job 0,8,6,1,7,0,9,15,6,1,4,2,130,164,18
Task 130,Job 1,13,10,1,6,0,14,19,5,1,1,1,130,164,11
Task 131,Job 0,10,4,1,7,0,11,17,6,1,1,0,131,165,2
Task 131,Job 1,15,7,2,9,1,17,24,7,2,2,2,131,165,13
Task 132,Job 0,8,9,3,10,0,11,18,7,3,1,1,132,166,12
Task 132,Job 1,13,5,3,9,1,16,22,6,3,3,0,132,166,2
Task 133,Job 0,9,9,1,7,1,10,16,6,1,1,1,133,167,7
Task 133,Job 1,14,6,4,9,0,18,23,5,4,2,1,133,167,2
Task 134,Job 0,9,6,3,11,0,12,20,8,3,2,2,134,168,14
Task 134,Job 1,14,10,4,7,1,18,21,3,4,1,0,134,168,9
Task 135,Job 0,8,6,3,11,0,11,19,8,3,1,1,135,168,15
Task 135,Job 1,13,6,3,10,0,16,23,7,3,3,2,135,168,18
Task 136,Job 0,7,9,2,12,0,9,19,10,2,1,1,136,170,18
Task 136,Job 1,12,8,2,11,0,14,23,9,2,1,1,136,170,6
Task 137,Job 0,2,9,3,10,0,5,12,7,3,4,1,137,170,12
Task 137,Job 1,7,4,1,8,0,8,15,7,1,3,0,137,170,17
Task 138,Job 0,2,5,1,6,0,3,8,5,1,1,1,138,172,2
Task 138,Job 1,7,8,2,11,0,9,18,9,2,1,1,138,172,3
Task 139,Job 0,9,10,4,7,1,13,16,3,4,1,0,139,173,10
Task 139,Job 1,14,4,3,7,1,17,21,4,3,3,2,139,173,20
Task 140,Job 0,3,4,4,12,0,7,15,8,4,1,0,140,173,9
Task 140,Job 1,8,6,1,12,0,9,20,11,1,3,1,140,173,15
Task 141,Job 0,10,8,4,11,1,14,21,7,4,3,0,141,175,19
Task 141,Job 1,15,5,4,6,1,19,21,2,4,3,1,141,175,16
Task 142,Job 0,9,6,3,11,0,12,20,8,3,4,1,142,175,5
Task 142,Job 1,14,7,2,7,0,16,21,5,2,3,1,142,175,18
Task 143,Job 0,7,9,2,6,0,9,13,4,2,4,2,143,177,12
Task 143,Job 1,12,6,3,11,0,15,23,8,3,2,1,143,177,4
Task 144,Job 0,6,8,1,12,1,7,18,11,1,1,0,144,177,13
Task 144,Job 1,11,10,1,10,0,12,21,9,1,1,2,144,177,3
Task 145,Job 0,1,4,4,9,1,5,10,5,4,2,0,145,179,12
Task 145,Job 1,6,6,2,11,0,8,17,9,2,3,2,145,179,13
Task 146,Job 0,8,5,3,7,0,11,15,4,3,2,2,146,179,14
Task 146,Job 1,13,6,4,9,1,17,22,5,4,2,0,146,179,18
Task 147,Job 0,10,9,4,12,0,14,22,8,4,2,1,147,181,17
Task 147,Job 1,15,6,3,10,1,18,25,7,3,3,0,147,181,8
Task 148,Job 0,5,5,1,11,1,6,16,10,1,2,2,148,181,10
Task 148,Job 1,10,5,1,6,1,11,16,5,1,4,2,148,181,10
Task 149,Job 0,10,4,3,9,0,13,19,6,3,3,0,149,183,2
Task 149,Job 1,15,4,1,6,1,16,21,5,1,4,0,149,183,14
Task 150,Job 0,6,8,3,9,0,9,15,6,3,4,0,150,184,11
Task 150,Job 1,11,8,1,12,0,12,23,11,1,1,1,150,184,3
Task 151,Job 0,9,5,3,12,0,12,21,9,3,4,0,151,184,12
Task 151,Job 1,14,8,4,10,1,18,24,6,4,1,1,151,184,14
Task 152,Job 0,1,10,3,11,0,4,12,8,3,1,2,152,186,20
Task 152,Job 1,6,4,1,10,0,7,16,9,1,2,1,152,186,3
Task 153,Job 0,4,7,3,12,0,7,16,9,3,2,2,153,186,20
Task 153,Job 1,9,5,3,7,0,12,16,4,3,4,2,153,186,18
Task 154,Job 0,7,6,4,7,1,11,14,3,4,1,0,154,187,18
Task 154,Job 1,12,5,4,11,0,16,23,7,4,3,2,154,187,3
Task 155,Job 0,4,4,2,9,1,6,13,7,2,1,0,155,188,16
Task 155,Job 1,9,7,3,10,0,12,19,7,3,2,0,155,188,6
Task 156,Job 0,4,9,3,6,0,7,10,3,3,1,1,156,189,6
Task 156,Job 1,9,8,3,11,0,12,20,8,3,2,2,156,189,16
Task 157,Job 0,7,7,4,12,0,11,19,8,4,2,0,157,190,7
Task 157,Job 1,12,6,3,10,0,15,22,7,3,2,1,157,190,5
Task 158,Job 0,4,5,4,8,0,8,12,4,4,2,1,158,191,9
Task 158,Job 1,9,9,4,10,1,13,19,6,4,2,0,158,191,4
Task 159,Job 0,1,5,2,7,1,3,8,5,2,4,0,159,193,18
Task 159,Job 1,6,7,2,8,0,8,14,6,2,4,0,159,193,16
Task 160,Job 0,6,7,2,10,0,8,16,8,2,2,0,160,194,19
Task 160,Job 1,11,10,4,11,1,15,22,7,4,2,1,160,194,13
Task 161,Job 0,7,5,3,6,0,10,13,3,3,4,1,161,195,8
Task 161,Job 1,12,4,2,9,1,14,21,7,2,3,2,161,195,2
Task 162,Job 0,5,7,4,9,0,9,14,5,4,2,2,162,195,2
Task 162,Job 1,10,5,1,11,0,11,21,10,1,2,1,162,195,14
Task 163,Job 0,5,7,3,11,0,8,16,8,3,2,0,163,197,4
Task 163,Job 1,10,6,3,11,0,13,21,8,3,4,0,163,197,16
Task 164,Job 0,9,4,2,7,0,11,16,5,2,4,0,164,198,20
Task 164,Job 1,14,8,1,10,0,15,24,9,1,1,1,164,198,3
Task 165,Job 0,6,5,4,9,0,10,15,5,4,3,0,165,199,15
Task 165,Job 1,11,10,1,12,0,12,23,11,1,3,0,165,199,10
Task 166,Job 0,4,7,4,12,0,8,16,8,4,2,1,166,200,20
Task 166,Job 1,9,4,2,12,0,11,21,10,2,3,2,166,200,16
Task 167,Job 0,9,8,1,6,0,10,15,5,1,2,2,167,200,11
Task 167,Job 1,14,5,3,8,0,17,22,5,3,3,0,167,200,17
Task 168,Job 0,10,9,3,6,0,13,16,3,3,3,2,168,201,7
Task 168,Job 1,15,5,4,7,1,19,22,3,4,1,2,168,201,17
Task 169,Job 0,6,9,1,6,0,7,12,5,1,2,1,169,203,12
Task 169,Job 1,11,4,2,12,0,13,23,10,2,2,2,169,203,2
Task 170,Job 0,6,10,4,7,0,10,13,3,4,4,0,170,204,17
Task 170,Job 1,11,10,2,12,0,13,23,10,2,3,1,170,204,2
Task 171,Job 0,10,6,2,9,0,12,19,7,2,4,1,171,205,15
Task 171,Job 1,15,6,2,11,1,17,26,9,2,4,0,171,205,4
Task 172,Job 0,10,5,4,12,0,14,22,8,4,3,1,172,205,13
Task 172,Job 1,15,5,2,12,0,17,27,10,2,4,0,172,205,17
Task 173,Job 0,3,5,4,6,0,7,9,2,4,1,2,173,207,10
Task 173,Job 1,8,9,1,6,0,9,14,5,1,3,2,173,207,7
Task 174,Job 0,3,10,3,8,0,6,11,5,3,3,1,174,207,14
Task 174,Job 1,8,8,1,7,1,9,15,6,1,3,0,174,207,16
Task 175,Job 0,1,8,4,9,0,5,10,5,4,1,2,175,209,7
Task 175,Job 1,6,10,1,10,0,7,16,9,1,1,1,175,209,4
Task 176,Job 0,8,6,3,11,0,11,19,8,3,1,0,176,210,7
Task 176,Job 1,13,6,2,12,1,15,25,10,2,3,2,176,210,13
Task 177,Job 0,4,7,3,10,0,7,14,7,3,2,2,177,211,13
Task 177,Job 1,9,10,1,8,1,10,17,7,1,2,1,177,211,9
Task 178,Job 0,3,8,2,9,0,5,12,7,2,4,1,178,212,18
Task 178,Job 1,8,7,1,8,0,9,16,7,1,1,2,178,212,12
Task 179,Job 0,10,7,4,11,0,14,21,7,4,1,2,179,213,14
Task 179,Job 1,15,8,1,9,1,16,24,8,1,3,1,179,213,19
Task 180,Job 0,1,8,1,9,1,2,10,8,1,4,1,180,214,10
Task 180,Job 1,6,9,4,12,0,10,18,8,4,2,1,180,214,11
Task 181,Job 0,9,9,2,9,1,11,18,7,2,2,2,181,214,7
Task 181,Job 1,14,10,3,10,0,17,24,7,3,2,1,181,214,6
Task 182,Job 0,4,9,2,9,1,6,13,7,2,1,0,182,216,15
Task 182,Job 1,9,10,3,11,0,12,20,8,3,4,2,182,216,8
Task 183,Job 0,10,8,1,6,0,11,16,5,1,4,2,183,217,10
Task 183,Job 1,15,8,3,12,0,18,27,9,3,3,2,183,217,7
Task 184,Job 0,4,9,3,11,1,7,15,8,3,4,1,184,218,2
Task 184,Job 1,9,7,4,10,0,13,19,6,4,4,1,184,218,13
Task 185,Job 0,8,9,2,9,1,10,17,7,2,3,2,185,218,20
Task 185,Job 1,13,6,4,6,0,17,19,2,4,2,2,185,218,18
Task 186,Job 0,1,7,1,6,0,2,7,5,1,1,0,186,219,5
Task 186,Job 1,6,5,1,9,1,7,15,8,1,3,1,186,219,9
Task 187,Job 0,2,10,4,9,0,6,11,5,4,3,1,187,221,14
Task 187,Job 1,7,7,4,12,0,11,19,8,4,2,2,187,221,7
Task 188,Job 0,9,4,3,9,0,12,18,6,3,3,2,188,221,19
Task 188,Job 1,14,5,3,9,0,17,23,6,3,4,1,188,221,20
Task 189,Job 0,4,5,2,6,0,6,10,4,2,2,1,189,223,4
Task 189,Job 1,9,4,4,6,0,13,15,2,4,4,1,189,223,3
Task 190,Job 0,9,6,1,8,1,10,17,7,1,3,2,190,223,10
Task 190,Job 1,14,5,1,9,1,15,23,8,1,3,0,190,223,19
Task 191,Job 0,4,5,1,11,0,5,15,10,1,1,0,191,224,18
Task 191,Job 1,9,7,3,9,1,12,18,6,3,1,1,191,224,15
Task 192,Job 0,1,8,3,6,1,4,7,3,3,3,0,192,226,12
Task 192,Job 1,6,8,2,8,0,8,14,6,2,1,1,192,226,20
Task 193,Job 0,10,5,3,10,1,13,20,7,3,2,2,193,226,10
Task 193,Job 1,15,6,2,6,1,17,21,4,2,4,1,193,226,9
Task 194,Job 0,10,10,2,12,0,12,22,10,2,2,2,194,227,4
Task 194,Job 1,15,6,2,7,0,17,22,5,2,1,0,194,227,10
Task 195,Job 0,6,4,1,8,0,7,14,7,1,4,1,195,229,12
Task 195,Job 1,11,7,4,11,0,15,22,7,4,2,1,195,229,15
Task 196,Job 0,9,8,2,7,0,11,16,5,2,2,0,196,229,12
Task 196,Job 1,14,6,3,6,1,17,20,3,3,3,1,196,229,2
Task 197,Job 0,7,6,1,7,0,8,14,6,1,3,2,197,231,6
Task 197,Job 1,12,8,4,8,0,16,20,4,4,3,1,197,231,20
Task 198,Job 0,7,5,3,6,1,10,13,3,3,4,1,198,231,8
Task 198,Job 1,12,6,1,8,1,13,20,7,1,4,1,198,231,7
Task 199,Job 0,7,5,4,8,0,11,15,4,4,2,2,199,232,3
Task 199,Job 1,12,5,3,10,0,15,22,7,3,2,1,199,232,19
Task 200,Job 0,4,4,3,7,1,7,11,4,3,1,1,200,234,13
Task 200,Job 1,9,4,2,12,1,11,21,10,2,1,2,200,234,11
Task 201,Job 0,1,9,4,6,0,5,7,2,4,4,2,201,235,4
Task 201,Job 1,6,8,1,7,1,7,13,6,1,3,0,201,235,12
Task 202,Job 0,2,10,4,11,0,6,13,7,4,4,2,202,235,17
Task 202,Job 1,7,4,1,12,0,8,19,11,1,4,2,202,235,5
Task 203,Job 0,3,6,4,7,1,7,10,3,4,2,2,203,236,17
Task 203,Job 1,8,6,3,7,1,11,15,4,3,1,0,203,236,17
Task 204,Job 0,8,6,4,9,1,12,17,5,4,3,2,204,237,18
Task 204,Job 1,13,9,3,6,1,16,19,3,3,3,2,204,237,5
Task 205,Job 0,3,5,4,6,0,7,9,2,4,3,2,205,238,10
Task 205,Job 1,8,4,4,9,0,12,17,5,4,3,2,205,238,18
Task 206,Job 0,2,7,3,12,0,5,14,9,3,1,0,206,240,6
Task 206,Job 1,7,5,2,12,0,9,19,10,2,1,2,206,240,4
Task 207,Job 0,4,10,4,7,0,8,11,3,4,2,2,207,241,18
Task 207,Job 1,9,6,2,7,0,11,16,5,2,3,1,207,241,2
Task 208,Job 0,6,7,4,11,0,10,17,7,4,3,2,208,241,19
Task 208,Job 1,11,6,2,7,1,13,18,5,2,3,2,208,241,3
Task 209,Job 0,3,10,3,12,0,6,15,9,3,1,0,209,242,5
Task 209,Job 1,8,9,3,9,0,11,17,6,3,4,1,209,242,8
Task 210,Job 0,3,5,3,7,0,6,10,4,3,3,1,210,244,20
Task 210,Job 1,8,5,4,12,0,12,20,8,4,1,2,210,244,13
Task 211,Job 0,2,4,3,7,0,5,9,4,3,4,2,211,244,8
Task 211,Job 1,7,6,4,7,1,11,14,3,4,3,0,211,244,8
Task 212,Job 0,5,9,3,8,1,8,13,5,3,1,0,212,246,10
Task 212,Job 1,10,6,2,10,1,12,20,8,2,2,1,212,246,16
Task 213,Job 0,4,5,3,11,0,7,15,8,3,3,1,213,247,14
Task 213,Job 1,9,6,3,12,0,12,21,9,3,3,1,213,247,11
Task 214,Job 0,10,6,4,11,0,14,21,7,4,4,0,214,247,19
Task 214,Job 1,15,8,4,9,0,19,24,5,4,4,1,214,247,10
Task 215,Job 0,8,6,4,10,0,12,18,6,4,2,0,215,248,17
Task 215,Job 1,13,9,4,6,0,17,19,2,4,3,2,215,248,11
Task 216,Job 0,6,5,2,12,0,8,18,10,2,3,2,216,249,12
Task 216,Job 1,11,9,4,10,0,15,21,6,4,1,0,216,249,7
Task 217,Job 0,2,6,3,10,0,5,12,7,3,1,1,217,251,12
Task 217,Job 1,7,6,1,10,1,8,17,9,1,2,1,217,251,6
Task 218,Job 0,2,5,4,10,0,6,12,6,4,3,1,218,251,4
Task 218,Job 1,7,6,1,6,0,8,13,5,1,1,0,218,251,20
Task 219,Job 0,9,8,3,11,0,12,20,8,3,4,0,219,252,6
Task 219,Job 1,14,10,2,12,1,16,26,10,2,1,1,219,252,18
Task 220,Job 0,7,9,1,7,0,8,14,6,1,3,2,220,254,14
Task 220,Job 1,12,10,1,9,0,13,21,8,1,1,1,220,254,4
Task 221,Job 0,2,8,4,12,0,6,14,8,4,3,2,221,255,18
Task 221,Job 1,7,10,1,10,0,8,17,9,1,1,1,221,255,13
Task 222,Job 0,7,5,3,12,0,10,19,9,3,2,2,222,256,15
Task 222,Job 1,12,7,3,10,0,15,22,7,3,3,0,222,256,10
Task 223,Job 0,2,10,2,8,0,4,10,6,2,4,1,223,256,13
Task 223,Job 1,7,8,1,7,1,8,14,6,1,2,0,223,256,8
Task 224,Job 0,10,4,1,6,0,11,16,5,1,4,2,224,258,3
Task 224,Job 1,15,10,2,6,0,17,21,4,2,2,1,224,258,4
Task 225,Job 0,3,5,3,11,1,6,14,8,3,1,1,225,258,8
Task 225,Job 1,8,7,2,9,0,10,17,7,2,3,0,225,258,9
Task 226,Job 0,6,7,2,12,0,8,18,10,2,2,2,226,260,4
Task 226,Job 1,11,7,2,10,0,13,21,8,2,4,2,226,260,14
Task 227,Job 0,10,6,3,10,0,13,20,7,3,4,1,227,260,8
Task 227,Job 1,15,10,3,11,0,18,26,8,3,1,1,227,260,10
Task 228,Job 0,7,10,2,6,1,9,13,4,2,3,1,228,261,7
Task 228,Job 1,12,8,3,9,1,15,21,6,3,4,0,228,261,11
Task 229,Job 0,8,7,2,8,1,10,16,6,2,2,1,229,263,17
Task 229,Job 1,13,7,2,9,0,15,22,7,2,3,1,229,263,19
Task 230,Job 0,9,7,4,12,1,13,21,8,4,1,2,230,263,8
Task 230,Job 1,14,5,3,10,0,17,24,7,3,2,0,230,263,8
Task 231,Job 0,9,6,4,8,0,13,17,4,4,2,2,231,264,19
Task 231,Job 1,14,9,4,6,1,18,20,2,4,1,1,231,264,5
Task 232,Job 0,8,6,3,8,0,11,16,5,3,1,0,232,265,18
Task 232,Job 1,13,5,2,9,0,15,22,7,2,4,1,232,265,2
Task 233,Job 0,3,9,3,6,0,6,9,3,3,2,0,233,267,5
Task 233,Job 1,8,5,3,7,0,11,15,4,3,3,1,233,267,4
Task 234,Job 0,8,8,4,6,0,12,14,2,4,1,0,234,267,20
Task 234,Job 1,13,8,2,8,0,15,21,6,2,3,0,234,267,18
Task 235,Job 0,4,4,3,6,1,7,10,3,3,4,0,235,268,4
Task 235,Job 1,9,8,2,12,1,11,21,10,2,2,1,235,268,5
Task 236,Job 0,9,8,4,6,0,13,15,2,4,4,1,236,270,13
Task 236,Job 1,14,9,4,7,0,18,21,3,4,4,1,236,270,13
Task 237,Job 0,9,5,1,9,0,10,18,8,1,4,1,237,270,9
Task 237,Job 1,14,5,2,7,0,16,21,5,2,3,0,237,270,4
Task 238,Job 0,4,7,2,6,0,6,10,4,2,2,1,238,271,7
Task 238,Job 1,9,6,1,9,0,10,18,8,1,1,1,238,271,12
Task 239,Job 0,2,4,2,11,0,4,13,9,2,2,1,239,273,13
Task 239,Job 1,7,10,1,10,1,8,17,9,1,1,0,239,273,2
Task 240,Job 0,7,10,3,9,1,10,16,6,3,1,0,240,274,6
Task 240,Job 1,12,4,3,8,0,15,20,5,3,2,2,240,274,12
Task 241,Job 0,1,7,3,7,1,4,8,4,3,4,1,241,274,13
Task 241,Job 1,6,8,1,10,0,7,16,9,1,3,2,241,274,15
Task 242,Job 0,10,6,4,7,1,14,17,3,4,1,2,242,275,16
Task 242,Job 1,15,7,4,12,1,19,27,8,4,1,1,242,275,8
Task 243,Job 0,6,6,1,6,0,7,12,5,1,4,2,243,276,13
Task 243,Job 1,11,9,2,10,0,13,21,8,2,1,1,243,276,10
Task 244,Job 0,2,5,4,11,0,6,13,7,4,1,0,244,277,10
Task 244,Job 1,7,9,3,7,0,10,14,4,3,1,2,244,277,8
Task 245,Job 0,4,9,1,6,1,5,10,5,1,2,1,245,278,8
Task 245,Job 1,9,9,3,9,0,12,18,6,3,1,2,245,278,20
Task 246,Job 0,3,5,4,7,0,7,10,3,4,2,0,246,279,15
Task 246,Job 1,8,4,3,11,0,11,19,8,3,1,2,246,279,12
Task 247,Job 0,1,7,1,10,0,2,11,9,1,4,2,247,280,10
Task 247,Job 1,6,7,2,10,0,8,16,8,2,4,2,247,280,6
Task 248,Job 0,6,10,4,8,0,10,14,4,4,3,0,248,281,18
Task 248,Job 1,11,7,4,6,1,15,17,2,4,3,1,248,281,18
Task 249,Job 0,7,6,4,11,1,11,18,7,4,2,2,249,282,19
Task 249,Job 1,12,9,1,6,0,13,18,5,1,2,0,249,282,17
Task 250,Job 0,7,6,4,8,1,11,15,4,4,3,1,250,283,7
Task 250,Job 1,12,5,2,12,1,14,24,10,2,1,0,250,283,11
Task 251,Job 0,10,7,2,6,1,12,16,4,2,3,1,251,284,9
Task 251,Job 1,15,8,4,12,1,19,27,8,4,4,0,251,284,15
Task 252,Job 0,6,5,2,10,0,8,16,8,2,1,0,252,285,19
Task 252,Job 1,11,8,4,6,0,15,17,2,4,2,1,252,285,4
Task 253,Job 0,6,4,1,8,0,7,14,7,1,3,1,253,287,12
Task 253,Job 1,11,5,4,9,0,15,20,5,4,1,1,253,287,5
Task 254,Job 0,9,8,2,11,1,11,20,9,2,2,2,254,287,10
Task 254,Job 1,14,10,2,8,0,16,22,6,2,3,0,254,287,3
Task 255,Job 0,1,9,3,10,0,4,11,7,3,2,0,255,289,9
Task 255,Job 1,6,8,3,9,0,9,15,6,3,3,1,255,289,17
Task 256,Job 0,3,8,2,7,1,5,10,5,2,1,1,256,289,4
Task 256,Job 1,8,8,3,9,0,11,17,6,3,2,0,256,289,9
Task 257,Job 0,3,7,3,7,0,6,10,4,3,4,2,257,290,13
Task 257,Job 1,8,7,2,11,0,10,19,9,2,4,0,257,290,4
Task 258,Job 0,4,8,1,12,0,5,16,11,1,1,0,258,292,5
Task 258,Job 1,9,6,1,11,0,10,20,10,1,3,2,258,292,15
Task 259,Job 0,9,6,3,11,0,12,20,8,3,1,0,259,292,9
Task 259,Job 1,14,7,1,11,1,15,25,10,1,4,2,259,292,3
Task 260,Job 0,7,10,3,9,0,10,16,6,3,4,1,260,293,7
Task 260,Job 1,12,8,1,6,0,13,18,5,1,2,0,260,293,6
Task 261,Job 0,3,9,2,11,1,5,14,9,2,3,2,261,295,10
Task 261,Job 1,8,8,3,6,0,11,14,3,3,1,0,261,295,18
Task 262,Job 0,5,6,1,6,0,6,11,5,1,1,0,262,296,13
Task 262,Job 1,10,6,3,9,1,13,19,6,3,3,0,262,296,5
Task 263,Job 0,3,10,3,10,1,6,13,7,3,2,0,263,296,15
Task 263,Job 1,8,5,2,7,0,10,15,5,2,4,2,263,296,11
Task 264,Job 0,10,8,4,10,0,14,20,6,4,3,0,264,298,12
Task 264,Job 1,15,9,1,7,1,16,22,6,1,1,1,264,298,5
Task 265,Job 0,8,7,4,6,0,12,14,2,4,4,0,265,299,19
Task 265,Job 1,13,10,3,9,0,16,22,6,3,4,2,265,299,6
Task 266,Job 0,1,9,1,12,0,2,13,11,1,1,2,266,300,17
Task 266,Job 1,6,8,1,10,0,7,16,9,1,1,1,266,300,16
Task 267,Job 0,9,5,4,10,0,13,19,6,4,4,2,267,300,19
Task 267,Job 1,14,7,1,10,1,15,24,9,1,2,2,267,300,18
Task 268,Job 0,3,8,2,9,0,5,12,7,2,4,1,268,302,6
Task 268,Job 1,8,4,4,11,0,12,19,7,4,4,0,268,302,9
Task 269,Job 0,5,5,1,9,1,6,14,8,1,3,0,269,303,13
Task 269,Job 1,10,4,1,9,0,11,19,8,1,2,0,269,303,8
Task 270,Job 0,3,9,1,8,0,4,11,7,1,4,2,270,303,3
Task 270,Job 1,8,10,1,11,0,9,19,10,1,3,0,270,303,18
Task 271,Job 0,6,5,1,10,0,7,16,9,1,1,1,271,304,7
Task 271,Job 1,11,9,4,11,1,15,22,7,4,4,0,271,304,19
Task 272,Job 0,10,6,1,6,1,11,16,5,1,2,0,272,305,2
Task 272,Job 1,15,7,2,11,0,17,26,9,2,4,0,272,305,5
Task 273,Job 0,10,4,2,12,0,12,22,10,2,1,0,273,306,4
Task 273,Job 1,15,10,1,6,0,16,21,5,1,3,1,273,306,16
Task 274,Job 0,1,10,2,11,0,3,12,9,2,2,0,274,308,13
Task 274,Job 1,6,8,4,7,1,10,13,3,4,2,0,274,308,11
Task 275,Job 0,5,5,2,11,1,7,16,9,2,1,0,275,308,8
Task 275,Job 1,10,5,4,7,0,14,17,3,4,4,0,275,308,8
Task 276,Job 0,10,10,1,8,0,11,18,7,1,4,1,276,310,5
Task 276,Job 1,15,6,4,8,0,19,23,4,4,1,2,276,310,12
Task 277,Job 0,9,9,3,8,1,12,17,5,3,4,0,277,311,6
Task 277,Job 1,14,7,2,12,1,16,26,10,2,1,0,277,311,12
Task 278,Job 0,1,6,3,8,0,4,9,5,3,2,2,278,311,20
Task 278,Job 1,6,10,3,11,0,9,17,8,3,1,1,278,311,6
Task 279,Job 0,2,7,3,12,0,5,14,9,3,4,1,279,312,5
Task 279,Job 1,7,5,2,9,0,9,16,7,2,3,0,279,312,20
Task 280,Job 0,9,10,2,9,1,11,18,7,2,1,0,280,313,15
Task 280,Job 1,14,4,1,9,0,15,23,8,1,1,1,280,313,12
Task 281,Job 0,9,4,3,12,1,12,21,9,3,2,0,281,314,9
Task 281,Job 1,14,7,1,6,0,15,20,5,1,2,2,281,314,8
Task 282,Job 0,6,5,1,9,0,7,15,8,1,3,0,282,316,9
Task 282,Job 1,11,6,3,6,0,14,17,3,3,1,0,282,316,13
Task 283,Job 0,7,7,1,7,0,8,14,6,1,2,1,283,316,18
Task 283,Job 1,12,10,3,6,0,15,18,3,3,2,2,283,316,12
Task 284,Job 0,5,6,2,11,0,7,16,9,2,3,1,284,317,17
Task 284,Job 1,10,10,3,9,0,13,19,6,3,2,2,284,317,2
Task 285,Job 0,8,6,4,7,1,12,15,3,4,3,1,285,319,13
Task 285,Job 1,13,6,3,6,0,16,19,3,3,1,2,285,319,5
Task 286,Job 0,2,6,3,7,0,5,9,4,3,1,2,286,320,9
Task 286,Job 1,7,7,3,11,0,10,18,8,3,3,1,286,320,14
Task 287,Job 0,4,9,2,7,0,6,11,5,2,1,1,287,321,5
Task 287,Job 1,9,6,4,9,0,13,18,5,4,4,0,287,321,15
Task 288,Job 0,9,5,1,9,0,10,18,8,1,1,1,288,322,13
Task 288,Job 1,14,6,4,9,0,18,23,5,4,3,1,288,322,8
Task 289,Job 0,5,9,1,7,0,6,12,6,1,1,1,289,322,4
Task 289,Job 1,10,4,4,11,1,14,21,7,4,4,1,289,322,11
Task 290,Job 0,3,10,3,6,0,6,9,3,3,2,2,290,324,3
Task 290,Job 1,8,9,4,12,0,12,20,8,4,4,2,290,324,6
Task 291,Job 0,8,7,4,6,0,12,14,2,4,4,2,291,324,11
Task 291,Job 1,13,4,3,11,1,16,24,8,3,2,2,291,324,15
Task 292,Job 0,6,9,4,12,0,10,18,8,4,2,1,292,326,18
Task 292,Job 1,11,8,3,9,0,14,20,6,3,4,1,292,326,12
Task 293,Job 0,10,9,4,9,0,14,19,5,4,4,2,293,327,20
Task 293,Job 1,15,10,4,8,1,19,23,4,4,2,0,293,327,5
Task 294,Job 0,1,4,2,8,0,3,9,6,2,1,0,294,328,3
Task 294,Job 1,6,8,4,9,0,10,15,5,4,3,1,294,328,3
Task 295,Job 0,10,7,4,6,0,14,16,2,4,2,0,295,329,7
Task 295,Job 1,15,4,2,7,0,17,22,5,2,4,0,295,329,13
Task 296,Job 0,2,9,4,7,0,6,9,3,4,1,0,296,329,10
Task 296,Job 1,7,6,2,7,0,9,14,5,2,4,2,296,329,7
Task 297,Job 0,6,10,3,9,1,9,15,6,3,4,1,297,331,19
Task 297,Job 1,11,8,1,12,1,12,23,11,1,2,0,297,331,5
Task 298,Job 0,3,9,4,11,1,7,14,7,4,1,0,298,332,14
Task 298,Job 1,8,9,3,6,0,11,14,3,3,3,0,298,332,10
Task 299,Job 0,3,5,3,9,0,6,12,6,3,3,2,299,332,14
Task 299,Job 1,8,10,2,7,0,10,15,5,2,3,0,299,332,14
Task 300,Job 0,2,7,2,12,0,4,14,10,2,2,0,300,333,19
Task 300,Job 1,7,10,1,12,0,8,19,11,1,4,0,300,333,8
Task 301,Job 0,10,6,1,7,0,11,17,6,1,1,1,301,334,10
Task 301,Job 1,15,6,4,12,0,19,27,8,4,1,0,301,334,7
Task 302,Job 0,7,8,2,11,0,9,18,9,2,1,1,302,335,3
Task 302,Job 1,12,6,2,9,1,14,21,7,2,3,0,302,335,18
Task 303,Job 0,9,6,4,12,0,13,21,8,4,1,0,303,336,12
Task 303,Job 1,14,4,3,8,0,17,22,5,3,1,2,303,336,12
Task 304,Job 0,6,5,4,11,0,10,17,7,4,3,1,304,338,9
Task 304,Job 1,11,9,2,8,0,13,19,6,2,2,2,304,338,6
Task 305,Job 0,8,10,1,6,1,9,14,5,1,2,1,305,338,7
Task 305,Job 1,13,8,4,7,0,17,20,3,4,1,2,305,338,12
Task 306,Job 0,8,7,4,9,0,12,17,5,4,4,1,306,340,10
Task 306,Job 1,13,10,2,7,0,15,20,5,2,2,1,306,340,9
Task 307,Job 0,1,8,1,10,0,2,11,9,1,2,2,307,341,19
Task 307,Job 1,6,7,4,7,1,10,13,3,4,2,2,307,341,20
Task 308,Job 0,4,9,2,10,0,6,14,8,2,2,1,308,342,6
Task 308,Job 1,9,5,2,6,0,11,15,4,2,4,0,308,342,11
Task 309,Job 0,2,5,1,10,1,3,12,9,1,3,2,309,342,19
Task 309,Job 1,7,4,4,6,0,11,13,2,4,2,1,309,342,14
Task 310,Job 0,8,7,1,9,1,9,17,8,1,4,1,310,344,19
Task 310,Job 1,13,4,2,7,1,15,20,5,2,1,2,310,344,4
Task 311,Job 0,8,8,4,11,0,12,19,7,4,3,2,311,345,17
Task 311,Job 1,13,5,1,12,0,14,25,11,1,1,2,311,345,19
Task 312,Job 0,1,7,3,8,0,4,9,5,3,3,1,312,346,7
Task 312,Job 1,6,8,4,7,0,10,13,3,4,1,0,312,346,5
Task 313,Job 0,9,7,2,7,0,11,16,5,2,2,2,313,346,11
Task 313,Job 1,14,5,4,10,0,18,24,6,4,3,1,313,346,17
Task 314,Job 0,8,8,3,8,0,11,16,5,3,3,0,314,347,10
Task 314,Job 1,13,4,1,10,0,14,23,9,1,1,2,314,347,17
Task 315,Job 0,3,9,1,6,0,4,9,5,1,2,2,315,349,3
Task 315,Job 1,8,5,2,9,0,10,17,7,2,3,2,315,349,13
Task 316,Job 0,2,8,4,6,1,6,8,2,4,2,2,316,350,19
Task 316,Job 1,7,10,4,10,0,11,17,6,4,3,2,316,350,7
Task 317,Job 0,5,10,3,11,0,8,16,8,3,1,2,317,350,9
Task 317,Job 1,10,7,4,10,1,14,20,6,4,4,2,317,350,6
Task 318,Job 0,8,9,3,6,1,11,14,3,3,3,2,318,352,12
Task 318,Job 1,13,8,3,12,0,16,25,9,3,3,1,318,352,16
Task 319,Job 0,7,9,2,11,0,9,18,9,2,3,0,319,352,11
Task 319,Job 1,12,5,2,9,0,14,21,7,2,4,2,319,352,3
Task 320,Job 0,9,5,3,6,0,12,15,3,3,1,0,320,353,16
Task 320,Job 1,14,7,4,7,1,18,21,3,4,3,1,320,353,18
Task 321,Job 0,8,6,3,8,1,11,16,5,3,1,1,321,354,18
Task 321,Job 1,13,6,1,6,0,14,19,5,1,4,1,321,354,12
Task 322,Job 0,4,7,2,8,0,6,12,6,2,4,1,322,356,16
Task 322,Job 1,9,6,2,10,0,11,19,8,2,3,0,322,356,5
Task 323,Job 0,4,6,2,11,0,6,15,9,2,3,2,323,357,6
Task 323,Job 1,9,6,4,6,0,13,15,2,4,4,0,323,357,4
Task 324,Job 0,7,9,3,7,1,10,14,4,3,4,0,324,358,12
Task 324,Job 1,12,9,2,9,0,14,21,7,2,1,0,324,358,12
Task 325,Job 0,4,5,4,9,1,8,13,5,4,4,2,325,359,6
Task 325,Job 1,9,8,3,11,0,12,20,8,3,1,2,325,359,17
Task 326,Job 0,1,10,1,8,0,2,9,7,1,1,1,326,360,17
Task 326,Job 1,6,7,2,7,0,8,13,5,2,1,1,326,360,19
Task 327,Job 0,6,5,1,12,1,7,18,11,1,3,2,327,361,7
Task 327,Job 1,11,5,2,9,0,13,20,7,2,2,0,327,361,18
Task 328,Job 0,1,10,4,8,1,5,9,4,4,3,2,328,362,5
Task 328,Job 1,6,8,2,8,0,8,14,6,2,1,1,328,362,10
Task 329,Job 0,1,5,4,9,0,5,10,5,4,3,2,329,363,3
Task 329,Job 1,6,9,4,12,0,10,18,8,4,3,2,329,363,4
Task 330,Job 0,10,5,1,11,1,11,21,10,1,3,1,330,363,12
Task 330,Job 1,15,7,1,11,0,16,26,10,1,1,0,330,363,7
Task 331,Job 0,6,10,1,10,0,7,16,9,1,2,1,331,365,15
Task 331,Job 1,11,7,4,9,1,15,20,5,4,4,1,331,365,16
Task 332,Job 0,7,6,4,7,0,11,14,3,4,4,0,332,365,12
Task 332,Job 1,12,5,1,7,0,13,19,6,1,1,2,332,365,19
Task 333,Job 0,8,4,1,9,0,9,17,8,1,3,1,333,366,4
Task 333,Job 1,13,4,3,7,0,16,20,4,3,3,2,333,366,6
Task 334,Job 0,9,10,1,7,0,10,16,6,1,4,2,334,367,9
Task 334,Job 1,14,9,3,12,0,17,26,9,3,3,2,334,367,19
Task 335,Job 0,9,10,2,12,0,11,21,10,2,3,0,335,369,6
Task 335,Job 1,14,4,1,11,0,15,25,10,1,3,0,335,369,11
Task 336,Job 0,7,10,1,12,0,8,19,11,1,1,0,336,370,19
Task 336,Job 1,12,6,2,10,1,14,22,8,2,1,1,336,370,18
Task 337,Job 0,1,5,2,10,0,3,11,8,2,2,0,337,370,8
Task 337,Job 1,6,10,1,7,0,7,13,6,1,3,1,337,370,16
Task 338,Job 0,3,7,4,10,0,7,13,6,4,3,2,338,372,10
Task 338,Job 1,8,10,1,7,1,9,15,6,1,3,2,338,372,19
Task 339,Job 0,7,7,2,12,0,9,19,10,2,4,0,339,372,10
Task 339,Job 1,12,6,2,9,0,14,21,7,2,3,2,339,372,8
Task 340,Job 0,9,6,1,10,1,10,19,9,1,2,0,340,373,5
Task 340,Job 1,14,5,1,12,0,15,26,11,1,4,2,340,373,2
Task 341,Job 0,5,5,3,10,0,8,15,7,3,2,1,341,374,6
Task 341,Job 1,10,6,1,8,1,11,18,7,1,3,0,341,374,7
Task 342,Job 0,3,10,3,8,0,6,11,5,3,1,2,342,376,5
Task 342,Job 1,8,6,4,7,0,12,15,3,4,4,1,342,376,19
Task 343,Job 0,3,8,4,12,0,7,15,8,4,1,2,343,377,16
Task 343,Job 1,8,8,3,7,1,11,15,4,3,1,1,343,377,5
Task 344,Job 0,5,6,3,8,0,8,13,5,3,3,1,344,378,8
Task 344,Job 1,10,9,3,11,0,13,21,8,3,4,1,344,378,2
Task 345,Job 0,2,10,3,8,1,5,10,5,3,3,0,345,378,14
Task 345,Job 1,7,6,2,6,0,9,13,4,2,3,1,345,378,20
Task 346,Job 0,7,5,3,7,0,10,14,4,3,1,1,346,380,8
Task 346,Job 1,12,7,4,6,0,16,18,2,4,4,1,346,380,19
Task 347,Job 0,8,6,2,7,0,10,15,5,2,3,2,347,381,12
Task 347,Job 1,13,4,2,11,0,15,24,9,2,4,1,347,381,10
Task 348,Job 0,5,6,4,10,1,9,15,6,4,4,2,348,381,3
Task 348,Job 1,10,6,4,8,0,14,18,4,4,4,0,348,381,5
Task 349,Job 0,2,6,2,7,0,4,9,5,2,1,0,349,383,8
Task 349,Job 1,7,7,4,12,1,11,19,8,4,3,1,349,383,7
Task 350,Job 0,2,7,3,9,0,5,11,6,3,3,1,350,383,14
Task 350,Job 1,7,7,4,7,1,11,14,3,4,4,2,350,383,11
Task 351,Job 0,2,6,3,12,0,5,14,9,3,4,1,351,384,2
Task 351,Job 1,7,8,1,11,0,8,18,10,1,1,0,351,384,9
Task 352,Job 0,1,5,2,11,0,3,12,9,2,2,2,352,385,16
Task 352,Job 1,6,6,3,9,0,9,15,6,3,4,2,352,385,10
Task 353,Job 0,10,4,3,10,0,13,20,7,3,4,1,353,387,12
Task 353,Job 1,15,5,1,11,0,16,26,10,1,2,1,353,387,17
Task 354,Job 0,10,5,1,7,0,11,17,6,1,4,0,354,388,10
Task 354,Job 1,15,7,4,6,0,19,21,2,4,2,1,354,388,14
Task 355,Job 0,5,7,4,6,0,9,11,2,4,1,0,355,388,13
Task 355,Job 1,10,10,1,9,1,11,19,8,1,2,1,355,388,8
Task 356,Job 0,10,9,3,6,1,13,16,3,3,3,1,356,390,18
Task 356,Job 1,15,5,3,6,0,18,21,3,3,1,0,356,390,8
Task 357,Job 0,7,9,4,7,0,11,14,3,4,4,0,357,391,17
Task 357,Job 1,12,7,4,7,0,16,19,3,4,3,1,357,391,8
Task 358,Job 0,1,10,3,12,0,4,13,9,3,1,1,358,392,13
Task 358,Job 1,6,8,3,12,0,9,18,9,3,3,2,358,392,11
Task 359,Job 0,5,8,2,12,0,7,17,10,2,1,2,359,393,18
Task 359,Job 1,10,7,4,7,0,14,17,3,4,2,0,359,393,20
Task 360,Job 0,5,10,4,7,0,9,12,3,4,2,1,360,393,17
Task 360,Job 1,10,5,4,9,0,14,19,5,4,4,1,360,393,6
Task 361,Job 0,3,5,4,6,0,7,9,2,4,4,1,361,394,19
Task 361,Job 1,8,8,4,6,1,12,14,2,4,3,2,361,394,19
Task 362,Job 0,8,10,4,10,0,12,18,6,4,4,1,362,395,3
Task 362,Job 1,13,9,1,12,1,14,25,11,1,3,0,362,395,9
Task 363,Job 0,3,5,1,7,0,4,10,6,1,3,2,363,397,17
Task 363,Job 1,8,9,4,9,1,12,17,5,4,3,2,363,397,13
Task 364,Job 0,3,4,4,11,0,7,14,7,4,3,1,364,398,2
Task 364,Job 1,8,10,1,8,1,9,16,7,1,4,0,364,398,15
Task 365,Job 0,2,6,1,7,0,3,9,6,1,3,0,365,399,19
Task 365,Job 1,7,10,3,12,0,10,19,9,3,2,1,365,399,18
Task 366,Job 0,4,4,1,8,0,5,12,7,1,1,1,366,400,5
Task 366,Job 1,9,6,1,12,1,10,21,11,1,1,1,366,400,6
Task 367,Job 0,8,5,2,9,0,10,17,7,2,2,0,367,400,3
Task 367,Job 1,13,9,3,9,0,16,22,6,3,1,1,367,400,10
Task 368,Job 0,10,8,1,9,1,11,19,8,1,2,2,368,402,5
Task 368,Job 1,15,9,4,7,0,19,22,3,4,3,1,368,402,6
Task 369,Job 0,9,8,1,11,1,10,20,10,1,1,0,369,402,17
Task 369,Job 1,14,7,2,6,0,16,20,4,2,2,2,369,402,2
Task 370,Job 0,7,5,3,12,0,10,19,9,3,1,1,370,404,10
Task 370,Job 1,12,10,2,7,1,14,19,5,2,3,1,370,404,8
Task 371,Job 0,8,6,3,8,1,11,16,5,3,4,2,371,405,15
Task 371,Job 1,13,8,4,11,1,17,24,7,4,4,0,371,405,7
Task 372,Job 0,2,4,3,6,0,5,8,3,3,2,0,372,405,4
Task 372,Job 1,7,9,3,10,0,10,17,7,3,1,1,372,405,3
Task 373,Job 0,7,8,4,10,0,11,17,6,4,4,0,373,406,10
Task 373,Job 1,12,10,3,7,0,15,19,4,3,3,2,373,406,7
Task 374,Job 0,8,7,3,9,1,11,17,6,3,1,0,374,408,15
Task 374,Job 1,13,6,2,10,0,15,23,8,2,3,0,374,408,9
Task 375,Job 0,2,6,2,6,1,4,8,4,2,3,1,375,409,14
Task 375,Job 1,7,7,3,9,0,10,16,6,3,3,2,375,409,18
Task 376,Job 0,5,8,2,10,1,7,15,8,2,2,1,376,410,4
Task 376,Job 1,10,8,1,7,0,11,17,6,1,3,2,376,410,11
Task 377,Job 0,7,5,2,8,1,9,15,6,2,3,1,377,411,3
Task 377,Job 1,12,5,2,6,0,14,18,4,2,2,0,377,411,9
Task 378,Job 0,8,5,4,10,1,12,18,6,4,3,2,378,411,9
Task 378,Job 1,13,5,2,6,1,15,19,4,2,3,1,378,411,14
Task 379,Job 0,3,6,2,10,0,5,13,8,2,4,1,379,413,14
Task 379,Job 1,8,7,1,11,0,9,19,10,1,1,1,379,413,4
Task 380,Job 0,4,8,2,11,0,6,15,9,2,2,2,380,413,6
Task 380,Job 1,9,6,1,11,0,10,20,10,1,3,2,380,413,19
Task 381,Job 0,2,9,3,7,0,5,9,4,3,1,0,381,414,4
Task 381,Job 1,7,5,1,11,0,8,18,10,1,1,1,381,414,4
Task 382,Job 0,8,5,3,11,0,11,19,8,3,1,1,382,416,3
Task 382,Job 1,13,6,1,9,1,14,22,8,1,3,0,382,416,20
Task 383,Job 0,8,8,1,8,0,9,16,7,1,1,2,383,417,14
Task 383,Job 1,13,9,2,10,0,15,23,8,2,1,1,383,417,8
Task 384,Job 0,4,5,1,9,1,5,13,8,1,4,0,384,417,11
Task 384,Job 1,9,7,1,11,0,10,20,10,1,1,2,384,417,17
Task 385,Job 0,7,6,1,9,1,8,16,8,1,3,1,385,419,13
Task 385,Job 1,12,7,3,12,1,15,24,9,3,4,0,385,419,16
Task 386,Job 0,8,9,4,12,0,12,20,8,4,2,1,386,420,16
Task 386,Job 1,13,5,1,11,0,14,24,10,1,3,1,386,420,17
Task 387,Job 0,3,8,3,6,0,6,9,3,3,4,2,387,421,12
Task 387,Job 1,8,4,4,12,1,12,20,8,4,4,1,387,421,16
Task 388,Job 0,1,5,2,11,0,3,12,9,2,2,0,388,422,19
Task 388,Job 1,6,6,4,8,0,10,14,4,4,1,1,388,422,14
Task 389,Job 0,10,10,2,10,0,12,20,8,2,2,1,389,422,4
Task 389,Job 1,15,10,3,8,0,18,23,5,3,3,0,389,422,16
Task 390,Job 0,8,7,4,9,0,12,17,5,4,2,1,390,424,2
Task 390,Job 1,13,8,3,10,0,16,23,7,3,1,0,390,424,3
Task 391,Job 0,5,8,1,8,0,6,13,7,1,4,1,391,425,15
Task 391,Job 1,10,4,1,7,0,11,17,6,1,4,0,391,425,14
Task 392,Job 0,5,7,4,10,1,9,15,6,4,2,0,392,425,2
Task 392,Job 1,10,9,3,6,1,13,16,3,3,4,2,392,425,3
Task 393,Job 0,9,10,3,8,0,12,17,5,3,4,2,393,427,19
Task 393,Job 1,14,6,4,10,0,18,24,6,4,3,0,393,427,3
Task 394,Job 0,10,10,3,7,1,13,17,4,3,2,2,394,427,2
Task 394,Job 1,15,8,1,8,0,16,23,7,1,2,2,394,427,19
Task 395,Job 0,2,8,2,10,0,4,12,8,2,4,1,395,429,12
Task 395,Job 1,7,4,2,9,1,9,16,7,2,4,1,395,429,13
Task 396,Job 0,1,4,2,8,0,3,9,6,2,1,1,396,429,17
Task 396,Job 1,6,6,1,11,0,7,17,10,1,4,1,396,429,11
Task 397,Job 0,8,6,4,10,1,12,18,6,4,4,2,397,431,6
Task 397,Job 1,13,4,4,12,1,17,25,8,4,4,0,397,431,13
Task 398,Job 0,5,10,3,9,0,8,14,6,3,1,0,398,431,11
Task 398,Job 1,10,8,1,10,1,11,20,9,1,2,2,398,431,5
Task 399,Job 0,7,9,3,6,0,10,13,3,3,1,2,399,433,4
Task 399,Job 1,12,10,1,9,0,13,21,8,1,3,0,399,433,10
Task 400,Job 0,3,10,1,10,0,4,13,9,1,4,1,400,434,15
Task 400,Job 1,8,10,3,8,1,11,16,5,3,1,0,400,434,4
Task 401,Job 0,7,9,4,8,0,11,15,4,4,1,2,401,435,16
Task 401,Job 1,12,9,2,6,0,14,18,4,2,4,1,401,435,7
Task 402,Job 0,7,9,2,7,0,9,14,5,2,2,2,402,435,16
Task 402,Job 1,12,4,1,12,0,13,24,11,1,1,2,402,435,16
Task 403,Job 0,10,4,1,8,0,11,18,7,1,2,1,403,437,4
Task 403,Job 1,15,6,4,6,0,19,21,2,4,3,2,403,437,12
Task 404,Job 0,4,7,4,11,0,8,15,7,4,3,0,404,438,7
Task 404,Job 1,9,6,1,7,1,10,16,6,1,4,0,404,438,17
Task 405,Job 0,4,10,4,10,0,8,14,6,4,3,1,405,439,17
Task 405,Job 1,9,6,2,9,0,11,18,7,2,2,1,405,439,19
Task 406,Job 0,6,8,4,12,0,10,18,8,4,2,1,406,440,18
Task 406,Job 1,11,4,1,7,0,12,18,6,1,4,2,406,440,20
Task 407,Job 0,6,10,2,12,0,8,18,10,2,3,0,407,440,9
Task 407,Job 1,11,10,4,10,1,15,21,6,4,2,1,407,440,7
Task 408,Job 0,8,5,4,11,1,12,19,7,4,4,1,408,441,19
Task 408,Job 1,13,5,4,11,0,17,24,7,4,1,0,408,441,19
Task 409,Job 0,9,10,3,11,0,12,20,8,3,1,1,409,443,11
Task 409,Job 1,14,4,3,8,1,17,22,5,3,3,1,409,443,19
Task 410,Job 0,10,10,1,10,0,11,20,9,1,4,1,410,444,7
Task 410,Job 1,15,4,4,10,0,19,25,6,4,3,1,410,444,13
Task 411,Job 0,10,10,4,10,0,14,20,6,4,3,0,411,445,2
Task 411,Job 1,15,7,1,7,0,16,22,6,1,4,2,411,445,19
Task 412,Job 0,1,5,3,11,1,4,12,8,3,4,0,412,446,6
Task 412,Job 1,6,10,1,10,0,7,16,9,1,4,0,412,446,15
Task 413,Job 0,5,6,3,11,1,8,16,8,3,3,2,413,446,10
Task 413,Job 1,10,10,4,10,0,14,20,6,4,3,2,413,446,7
Task 414,Job 0,8,7,4,7,0,12,15,3,4,4,0,414,447,8
Task 414,Job 1,13,5,3,7,1,16,20,4,3,4,1,414,447,5
Task 415,Job 0,5,7,1,8,0,6,13,7,1,2,1,415,448,7
Task 415,Job 1,10,7,2,9,0,12,19,7,2,3,2,415,448,15
Task 416,Job 0,1,10,4,12,0,5,13,8,4,4,0,416,449,15
Task 416,Job 1,6,10,3,9,0,9,15,6,3,2,0,416,449,7
Task 417,Job 0,1,6,4,7,0,5,8,3,4,2,2,417,450,4
Task 417,Job 1,6,4,4,7,0,10,13,3,4,4,1,417,450,10
Task 418,Job 0,8,7,2,9,0,10,17,7,2,2,2,418,452,2
Task 418,Job 1,13,6,4,11,0,17,24,7,4,4,0,418,452,9
Task 419,Job 0,4,4,3,8,0,7,12,5,3,1,1,419,453,8
Task 419,Job 1,9,7,3,9,0,12,18,6,3,2,2,419,453,18
Task 420,Job 0,4,4,2,9,0,6,13,7,2,2,2,420,454,15
Task 420,Job 1,9,7,2,10,0,11,19,8,2,4,0,420,454,7
Task 421,Job 0,5,9,4,9,0,9,14,5,4,3,2,421,454,9
Task 421,Job 1,10,7,2,12,0,12,22,10,2,2,1,421,454,19
Task 422,Job 0,8,8,2,9,1,10,17,7,2,3,2,422,456,20
Task 422,Job 1,13,5,2,6,0,15,19,4,2,1,1,422,456,3
Task 423,Job 0,6,5,3,7,0,9,13,4,3,3,0,423,457,20
Task 423,Job 1,11,7,2,8,0,13,19,6,2,2,0,423,457,13
Task 424,Job 0,3,10,2,9,0,5,12,7,2,4,1,424,458,4
Task 424,Job 1,8,9,1,9,1,9,17,8,1,2,0,424,458,2
Task 425,Job 0,9,9,4,7,0,13,16,3,4,2,2,425,458,14
Task 425,Job 1,14,5,2,10,0,16,24,8,2,1,2,425,458,5
Task 426,Job 0,7,4,1,11,0,8,18,10,1,4,1,426,459,20
Task 426,Job 1,12,10,1,12,0,13,24,11,1,1,2,426,459,5
Task 427,Job 0,5,7,4,7,0,9,12,3,4,4,0,427,460,11
Task 427,Job 1,10,8,3,6,0,13,16,3,3,3,1,427,460,17
Task 428,Job 0,7,8,1,7,0,8,14,6,1,2,1,428,461,19
Task 428,Job 1,12,4,2,9,0,14,21,7,2,1,2,428,461,19
Task 429,Job 0,7,8,3,7,0,10,14,4,3,1,0,429,462,14
Task 429,Job 1,12,7,3,12,0,15,24,9,3,2,1,429,462,11
Task 430,Job 0,10,7,1,6,0,11,16,5,1,4,0,430,463,3
Task 430,Job 1,15,7,2,12,0,17,27,10,2,2,1,430,463,2
Task 431,Job 0,2,9,3,12,0,5,14,9,3,4,2,431,465,16
Task 431,Job 1,7,8,2,11,0,9,18,9,2,2,2,431,465,14
Task 432,Job 0,7,10,4,9,1,11,16,5,4,1,2,432,466,11
Task 432,Job 1,12,4,2,10,1,14,22,8,2,4,1,432,466,2
Task 433,Job 0,4,4,4,11,0,8,15,7,4,3,0,433,466,13
Task 433,Job 1,9,9,4,11,0,13,20,7,4,4,1,433,466,3
Task 434,Job 0,5,6,3,11,0,8,16,8,3,1,1,434,468,11
Task 434,Job 1,10,9,4,11,1,14,21,7,4,2,0,434,468,8
Task 435,Job 0,9,9,3,12,0,12,21,9,3,3,0,435,469,10
Task 435,Job 1,14,6,4,12,0,18,26,8,4,4,2,435,469,17
Task 436,Job 0,3,9,1,6,0,4,9,5,1,1,0,436,469,4
Task 436,Job 1,8,7,2,11,1,10,19,9,2,1,0,436,469,6
Task 437,Job 0,2,10,3,9,0,5,11,6,3,3,0,437,470,9
Task 437,Job 1,7,7,4,7,0,11,14,3,4,1,0,437,470,17
Task 438,Job 0,7,8,4,6,1,11,13,2,4,2,2,438,471,11
Task 438,Job 1,12,9,4,10,1,16,22,6,4,4,1,438,471,14
Task 439,Job 0,8,6,3,12,0,11,20,9,3,1,0,439,472,20
Task 439,Job 1,13,7,2,7,0,15,20,5,2,3,1,439,472,9
Task 440,Job 0,6,4,2,8,0,8,14,6,2,4,1,440,473,7
Task 440,Job 1,11,8,3,6,0,14,17,3,3,1,2,440,473,6
Task 441,Job 0,9,10,4,11,1,13,20,7,4,2,2,441,475,11
Task 441,Job 1,14,5,2,6,1,16,20,4,2,2,2,441,475,8
Task 442,Job 0,1,9,4,9,0,5,10,5,4,2,0,442,476,14
Task 442,Job 1,6,7,1,8,0,7,14,7,1,2,0,442,476,7
Task 443,Job 0,3,7,2,10,0,5,13,8,2,4,1,443,477,8
Task 443,Job 1,8,10,1,11,1,9,19,10,1,1,2,443,477,12
Task 444,Job 0,6,10,1,9,1,7,15,8,1,3,0,444,477,5
Task 444,Job 1,11,7,2,6,0,13,17,4,2,4,1,444,477,9
Task 445,Job 0,5,9,2,8,0,7,13,6,2,4,0,445,479,19
Task 445,Job 1,10,10,4,8,0,14,18,4,4,1,0,445,479,17
Task 446,Job 0,5,10,2,10,0,7,15,8,2,4,0,446,480,9
Task 446,Job 1,10,9,4,7,0,14,17,3,4,1,1,446,480,3
Task 447,Job 0,5,4,4,7,0,9,12,3,4,4,1,447,481,18
Task 447,Job 1,10,9,4,11,1,14,21,7,4,4,1,447,481,6
Task 448,Job 0,2,4,1,10,0,3,12,9,1,2,0,448,482,20
Task 448,Job 1,7,9,1,6,1,8,13,5,1,2,2,448,482,20
Task 449,Job 0,10,8,1,12,1,11,22,11,1,4,0,449,482,3
Task 449,Job 1,15,8,2,10,1,17,25,8,2,4,0,449,482,9
Task 450,Job 0,6,5,1,9,0,7,15,8,1,1,0,450,484,6
Task 450,Job 1,11,10,2,6,0,13,17,4,2,4,0,450,484,13
Task 451,Job 0,3,8,3,9,0,6,12,6,3,1,0,451,484,18
Task 451,Job 1,8,5,4,6,0,12,14,2,4,1,0,451,484,3
Task 452,Job 0,9,5,1,8,0,10,17,7,1,1,1,452,485,6
Task 452,Job 1,14,9,1,6,0,15,20,5,1,4,2,452,485,11
Task 453,Job 0,4,10,3,6,0,7,10,3,3,3,2,453,486,5
Task 453,Job 1,9,7,4,8,0,13,17,4,4,3,1,453,486,8
Task 454,Job 0,8,4,4,10,0,12,18,6,4,3,2,454,488,7
Task 454,Job 1,13,8,4,8,0,17,21,4,4,3,2,454,488,8
Task 455,Job 0,4,10,1,11,0,5,15,10,1,1,2,455,488,9
Task 455,Job 1,9,5,3,10,0,12,19,7,3,1,0,455,488,6
Task 456,Job 0,1,5,1,11,1,2,12,10,1,4,0,456,490,9
Task 456,Job 1,6,8,4,12,0,10,18,8,4,1,0,456,490,14
Task 457,Job 0,8,6,2,8,0,10,16,6,2,4,1,457,490,3
Task 457,Job 1,13,6,4,10,0,17,23,6,4,2,0,457,490,13
Task 458,Job 0,6,9,4,8,1,10,14,4,4,2,1,458,491,16
Task 458,Job 1,11,6,1,7,0,12,18,6,1,1,2,458,491,14
Task 459,Job 0,10,9,2,9,0,12,19,7,2,3,0,459,493,20
Task 459,Job 1,15,6,2,7,1,17,22,5,2,2,0,459,493,12
Task 460,Job 0,1,4,4,12,0,5,13,8,4,4,1,460,493,16
Task 460,Job 1,6,8,3,11,0,9,17,8,3,3,0,460,493,18
Task 461,Job 0,8,5,4,6,0,12,14,2,4,2,2,461,494,9
Task 461,Job 1,13,10,4,9,0,17,22,5,4,2,0,461,494,12
Task 462,Job 0,2,6,3,9,1,5,11,6,3,2,1,462,496,14
Task 462,Job 1,7,4,4,8,0,11,15,4,4,4,2,462,496,18
Task 463,Job 0,10,10,1,12,0,11,22,11,1,4,2,463,496,3
Task 463,Job 1,15,10,1,6,0,16,21,5,1,4,1,463,496,12
Task 464,Job 0,10,8,3,9,0,13,19,6,3,3,1,464,497,7
Task 464,Job 1,15,10,2,10,0,17,25,8,2,3,0,464,497,19
Task 465,Job 0,4,9,4,7,0,8,11,3,4,2,1,465,498,3
Task 465,Job 1,9,6,3,8,0,12,17,5,3,4,0,465,498,7
Task 466,Job 0,10,8,4,12,1,14,22,8,4,3,2,466,500,17
Task 466,Job 1,15,7,3,9,0,18,24,6,3,4,0,466,500,2
Task 467,Job 0,3,8,3,11,0,6,14,8,3,2,2,467,501,8
Task 467,Job 1,8,6,3,8,0,11,16,5,3,2,0,467,501,14
Task 468,Job 0,7,10,1,8,0,8,15,7,1,4,2,468,502,17
Task 468,Job 1,12,5,3,11,0,15,23,8,3,1,0,468,502,15
Task 469,Job 0,6,4,1,8,0,7,14,7,1,3,0,469,503,12
Task 469,Job 1,11,5,4,10,0,15,21,6,4,3,1,469,503,18
Task 470,Job 0,3,10,2,11,0,5,14,9,2,3,0,470,504,18
Task 470,Job 1,8,6,1,11,0,9,19,10,1,2,2,470,504,14
Task 471,Job 0,3,7,1,6,0,4,9,5,1,2,1,471,505,9
Task 471,Job 1,8,5,4,8,0,12,16,4,4,3,0,471,505,6
Task 472,Job 0,4,10,2,11,1,6,15,9,2,3,1,472,505,16
Task 472,Job 1,9,10,1,8,0,10,17,7,1,4,2,472,505,5
Task 473,Job 0,2,5,4,8,0,6,10,4,4,2,0,473,506,12
Task 473,Job 1,7,5,1,11,1,8,18,10,1,3,1,473,506,12
Task 474,Job 0,5,6,4,11,1,9,16,7,4,4,0,474,508,14
Task 474,Job 1,10,9,2,11,1,12,21,9,2,4,0,474,508,15
Task 475,Job 0,1,4,1,12,0,2,13,11,1,1,2,475,509,13
Task 475,Job 1,6,6,2,9,1,8,15,7,2,3,1,475,509,20
Task 476,Job 0,10,10,2,12,0,12,22,10,2,4,2,476,510,2
Task 476,Job 1,15,6,2,11,1,17,26,9,2,1,2,476,510,8
Task 477,Job 0,2,9,4,6,0,6,8,2,4,3,1,477,511,2
Task 477,Job 1,7,4,4,8,0,11,15,4,4,4,1,477,511,3
Task 478,Job 0,7,10,4,6,0,11,13,2,4,3,2,478,512,14
Task 478,Job 1,12,10,3,8,0,15,20,5,3,4,1,478,512,18
Task 479,Job 0,10,10,2,7,1,12,17,5,2,2,1,479,513,12
Task 479,Job 1,15,5,1,11,0,16,26,10,1,3,0,479,513,18
Task 480,Job 0,8,6,1,11,1,9,19,10,1,1,2,480,513,16
Task 480,Job 1,13,5,1,8,0,14,21,7,1,2,0,480,513,9
Task 481,Job 0,10,10,4,10,0,14,20,6,4,1,1,481,514,8
Task 481,Job 1,15,6,1,9,0,16,24,8,1,1,2,481,514,16
Task 482,Job 0,10,10,1,8,0,11,18,7,1,2,2,482,516,9
Task 482,Job 1,15,8,4,11,0,19,26,7,4,3,0,482,516,14
Task 483,Job 0,1,8,3,8,1,4,9,5,3,2,0,483,517,3
Task 483,Job 1,6,10,3,12,0,9,18,9,3,3,2,483,517,4
Task 484,Job 0,10,8,2,6,1,12,16,4,2,2,2,484,518,11
Task 484,Job 1,15,6,1,11,0,16,26,10,1,1,0,484,518,2
Task 485,Job 0,5,6,4,9,0,9,14,5,4,1,1,485,519,18
Task 485,Job 1,10,5,3,11,0,13,21,8,3,4,1,485,519,13
Task 486,Job 0,3,4,3,9,0,6,12,6,3,1,0,486,520,10
Task 486,Job 1,8,5,1,9,0,9,17,8,1,1,0,486,520,5
Task 487,Job 0,6,6,3,12,0,9,18,9,3,3,0,487,520,17
Task 487,Job 1,11,4,2,10,1,13,21,8,2,4,2,487,520,4
Task 488,Job 0,5,4,4,12,0,9,17,8,4,1,0,488,522,3
Task 488,Job 1,10,6,1,10,1,11,20,9,1,4,0,488,522,18
Task 489,Job 0,3,7,1,12,1,4,15,11,1,2,0,489,522,18
Task 489,Job 1,8,4,3,10,0,11,18,7,3,3,1,489,522,13
Task 490,Job 0,6,7,3,7,0,9,13,4,3,3,0,490,524,4
Task 490,Job 1,11,4,3,9,1,14,20,6,3,2,1,490,524,14
Task 491,Job 0,5,4,4,7,0,9,12,3,4,1,1,491,524,20
Task 491,Job 1,10,9,3,10,0,13,20,7,3,1,2,491,524,19
Task 492,Job 0,2,8,2,8,0,4,10,6,2,2,2,492,525,11
Task 492,Job 1,7,7,4,9,1,11,16,5,4,1,1,492,525,6
Task 493,Job 0,7,5,4,6,0,11,13,2,4,3,2,493,527,5
Task 493,Job 1,12,4,4,8,0,16,20,4,4,4,1,493,527,9
Task 494,Job 0,6,9,3,10,0,9,16,7,3,3,1,494,528,15
Task 494,Job 1,11,5,1,6,0,12,17,5,1,4,0,494,528,4
Task 495,Job 0,9,7,3,8,0,12,17,5,3,3,0,495,529,5
Task 495,Job 1,14,4,1,10,0,15,24,9,1,3,2,495,529,17
Task 496,Job 0,5,5,3,10,1,8,15,7,3,2,1,496,530,14
Task 496,Job 1,10,10,4,8,0,14,18,4,4,3,0,496,530,5
Task 497,Job 0,1,6,1,6,0,2,7,5,1,1,2,497,531,16
Task 497,Job 1,6,5,2,8,1,8,14,6,2,2,2,497,531,20
Task 498,Job 0,3,6,2,8,0,5,11,6,2,2,0,498,532,6
Task 498,Job 1,8,4,3,12,1,11,20,9,3,2,0,498,532,20
Task 499,Job 0,9,10,2,12,0,11,21,10,2,1,1,499,533,10
Task 499,Job 1,14,8,1,6,1,15,20,5,1,3,0,499,533,15
Task 500,Job 0,4,10,2,8,0,6,12,6,2,1,1,500,534,9
Task 500,Job 1,9,7,4,7,1,13,16,3,4,1,0,500,534,19
Task 501,Job 0,2,5,1,9,0,3,11,8,1,1,1,501,535,14
Task 501,Job 1,7,4,4,6,0,11,13,2,4,1,0,501,535,9
Task 502,Job 0,10,10,3,7,1,13,17,4,3,1,0,502,535,13
Task 502,Job 1,15,8,1,7,0,16,22,6,1,1,1,502,535,18
Task 503,Job 0,3,7,3,7,0,6,10,4,3,2,1,503,537,15
Task 503,Job 1,8,9,3,11,0,11,19,8,3,1,2,503,537,11
Task 504,Job 0,9,4,2,10,1,11,19,8,2,2,1,504,538,12
Task 504,Job 1,14,6,1,7,0,15,21,6,1,2,0,504,538,4
Task 505,Job 0,10,8,1,10,0,11,20,9,1,4,1,505,538,20
Task 505,Job 1,15,6,3,11,0,18,26,8,3,3,2,505,538,12
Task 506,Job 0,8,5,1,7,0,9,15,6,1,2,0,506,540,8
Task 506,Job 1,13,5,4,8,1,17,21,4,4,4,0,506,540,6
Task 507,Job 0,6,7,4,9,0,10,15,5,4,3,1,507,540,18
Task 507,Job 1,11,8,1,6,0,12,17,5,1,4,0,507,540,20
Task 508,Job 0,1,10,1,9,1,2,10,8,1,1,2,508,542,2
Task 508,Job 1,6,4,2,8,0,8,14,6,2,3,1,508,542,9
Task 509,Job 0,3,8,2,12,0,5,15,10,2,2,2,509,543,3
Task 509,Job 1,8,7,2,6,0,10,14,4,2,4,0,509,543,16
Task 510,Job 0,4,10,2,10,1,6,14,8,2,2,2,510,544,6
Task 510,Job 1,9,6,1,9,0,10,18,8,1,4,0,510,544,6
Task 511,Job 0,7,9,4,6,1,11,13,2,4,4,0,511,545,16
Task 511,Job 1,12,5,1,9,0,13,21,8,1,2,2,511,545,12
Task 512,Job 0,7,6,2,7,1,9,14,5,2,1,0,512,546,2
Task 512,Job 1,12,5,3,8,0,15,20,5,3,2,0,512,546,11
Task 513,Job 0,2,7,2,9,0,4,11,7,2,2,2,513,547,20
Task 513,Job 1,7,7,3,11,1,10,18,8,3,1,2,513,547,7
Task 514,Job 0,2,4,3,10,0,5,12,7,3,3,1,514,548,10
Task 514,Job 1,7,5,4,12,0,11,19,8,4,1,1,514,548,5
Task 515,Job 0,9,10,2,11,1,11,20,9,2,1,1,515,549,4
Task 515,Job 1,14,9,3,9,0,17,23,6,3,1,2,515,549,5
Task 516,Job 0,3,9,3,7,0,6,10,4,3,3,2,516,549,20
Task 516,Job 1,8,5,4,11,1,12,19,7,4,4,1,516,549,7
Task 517,Job 0,8,4,3,9,1,11,17,6,3,3,2,517,550,8
Task 517,Job 1,13,8,2,9,0,15,22,7,2,4,1,517,550,5
Task 518,Job 0,4,4,4,11,1,8,15,7,4,3,1,518,552,19
Task 518,Job 1,9,5,4,9,1,13,18,5,4,4,2,518,552,16
Task 519,Job 0,4,10,1,6,0,5,10,5,1,2,0,519,552,18
Task 519,Job 1,9,7,4,9,0,13,18,5,4,1,0,519,552,18
Task 520,Job 0,9,9,4,6,1,13,15,2,4,1,2,520,553,7
Task 520,Job 1,14,10,4,6,0,18,20,2,4,4,1,520,553,8
Task 521,Job 0,9,7,4,10,0,13,19,6,4,2,0,521,555,3
Task 521,Job 1,14,7,2,6,0,16,20,4,2,3,1,521,555,19
Task 522,Job 0,10,8,3,12,0,13,22,9,3,1,2,522,556,18
Task 522,Job 1,15,9,1,7,0,16,22,6,1,3,2,522,556,18
Task 523,Job 0,4,6,2,7,0,6,11,5,2,4,2,523,556,17
Task 523,Job 1,9,9,4,6,0,13,15,2,4,3,0,523,556,7
Task 524,Job 0,9,8,1,9,0,10,18,8,1,3,2,524,558,15
Task 524,Job 1,14,6,4,6,1,18,20,2,4,2,2,524,558,15
Task 525,Job 0,8,4,3,7,0,11,15,4,3,4,2,525,559,18
Task 525,Job 1,13,10,3,6,0,16,19,3,3,4,1,525,559,17
Task 526,Job 0,9,9,4,9,0,13,18,5,4,3,1,526,559,20
Task 526,Job 1,14,10,1,9,0,15,23,8,1,4,2,526,559,18
Task 527,Job 0,5,7,4,8,0,9,13,4,4,4,2,527,560,13
Task 527,Job 1,10,10,1,9,1,11,19,8,1,4,1,527,560,9
Task 528,Job 0,2,6,1,10,0,3,12,9,1,3,1,528,561,2
Task 528,Job 1,7,5,2,7,1,9,14,5,2,4,0,528,561,7
Task 529,Job 0,6,10,4,9,0,10,15,5,4,1,2,529,563,7
Task 529,Job 1,11,5,3,8,1,14,19,5,3,2,0,529,563,13
Task 530,Job 0,9,8,1,10,0,10,19,9,1,1,1,530,564,17
Task 530,Job 1,14,5,2,12,0,16,26,10,2,2,1,530,564,13
Task 531,Job 0,3,9,2,6,0,5,9,4,2,1,0,531,564,3
Task 531,Job 1,8,5,4,9,0,12,17,5,4,1,1,531,564,10
Task 532,Job 0,8,5,4,10,0,12,18,6,4,2,2,532,566,15
Task 532,Job 1,13,8,1,8,0,14,21,7,1,2,1,532,566,6
Task 533,Job 0,6,7,4,8,0,10,14,4,4,4,0,533,567,2
Task 533,Job 1,11,6,2,12,0,13,23,10,2,1,1,533,567,19
Task 534,Job 0,5,8,3,12,0,8,17,9,3,4,0,534,568,12
Task 534,Job 1,10,6,1,12,0,11,22,11,1,3,1,534,568,4
Task 535,Job 0,3,9,4,11,0,7,14,7,4,2,1,535,568,19
Task 535,Job 1,8,10,1,6,1,9,14,5,1,2,0,535,568,20
Task 536,Job 0,10,10,2,11,1,12,21,9,2,3,2,536,569,13
Task 536,Job 1,15,5,3,7,1,18,22,4,3,4,0,536,569,15
Task 537,Job 0,1,6,2,6,1,3,7,4,2,4,2,537,571,6
Task 537,Job 1,6,5,4,12,1,10,18,8,4,2,1,537,571,20
Task 538,Job 0,7,5,1,11,0,8,18,10,1,2,2,538,571,12
Task 538,Job 1,12,9,3,7,0,15,19,4,3,3,1,538,571,10
Task 539,Job 0,9,9,3,10,0,12,19,7,3,2,2,539,572,18
Task 539,Job 1,14,7,2,9,0,16,23,7,2,1,0,539,572,9
Task 540,Job 0,1,10,3,8,0,4,9,5,3,3,1,540,574,10
Task 540,Job 1,6,9,4,11,0,10,17,7,4,2,1,540,574,10
Task 541,Job 0,1,5,2,12,0,3,13,10,2,3,2,541,574,16
Task 541,Job 1,6,9,3,6,1,9,12,3,3,1,1,541,574,4
Task 542,Job 0,5,7,3,11,0,8,16,8,3,1,2,542,575,17
Task 542,Job 1,10,8,1,11,0,11,21,10,1,3,1,542,575,6
Task 543,Job 0,2,10,4,11,0,6,13,7,4,1,0,543,577,13
Task 543,Job 1,7,10,1,12,0,8,19,11,1,2,0,543,577,18
Task 544,Job 0,7,9,3,12,1,10,19,9,3,1,1,544,577,19
Task 544,Job 1,12,9,2,11,1,14,23,9,2,3,1,544,577,20
Task 545,Job 0,3,7,3,10,0,6,13,7,3,1,1,545,578,7
Task 545,Job 1,8,9,4,6,0,12,14,2,4,2,1,545,578,8
Task 546,Job 0,4,7,4,11,0,8,15,7,4,2,0,546,579,2
Task 546,Job 1,9,7,3,7,0,12,16,4,3,1,0,546,579,11
Task 547,Job 0,4,9,2,7,0,6,11,5,2,2,1,547,581,13
Task 547,Job 1,9,8,4,10,0,13,19,6,4,3,1,547,581,6
Task 548,Job 0,10,4,2,8,0,12,18,6,2,3,2,548,582,8
Task 548,Job 1,15,7,4,6,0,19,21,2,4,4,0,548,582,19
Task 549,Job 0,3,6,2,11,1,5,14,9,2,2,2,549,582,10
Task 549,Job 1,8,5,2,6,0,10,14,4,2,1,2,549,582,13
Task 550,Job 0,10,4,2,8,0,12,18,6,2,2,0,550,583,16
Task 550,Job 1,15,10,3,9,1,18,24,6,3,2,2,550,583,4
Task 551,Job 0,9,9,2,10,0,11,19,8,2,1,2,551,585,14
Task 551,Job 1,14,10,3,10,0,17,24,7,3,3,2,551,585,4
Task 552,Job 0,8,8,2,11,0,10,19,9,2,1,0,552,585,9
Task 552,Job 1,13,5,2,6,1,15,19,4,2,4,0,552,585,18
Task 553,Job 0,5,8,2,10,1,7,15,8,2,4,0,553,586,2
Task 553,Job 1,10,5,2,9,1,12,19,7,2,2,0,553,586,20
Task 554,Job 0,7,4,1,6,1,8,13,5,1,2,2,554,587,19
Task 554,Job 1,12,10,4,8,0,16,20,4,4,2,2,554,587,17
Task 555,Job 0,1,10,4,12,1,5,13,8,4,1,2,555,589,5
Task 555,Job 1,6,5,1,8,0,7,14,7,1,1,2,555,589,3
Task 556,Job 0,8,5,3,9,0,11,17,6,3,3,2,556,590,8
Task 556,Job 1,13,9,3,9,0,16,22,6,3,3,2,556,590,4
Task 557,Job 0,5,8,3,7,0,8,12,4,3,3,2,557,590,8
Task 557,Job 1,10,9,4,11,1,14,21,7,4,3,0,557,590,7
Task 558,Job 0,10,4,3,8,0,13,18,5,3,3,0,558,592,10
Task 558,Job 1,15,4,1,8,0,16,23,7,1,1,2,558,592,18
Task 559,Job 0,10,4,4,7,0,14,17,3,4,1,2,559,592,15
Task 559,Job 1,15,4,1,7,0,16,22,6,1,1,2,559,592,10
Task 560,Job 0,4,10,2,7,0,6,11,5,2,3,1,560,593,5
Task 560,Job 1,9,9,4,6,1,13,15,2,4,3,0,560,593,20
Task 561,Job 0,5,5,4,8,1,9,13,4,4,3,0,561,595,7
Task 561,Job 1,10,10,3,9,0,13,19,6,3,3,2,561,595,11
Task 562,Job 0,9,9,1,8,0,10,17,7,1,1,0,562,596,13
Task 562,Job 1,14,8,4,10,0,18,24,6,4,1,1,562,596,7
Task 563,Job 0,6,7,3,6,0,9,12,3,3,3,0,563,597,20
Task 563,Job 1,11,5,3,8,1,14,19,5,3,3,0,563,597,19
Task 564,Job 0,2,4,1,6,0,3,8,5,1,2,2,564,597,20
Task 564,Job 1,7,4,3,12,0,10,19,9,3,3,2,564,597,11
Task 565,Job 0,9,4,4,7,1,13,16,3,4,1,2,565,599,18
Task 565,Job 1,14,8,4,10,0,18,24,6,4,1,0,565,599,7
Task 566,Job 0,1,4,3,7,0,4,8,4,3,4,1,566,599,13
Task 566,Job 1,6,5,3,7,0,9,13,4,3,4,1,566,599,20
Task 567,Job 0,10,7,2,8,1,12,18,6,2,4,0,567,600,8
Task 567,Job 1,15,8,2,12,1,17,27,10,2,2,2,567,600,13
Task 568,Job 0,10,5,1,8,0,11,18,7,1,2,1,568,601,4
Task 568,Job 1,15,5,4,6,1,19,21,2,4,4,0,568,601,16
Task 569,Job 0,2,5,1,10,1,3,12,9,1,1,1,569,602,3
Task 569,Job 1,7,7,3,9,0,10,16,6,3,1,2,569,602,4
Task 570,Job 0,4,7,2,12,0,6,16,10,2,3,2,570,603,3
Task 570,Job 1,9,9,3,7,1,12,16,4,3,2,1,570,603,16
Task 571,Job 0,5,4,3,6,0,8,11,3,3,2,2,571,605,16
Task 571,Job 1,10,4,3,10,0,13,20,7,3,3,2,571,605,2
Task 572,Job 0,4,6,2,7,0,6,11,5,2,2,0,572,605,4
Task 572,Job 1,9,10,2,11,1,11,20,9,2,2,0,572,605,16
Task 573,Job 0,1,7,3,12,0,4,13,9,3,1,2,573,607,14
Task 573,Job 1,6,6,3,8,0,9,14,5,3,2,0,573,607,15
Task 574,Job 0,10,6,4,7,1,14,17,3,4,2,0,574,607,16
Task 574,Job 1,15,5,4,8,0,19,23,4,4,2,1,574,607,11
Task 575,Job 0,7,6,4,6,0,11,13,2,4,4,1,575,608,11
Task 575,Job 1,12,10,2,9,0,14,21,7,2,3,2,575,608,20
Task 576,Job 0,5,6,3,9,1,8,14,6,3,3,1,576,609,3
Task 576,Job 1,10,5,2,10,0,12,20,8,2,4,0,576,609,9
Task 577,Job 0,7,5,4,11,0,11,18,7,4,2,1,577,610,7
Task 577,Job 1,12,9,4,7,0,16,19,3,4,2,1,577,610,4
Task 578,Job 0,5,7,4,7,0,9,12,3,4,3,1,578,612,6
Task 578,Job 1,10,4,1,10,1,11,20,9,1,1,0,578,612,4
Task 579,Job 0,4,9,2,10,1,6,14,8,2,2,0,579,612,5
Task 579,Job 1,9,6,2,11,1,11,20,9,2,1,1,579,612,16
Task 580,Job 0,7,5,1,7,0,8,14,6,1,2,0,580,613,9
Task 580,Job 1,12,7,1,7,0,13,19,6,1,2,2,580,613,20
Task 581,Job 0,6,6,1,10,0,7,16,9,1,3,1,581,614,14
Task 581,Job 1,11,10,3,6,0,14,17,3,3,1,0,581,614,7
Task 582,Job 0,7,4,4,10,0,11,17,6,4,2,2,582,615,18
Task 582,Job 1,12,7,4,11,0,16,23,7,4,4,1,582,615,19
Task 583,Job 0,10,9,3,10,0,13,20,7,3,4,0,583,617,6
Task 583,Job 1,15,9,4,10,0,19,25,6,4,4,1,583,617,15
Task 584,Job 0,5,5,2,12,0,7,17,10,2,3,0,584,617,8
Task 584,Job 1,10,10,1,11,0,11,21,10,1,4,1,584,617,5
Task 585,Job 0,1,5,1,8,1,2,9,7,1,4,1,585,619,4
Task 585,Job 1,6,5,1,6,0,7,12,5,1,4,1,585,619,13
Task 586,Job 0,9,5,4,6,0,13,15,2,4,2,0,586,619,4
Task 586,Job 1,14,6,2,12,0,16,26,10,2,3,0,586,619,17
Task 587,Job 0,6,10,3,8,0,9,14,5,3,3,0,587,620,18
Task 587,Job 1,11,4,2,10,0,13,21,8,2,3,1,587,620,3
Task 588,Job 0,2,5,1,9,1,3,11,8,1,4,2,588,621,12
Task 588,Job 1,7,5,4,9,0,11,16,5,4,3,2,588,621,10
Task 589,Job 0,9,9,1,8,0,10,17,7,1,3,2,589,623,9
Task 589,Job 1,14,10,4,9,0,18,23,5,4,3,2,589,623,10
Task 590,Job 0,7,7,3,12,0,10,19,9,3,2,0,590,623,5
Task 590,Job 1,12,9,1,6,1,13,18,5,1,4,0,590,623,11
Task 591,Job 0,2,8,2,7,0,4,9,5,2,1,2,591,624,11
Task 591,Job 1,7,5,2,11,1,9,18,9,2,2,0,591,624,10
Task 592,Job 0,2,6,1,12,1,3,14,11,1,2,2,592,626,7
Task 592,Job 1,7,4,3,6,0,10,13,3,3,2,2,592,626,3
Task 593,Job 0,2,8,3,8,1,5,10,5,3,4,2,593,627,8
Task 593,Job 1,7,4,4,7,0,11,14,3,4,1,2,593,627,10
Task 594,Job 0,9,4,1,9,0,10,18,8,1,4,1,594,627,7
Task 594,Job 1,14,6,2,9,0,16,23,7,2,1,2,594,627,11
Task 595,Job 0,9,9,4,7,0,13,16,3,4,2,1,595,629,9
Task 595,Job 1,14,5,3,9,0,17,23,6,3,1,1,595,629,10
Task 596,Job 0,9,8,2,7,1,11,16,5,2,2,1,596,629,3
Task 596,Job 1,14,9,2,10,0,16,24,8,2,4,2,596,629,12
Task 597,Job 0,9,8,2,12,0,11,21,10,2,2,1,597,631,17
Task 597,Job 1,14,8,4,11,1,18,25,7,4,2,2,597,631,13
Task 598,Job 0,8,7,3,6,0,11,14,3,3,1,0,598,632,7
Task 598,Job 1,13,6,4,7,0,17,20,3,4,2,1,598,632,8
Task 599,Job 0,6,8,3,6,0,9,12,3,3,2,0,599,632,10
Task 599,Job 1,11,4,4,11,0,15,22,7,4,2,2,599,632,6
Task 600,Job 0,4,5,1,11,1,5,15,10,1,4,0,600,634,7
Task 600,Job 1,9,6,4,9,1,13,18,5,4,3,1,600,634,2
Task 601,Job 0,1,7,1,9,0,2,10,8,1,2,2,601,634,12
Task 601,Job 1,6,4,4,6,0,10,12,2,4,1,0,601,634,14
Task 602,Job 0,3,7,2,7,0,5,10,5,2,1,0,602,635,16
Task 602,Job 1,8,9,4,6,0,12,14,2,4,2,1,602,635,19
Task 603,Job 0,1,7,3,6,0,4,7,3,3,3,0,603,637,12
Task 603,Job 1,6,6,2,7,1,8,13,5,2,2,0,603,637,10
Task 604,Job 0,6,5,2,12,0,8,18,10,2,1,1,604,638,6
Task 604,Job 1,11,8,4,9,1,15,20,5,4,1,2,604,638,16
Task 605,Job 0,7,6,2,11,0,9,18,9,2,1,2,605,639,12
Task 605,Job 1,12,10,3,12,0,15,24,9,3,1,2,605,639,11
Task 606,Job 0,2,5,3,9,0,5,11,6,3,3,2,606,640,6
Task 606,Job 1,7,6,3,9,0,10,16,6,3,2,1,606,640,5
Task 607,Job 0,7,9,1,12,0,8,19,11,1,3,1,607,640,10
Task 607,Job 1,12,7,1,10,0,13,22,9,1,1,0,607,640,17
Task 608,Job 0,1,9,4,6,0,5,7,2,4,4,0,608,641,16
Task 608,Job 1,6,9,4,9,0,10,15,5,4,4,1,608,641,3
Task 609,Job 0,5,9,1,6,0,6,11,5,1,3,2,609,642,10
Task 609,Job 1,10,7,4,8,1,14,18,4,4,3,1,609,642,7
Task 610,Job 0,2,8,1,10,1,3,12,9,1,2,0,610,643,6
Task 610,Job 1,7,6,3,7,1,10,14,4,3,4,2,610,643,5
Task 611,Job 0,3,8,3,12,0,6,15,9,3,2,0,611,644,10
Task 611,Job 1,8,10,4,8,1,12,16,4,4,2,2,611,644,11
Task 612,Job 0,6,10,4,8,0,10,14,4,4,2,1,612,645,18
Task 612,Job 1,11,9,3,9,0,14,20,6,3,3,2,612,645,8
Task 613,Job 0,7,5,3,6,0,10,13,3,3,3,2,613,646,8
Task 613,Job 1,12,8,1,7,0,13,19,6,1,2,1,613,646,3
Task 614,Job 0,5,4,1,10,0,6,15,9,1,3,0,614,648,6
Task 614,Job 1,10,8,4,9,0,14,19,5,4,1,1,614,648,10
Task 615,Job 0,10,5,4,7,0,14,17,3,4,4,2,615,648,12
Task 615,Job 1,15,10,1,10,0,16,25,9,1,2,1,615,648,5
Task 616,Job 0,9,7,4,6,1,13,15,2,4,3,0,616,650,12
Task 616,Job 1,14,6,2,9,0,16,23,7,2,4,0,616,650,11
Task 617,Job 0,6,7,2,6,0,8,12,4,2,4,1,617,651,11
Task 617,Job 1,11,4,4,6,0,15,17,2,4,2,2,617,651,8
Task 618,Job 0,5,10,4,7,0,9,12,3,4,2,2,618,652,9
Task 618,Job 1,10,7,4,10,1,14,20,6,4,1,1,618,652,19
Task 619,Job 0,4,9,2,6,0,6,10,4,2,3,0,619,653,8
Task 619,Job 1,9,4,3,9,0,12,18,6,3,3,1,619,653,18
Task 620,Job 0,1,9,2,6,0,3,7,4,2,4,0,620,653,20
Task 620,Job 1,6,5,1,11,0,7,17,10,1,4,1,620,653,18
Task 621,Job 0,9,10,1,11,0,10,20,10,1,3,2,621,655,16
Task 621,Job 1,14,8,3,11,0,17,25,8,3,2,1,621,655,18
Task 622,Job 0,8,5,1,9,0,9,17,8,1,1,1,622,656,3
Task 622,Job 1,13,6,1,7,0,14,20,6,1,1,1,622,656,2
Task 623,Job 0,5,9,1,8,0,6,13,7,1,2,1,623,657,15
Task 623,Job 1,10,5,1,10,0,11,20,9,1,2,2,623,657,2
Task 624,Job 0,3,6,2,12,0,5,15,10,2,1,1,624,658,14
Task 624,Job 1,8,10,2,6,1,10,14,4,2,4,0,624,658,19
Task 625,Job 0,8,9,3,8,0,11,16,5,3,2,1,625,659,7
Task 625,Job 1,13,6,3,7,0,16,20,4,3,2,0,625,659,5
Task 626,Job 0,9,8,1,7,0,10,16,6,1,3,0,626,659,13
Task 626,Job 1,14,10,2,8,0,16,22,6,2,2,1,626,659,10
Task 627,Job 0,8,5,3,12,0,11,20,9,3,3,1,627,660,19
Task 627,Job 1,13,6,2,9,0,15,22,7,2,3,1,627,660,6
Task 628,Job 0,10,8,1,8,0,11,18,7,1,3,0,628,661,12
Task 628,Job 1,15,5,4,9,0,19,24,5,4,3,0,628,661,2
Task 629,Job 0,3,6,4,7,0,7,10,3,4,2,0,629,663,17
Task 629,Job 1,8,10,3,12,0,11,20,9,3,2,0,629,663,11
Task 630,Job 0,1,10,1,8,0,2,9,7,1,2,0,630,664,5
Task 630,Job 1,6,4,1,11,0,7,17,10,1,4,2,630,664,17
Task 631,Job 0,4,9,1,12,0,5,16,11,1,3,1,631,665,16
Task 631,Job 1,9,8,1,10,0,10,19,9,1,1,1,631,665,19
Task 632,Job 0,8,8,2,6,0,10,14,4,2,2,1,632,666,6
Task 632,Job 1,13,9,1,7,0,14,20,6,1,4,0,632,666,16
Task 633,Job 0,3,9,3,11,1,6,14,8,3,1,0,633,667,12
Task 633,Job 1,8,4,2,8,0,10,16,6,2,1,0,633,667,16
Task 634,Job 0,5,6,3,10,0,8,15,7,3,4,1,634,667,17
Task 634,Job 1,10,5,2,6,0,12,16,4,2,3,2,634,667,9
Task 635,Job 0,5,5,1,8,1,6,13,7,1,3,2,635,668,20
Task 635,Job 1,10,4,2,11,0,12,21,9,2,3,2,635,668,13
Task 636,Job 0,7,6,4,7,0,11,14,3,4,1,2,636,669,17
Task 636,Job 1,12,8,2,11,0,14,23,9,2,2,0,636,669,19
Task 637,Job 0,5,9,3,8,1,8,13,5,3,3,1,637,671,14
Task 637,Job 1,10,4,1,10,0,11,20,9,1,2,0,637,671,14
Task 638,Job 0,2,5,2,12,1,4,14,10,2,1,1,638,671,2
Task 638,Job 1,7,10,4,7,0,11,14,3,4,1,2,638,671,11
Task 639,Job 0,3,9,3,7,0,6,10,4,3,2,1,639,673,3
Task 639,Job 1,8,10,1,8,0,9,16,7,1,2,2,639,673,6
Task 640,Job 0,3,5,4,10,0,7,13,6,4,4,0,640,674,17
Task 640,Job 1,8,10,4,12,0,12,20,8,4,2,0,640,674,8
Task 641,Job 0,8,10,1,10,0,9,18,9,1,4,0,641,674,10
Task 641,Job 1,13,9,1,8,1,14,21,7,1,2,2,641,674,8
Task 642,Job 0,2,5,4,12,0,6,14,8,4,1,1,642,675,7
Task 642,Job 1,7,9,4,12,0,11,19,8,4,4,1,642,675,5
Task 643,Job 0,8,8,2,10,0,10,18,8,2,2,1,643,677,20
Task 643,Job 1,13,7,3,7,0,16,20,4,3,1,0,643,677,16
Task 644,Job 0,8,9,2,8,0,10,16,6,2,4,2,644,678,8
Task 644,Job 1,13,4,1,7,0,14,20,6,1,4,1,644,678,5
Task 645,Job 0,2,6,1,11,1,3,13,10,1,4,1,645,678,15
Task 645,Job 1,7,10,4,11,1,11,18,7,4,4,0,645,678,18
Task 646,Job 0,10,8,1,8,0,11,18,7,1,2,1,646,679,20
Task 646,Job 1,15,4,2,8,0,17,23,6,2,3,1,646,679,9
Task 647,Job 0,10,9,2,9,0,12,19,7,2,3,1,647,681,11
Task 647,Job 1,15,5,3,10,0,18,25,7,3,2,1,647,681,4
Task 648,Job 0,8,4,3,9,0,11,17,6,3,2,2,648,682,19
Task 648,Job 1,13,8,4,11,0,17,24,7,4,3,1,648,682,20
Task 649,Job 0,1,4,3,11,0,4,12,8,3,4,2,649,683,2
Task 649,Job 1,6,10,2,10,1,8,16,8,2,3,2,649,683,16
Task 650,Job 0,9,7,1,11,0,10,20,10,1,3,1,650,683,6
Task 650,Job 1,14,7,3,10,1,17,24,7,3,2,2,650,683,17
Task 651,Job 0,8,10,2,8,1,10,16,6,2,3,2,651,685,4
Task 651,Job 1,13,4,3,12,1,16,25,9,3,4,1,651,685,3
Task 652,Job 0,3,9,2,8,0,5,11,6,2,4,1,652,685,3
Task 652,Job 1,8,9,4,10,0,12,18,6,4,4,2,652,685,16
Task 653,Job 0,10,6,3,6,1,13,16,3,3,2,1,653,687,7
Task 653,Job 1,15,4,1,11,0,16,26,10,1,2,2,653,687,16
Task 654,Job 0,5,9,2,6,0,7,11,4,2,3,2,654,687,4
Task 654,Job 1,10,7,4,11,0,14,21,7,4,2,2,654,687,14
Task 655,Job 0,1,10,2,10,0,3,11,8,2,3,0,655,689,14
Task 655,Job 1,6,6,3,10,0,9,16,7,3,2,1,655,689,18
Task 656,Job 0,10,8,3,8,0,13,18,5,3,3,0,656,689,14
Task 656,Job 1,15,10,2,8,0,17,23,6,2,1,0,656,689,15
Task 657,Job 0,6,7,2,7,0,8,13,5,2,4,1,657,691,6
Task 657,Job 1,11,5,4,9,0,15,20,5,4,1,1,657,691,17
Task 658,Job 0,7,8,2,8,0,9,15,6,2,4,0,658,692,17
Task 658,Job 1,12,10,4,7,0,16,19,3,4,4,2,658,692,6
Task 659,Job 0,8,10,3,12,0,11,20,9,3,4,1,659,692,15
Task 659,Job 1,13,7,2,8,1,15,21,6,2,3,2,659,692,20
Task 660,Job 0,10,5,2,11,0,12,21,9,2,2,1,660,693,16
Task 660,Job 1,15,9,1,7,0,16,22,6,1,3,0,660,693,5
Task 661,Job 0,5,6,3,7,0,8,12,4,3,2,2,661,694,7
Task 661,Job 1,10,4,1,7,0,11,17,6,1,1,1,661,694,4
Task 662,Job 0,5,7,4,12,0,9,17,8,4,2,1,662,695,18
Task 662,Job 1,10,5,2,9,0,12,19,7,2,1,1,662,695,5
Task 663,Job 0,6,10,4,10,0,10,16,6,4,2,1,663,696,14
Task 663,Job 1,11,9,1,7,0,12,18,6,1,4,2,663,696,19
Task 664,Job 0,3,9,1,7,1,4,10,6,1,2,0,664,697,16
Task 664,Job 1,8,9,2,9,1,10,17,7,2,2,0,664,697,3
Task 665,Job 0,10,5,3,6,0,13,16,3,3,1,2,665,699,14
Task 665,Job 1,15,5,2,9,1,17,24,7,2,2,2,665,699,8
Task 666,Job 0,8,10,2,11,0,10,19,9,2,1,0,666,700,17
Task 666,Job 1,13,7,2,8,0,15,21,6,2,3,1,666,700,5
Task 667,Job 0,3,4,2,7,1,5,10,5,2,4,2,667,701,16
Task 667,Job 1,8,8,1,11,0,9,19,10,1,2,1,667,701,20
Task 668,Job 0,7,10,1,10,0,8,17,9,1,3,0,668,702,6
Task 668,Job 1,12,4,3,10,1,15,22,7,3,1,2,668,702,5
Task 669,Job 0,8,10,4,7,0,12,15,3,4,4,1,669,703,3
Task 669,Job 1,13,10,4,9,0,17,22,5,4,2,2,669,703,14
Task 670,Job 0,10,4,2,12,0,12,22,10,2,3,1,670,704,14
Task 670,Job 1,15,4,2,11,1,17,26,9,2,4,2,670,704,4
Task 671,Job 0,3,9,3,11,1,6,14,8,3,2,2,671,704,17
Task 671,Job 1,8,9,4,7,0,12,15,3,4,2,1,671,704,15
Task 672,Job 0,4,10,3,10,0,7,14,7,3,3,2,672,706,11
Task 672,Job 1,9,4,4,11,0,13,20,7,4,2,2,672,706,3
Task 673,Job 0,5,6,1,8,0,6,13,7,1,1,0,673,706,15
Task 673,Job 1,10,5,1,10,1,11,20,9,1,2,0,673,706,10
Task 674,Job 0,1,6,2,9,1,3,10,7,2,2,1,674,708,2
Task 674,Job 1,6,8,4,11,0,10,17,7,4,1,0,674,708,6
Task 675,Job 0,6,5,4,12,1,10,18,8,4,2,2,675,708,13
Task 675,Job 1,11,4,4,7,0,15,18,3,4,4,1,675,708,4
Task 676,Job 0,5,6,4,12,0,9,17,8,4,1,2,676,710,13
Task 676,Job 1,10,9,1,6,0,11,16,5,1,3,0,676,710,10
Task 677,Job 0,3,8,3,7,0,6,10,4,3,3,0,677,711,4
Task 677,Job 1,8,10,4,10,1,12,18,6,4,4,2,677,711,17
Task 678,Job 0,10,4,4,7,0,14,17,3,4,2,0,678,712,7
Task 678,Job 1,15,8,1,10,0,16,25,9,1,4,0,678,712,9
Task 679,Job 0,3,8,1,7,0,4,10,6,1,1,0,679,713,11
Task 679,Job 1,8,8,2,6,0,10,14,4,2,3,2,679,713,6
Task 680,Job 0,6,4,1,12,0,7,18,11,1,2,1,680,714,14
Task 680,Job 1,11,7,2,6,0,13,17,4,2,4,1,680,714,5
Task 681,Job 0,7,6,3,10,0,10,17,7,3,2,1,681,714,13
Task 681,Job 1,12,4,1,7,0,13,19,6,1,1,2,681,714,18
Task 682,Job 0,5,7,2,12,0,7,17,10,2,1,1,682,716,11
Task 682,Job 1,10,10,3,12,0,13,22,9,3,4,1,682,716,11
Task 683,Job 0,3,10,4,12,1,7,15,8,4,4,0,683,716,20
Task 683,Job 1,8,4,1,9,1,9,17,8,1,1,2,683,716,17
Task 684,Job 0,2,4,4,11,0,6,13,7,4,1,0,684,717,10
Task 684,Job 1,7,6,4,11,1,11,18,7,4,4,0,684,717,3
Task 685,Job 0,8,6,3,10,0,11,18,7,3,2,1,685,718,7
Task 685,Job 1,13,4,4,9,0,17,22,5,4,2,2,685,718,20
Task 686,Job 0,3,6,1,10,0,4,13,9,1,2,2,686,720,11
Task 686,Job 1,8,9,3,8,1,11,16,5,3,2,0,686,720,14
Task 687,Job 0,2,6,4,10,0,6,12,6,4,4,1,687,721,6
Task 687,Job 1,7,6,4,9,0,11,16,5,4,2,0,687,721,5
Task 688,Job 0,5,6,4,11,0,9,16,7,4,4,2,688,721,16
Task 688,Job 1,10,7,1,7,0,11,17,6,1,1,0,688,721,7
Task 689,Job 0,9,4,1,7,0,10,16,6,1,3,1,689,722,10
Task 689,Job 1,14,6,3,9,0,17,23,6,3,2,1,689,722,20
Task 690,Job 0,3,10,1,9,0,4,12,8,1,1,1,690,723,13
Task 690,Job 1,8,7,1,9,0,9,17,8,1,1,1,690,723,17
Task 691,Job 0,10,7,1,12,0,11,22,11,1,1,1,691,725,19
Task 691,Job 1,15,9,3,9,0,18,24,6,3,4,2,691,725,10
Task 692,Job 0,5,8,4,11,0,9,16,7,4,3,2,692,725,8
Task 692,Job 1,10,6,2,12,1,12,22,10,2,2,2,692,725,16
Task 693,Job 0,3,6,1,9,1,4,12,8,1,2,2,693,727,20
Task 693,Job 1,8,8,4,6,0,12,14,2,4,4,0,693,727,18
Task 694,Job 0,2,6,2,9,1,4,11,7,2,1,1,694,728,19
Task 694,Job 1,7,9,4,6,0,11,13,2,4,1,1,694,728,19
Task 695,Job 0,3,6,3,10,0,6,13,7,3,4,2,695,728,19
Task 695,Job 1,8,4,2,6,0,10,14,4,2,2,0,695,728,11
Task 696,Job 0,1,5,1,6,0,2,7,5,1,1,0,696,729,5
Task 696,Job 1,6,9,3,11,0,9,17,8,3,3,1,696,729,14
Task 697,Job 0,10,10,4,12,0,14,22,8,4,4,1,697,731,8
Task 697,Job 1,15,8,1,7,1,16,22,6,1,3,2,697,731,9
Task 698,Job 0,8,5,3,11,0,11,19,8,3,4,2,698,731,16
Task 698,Job 1,13,5,2,11,0,15,24,9,2,2,0,698,731,5
Task 699,Job 0,2,8,4,10,0,6,12,6,4,2,0,699,733,12
Task 699,Job 1,7,8,1,12,1,8,19,11,1,3,2,699,733,11
Task 700,Job 0,5,9,3,6,0,8,11,3,3,4,0,700,734,18
Task 700,Job 1,10,5,4,6,0,14,16,2,4,1,1,700,734,10
Task 701,Job 0,2,4,3,10,0,5,12,7,3,3,1,701,735,15
Task 701,Job 1,7,7,4,12,0,11,19,8,4,2,0,701,735,15
Task 702,Job 0,9,4,3,9,0,12,18,6,3,2,0,702,735,20
Task 702,Job 1,14,4,3,8,0,17,22,5,3,3,2,702,735,6
Task 703,Job 0,4,4,1,7,0,5,11,6,1,1,0,703,737,5
Task 703,Job 1,9,5,4,6,1,13,15,2,4,1,0,703,737,20
Task 704,Job 0,6,6,1,7,0,7,13,6,1,2,1,704,737,6
Task 704,Job 1,11,6,3,8,0,14,19,5,3,1,0,704,737,15
Task 705,Job 0,4,4,2,9,0,6,13,7,2,3,2,705,738,3
Task 705,Job 1,9,10,1,12,0,10,21,11,1,2,0,705,738,2
Task 706,Job 0,3,9,3,10,0,6,13,7,3,1,0,706,740,13
Task 706,Job 1,8,7,2,9,0,10,17,7,2,3,0,706,740,10
Task 707,Job 0,1,10,1,8,1,2,9,7,1,1,0,707,741,16
Task 707,Job 1,6,5,2,12,0,8,18,10,2,2,0,707,741,9
Task 708,Job 0,6,9,3,11,0,9,17,8,3,3,2,708,741,8
Task 708,Job 1,11,8,3,12,0,14,23,9,3,4,2,708,741,19
Task 709,Job 0,8,10,2,6,0,10,14,4,2,1,0,709,742,8
Task 709,Job 1,13,9,3,8,0,16,21,5,3,2,2,709,742,19
Task 710,Job 0,1,4,1,12,0,2,13,11,1,4,2,710,744,8
Task 710,Job 1,6,9,2,8,1,8,14,6,2,2,1,710,744,2
Task 711,Job 0,1,4,1,9,0,2,10,8,1,2,1,711,745,5
Task 711,Job 1,6,6,1,11,0,7,17,10,1,4,0,711,745,5
Task 712,Job 0,2,8,1,6,0,3,8,5,1,1,2,712,745,16
Task 712,Job 1,7,4,4,10,0,11,17,6,4,3,1,712,745,3
Task 713,Job 0,6,6,2,7,0,8,13,5,2,3,1,713,747,18
Task 713,Job 1,11,8,2,10,0,13,21,8,2,1,0,713,747,3
Task 714,Job 0,10,7,1,7,0,11,17,6,1,3,1,714,748,7
Task 714,Job 1,15,7,4,8,1,19,23,4,4,4,2,714,748,5
Task 715,Job 0,1,8,1,7,0,2,8,6,1,2,1,715,748,2
Task 715,Job 1,6,8,2,11,1,8,17,9,2,1,2,715,748,9
Task 716,Job 0,4,6,2,8,0,6,12,6,2,1,0,716,750,3
Task 716,Job 1,9,6,2,6,1,11,15,4,2,4,2,716,750,8
Task 717,Job 0,9,6,3,7,0,12,16,4,3,2,0,717,750,9
Task 717,Job 1,14,7,3,10,1,17,24,7,3,3,1,717,750,2
Task 718,Job 0,8,7,4,6,0,12,14,2,4,3,0,718,752,11
Task 718,Job 1,13,4,2,7,0,15,20,5,2,2,1,718,752,18
Task 719,Job 0,7,7,4,10,1,11,17,6,4,3,2,719,752,17
Task 719,Job 1,12,7,1,10,1,13,22,9,1,4,0,719,752,12
Task 720,Job 0,6,6,3,9,0,9,15,6,3,3,0,720,754,18
Task 720,Job 1,11,10,2,7,1,13,18,5,2,3,0,720,754,10
Task 721,Job 0,5,6,4,7,0,9,12,3,4,3,1,721,755,7
Task 721,Job 1,10,8,1,8,0,11,18,7,1,4,1,721,755,3
Task 722,Job 0,7,10,1,12,0,8,19,11,1,2,1,722,756,5
Task 722,Job 1,12,6,3,11,0,15,23,8,3,4,2,722,756,3
Task 723,Job 0,9,7,2,9,0,11,18,7,2,2,1,723,757,6
Task 723,Job 1,14,10,2,7,0,16,21,5,2,4,1,723,757,19
Task 724,Job 0,6,5,2,7,0,8,13,5,2,3,0,724,758,12
Task 724,Job 1,11,8,2,10,0,13,21,8,2,1,1,724,758,13
Task 725,Job 0,9,6,1,6,0,10,15,5,1,1,0,725,759,20
Task 725,Job 1,14,6,1,11,0,15,25,10,1,1,1,725,759,4
Task 726,Job 0,5,5,1,9,0,6,14,8,1,4,2,726,760,15
Task 726,Job 1,10,4,1,11,0,11,21,10,1,4,1,726,760,12
Task 727,Job 0,6,10,1,6,0,7,12,5,1,3,2,727,761,5
Task 727,Job 1,11,10,1,12,1,12,23,11,1,2,0,727,761,15
Task 728,Job 0,10,9,3,6,0,13,16,3,3,2,0,728,761,14
Task 728,Job 1,15,8,4,7,1,19,22,3,4,2,2,728,761,6
Task 729,Job 0,6,4,2,10,0,8,16,8,2,2,0,729,763,20
Task 729,Job 1,11,8,2,10,1,13,21,8,2,4,1,729,763,20
Task 730,Job 0,8,8,4,6,0,12,14,2,4,1,0,730,764,3
Task 730,Job 1,13,8,3,12,0,16,25,9,3,2,0,730,764,14
Task 731,Job 0,7,4,2,12,0,9,19,10,2,2,2,731,764,5
Task 731,Job 1,12,10,2,12,1,14,24,10,2,1,1,731,764,14
Task 732,Job 0,7,7,1,9,0,8,16,8,1,1,0,732,765,16
Task 732,Job 1,12,5,3,12,0,15,24,9,3,4,1,732,765,20
Task 733,Job 0,10,10,4,7,0,14,17,3,4,3,0,733,767,13
Task 733,Job 1,15,7,1,11,0,16,26,10,1,4,2,733,767,15
Task 734,Job 0,3,5,4,9,1,7,12,5,4,4,0,734,768,5
Task 734,Job 1,8,7,2,8,0,10,16,6,2,3,1,734,768,2
Task 735,Job 0,3,9,3,7,0,6,10,4,3,3,0,735,769,10
Task 735,Job 1,8,9,2,12,0,10,20,10,2,4,1,735,769,17
Task 736,Job 0,9,10,2,12,0,11,21,10,2,4,2,736,770,3
Task 736,Job 1,14,5,2,9,0,16,23,7,2,2,2,736,770,15
Task 737,Job 0,9,5,3,8,0,12,17,5,3,4,1,737,771,7
Task 737,Job 1,14,4,2,11,1,16,25,9,2,4,2,737,771,10
Task 738,Job 0,2,9,1,12,0,3,14,11,1,3,2,738,772,4
Task 738,Job 1,7,9,1,7,0,8,14,6,1,2,2,738,772,6
Task 739,Job 0,10,7,4,12,0,14,22,8,4,2,1,739,772,3
Task 739,Job 1,15,8,1,7,1,16,22,6,1,3,2,739,772,20
Task 740,Job 0,6,5,1,11,0,7,17,10,1,3,2,740,774,5
Task 740,Job 1,11,7,3,6,0,14,17,3,3,2,0,740,774,14
Task 741,Job 0,7,10,4,10,0,11,17,6,4,1,0,741,775,4
Task 741,Job 1,12,8,2,10,0,14,22,8,2,2,2,741,775,15
Task 742,Job 0,9,10,1,6,0,10,15,5,1,2,1,742,776,18
Task 742,Job 1,14,8,4,7,1,18,21,3,4,4,2,742,776,4
Task 743,Job 0,1,6,4,10,0,5,11,6,4,1,1,743,777,7
Task 743,Job 1,6,6,4,7,0,10,13,3,4,4,1,743,777,15
Task 744,Job 0,1,5,1,9,0,2,10,8,1,2,1,744,778,10
Task 744,Job 1,6,9,2,7,1,8,13,5,2,4,0,744,778,12
Task 745,Job 0,3,6,1,9,0,4,12,8,1,1,0,745,779,11
Task 745,Job 1,8,7,3,9,0,11,17,6,3,4,1,745,779,16
Task 746,Job 0,8,6,3,7,0,11,15,4,3,1,2,746,779,7
Task 746,Job 1,13,7,1,12,0,14,25,11,1,4,2,746,779,18
Task 747,Job 0,1,9,3,12,1,4,13,9,3,1,1,747,780,13
Task 747,Job 1,6,10,3,6,0,9,12,3,3,3,0,747,780,10
Task 748,Job 0,8,8,1,6,0,9,14,5,1,4,2,748,782,2
Task 748,Job 1,13,7,1,7,0,14,20,6,1,2,1,748,782,15
Task 749,Job 0,7,9,3,10,0,10,17,7,3,3,2,749,782,13
Task 749,Job 1,12,5,2,7,0,14,19,5,2,1,1,749,782,17
Task 750,Job 0,4,6,3,10,0,7,14,7,3,4,0,750,784,13
Task 750,Job 1,9,8,1,10,0,10,19,9,1,3,0,750,784,10
Task 751,Job 0,8,9,1,7,0,9,15,6,1,2,2,751,785,11
Task 751,Job 1,13,8,2,11,0,15,24,9,2,4,1,751,785,9
Task 752,Job 0,8,6,2,8,0,10,16,6,2,2,2,752,785,5
Task 752,Job 1,13,7,3,8,0,16,21,5,3,4,2,752,785,3
Task 753,Job 0,1,5,4,7,0,5,8,3,4,3,0,753,786,4
Task 753,Job 1,6,10,4,12,0,10,18,8,4,1,1,753,786,19
Task 754,Job 0,4,9,4,10,0,8,14,6,4,3,0,754,787,20
Task 754,Job 1,9,7,3,11,0,12,20,8,3,2,2,754,787,19
Task 755,Job 0,5,4,4,9,0,9,14,5,4,1,1,755,789,14
Task 755,Job 1,10,4,3,8,0,13,18,5,3,3,1,755,789,18
Task 756,Job 0,8,10,2,12,1,10,20,10,2,4,2,756,790,16
Task 756,Job 1,13,4,3,7,1,16,20,4,3,1,0,756,790,3
Task 757,Job 0,3,6,4,12,0,7,15,8,4,1,0,757,790,9
Task 757,Job 1,8,5,2,7,1,10,15,5,2,3,1,757,790,3
Task 758,Job 0,7,10,3,7,0,10,14,4,3,1,1,758,791,20
Task 758,Job 1,12,9,3,7,0,15,19,4,3,4,0,758,791,6
Task 759,Job 0,1,5,1,8,0,2,9,7,1,1,2,759,792,20
Task 759,Job 1,6,10,4,12,0,10,18,8,4,1,2,759,792,5
Task 760,Job 0,9,6,4,10,0,13,19,6,4,4,1,760,794,19
Task 760,Job 1,14,7,4,8,0,18,22,4,4,4,2,760,794,17
Task 761,Job 0,9,4,1,7,0,10,16,6,1,3,0,761,795,4
Task 761,Job 1,14,7,3,12,0,17,26,9,3,2,2,761,795,19
Task 762,Job 0,5,4,1,7,0,6,12,6,1,3,2,762,796,3
Task 762,Job 1,10,7,1,8,1,11,18,7,1,1,2,762,796,19
Task 763,Job 0,5,9,4,11,0,9,16,7,4,1,2,763,797,2
Task 763,Job 1,10,10,2,8,0,12,18,6,2,1,0,763,797,20
Task 764,Job 0,7,7,2,8,1,9,15,6,2,2,1,764,797,13
Task 764,Job 1,12,7,4,8,0,16,20,4,4,3,1,764,797,3
Task 765,Job 0,9,5,4,12,0,13,21,8,4,1,1,765,798,9
Task 765,Job 1,14,9,2,6,0,16,20,4,2,3,0,765,798,12
Task 766,Job 0,3,6,2,10,1,5,13,8,2,1,0,766,799,18
Task 766,Job 1,8,8,3,9,0,11,17,6,3,4,1,766,799,10
Task 767,Job 0,7,8,4,7,1,11,14,3,4,3,2,767,800,3
Task 767,Job 1,12,7,4,7,0,16,19,3,4,2,1,767,800,4
Task 768,Job 0,6,7,1,8,1,7,14,7,1,2,0,768,801,16
Task 768,Job 1,11,9,2,10,0,13,21,8,2,1,2,768,801,5
Task 769,Job 0,5,7,1,7,1,6,12,6,1,2,0,769,802,14
Task 769,Job 1,10,10,2,7,0,12,17,5,2,2,1,769,802,11
Task 770,Job 0,6,6,1,12,0,7,18,11,1,2,2,770,803,6
Task 770,Job 1,11,7,4,8,0,15,19,4,4,4,1,770,803,16
Task 771,Job 0,1,10,4,11,1,5,12,7,4,4,2,771,804,18
Task 771,Job 1,6,6,3,8,0,9,14,5,3,2,2,771,804,6
Task 772,Job 0,2,9,2,6,0,4,8,4,2,2,0,772,805,6
Task 772,Job 1,7,10,4,12,1,11,19,8,4,4,2,772,805,13
Task 773,Job 0,2,7,2,7,0,4,9,5,2,3,0,773,807,8
Task 773,Job 1,7,7,3,12,1,10,19,9,3,1,0,773,807,2
Task 774,Job 0,10,7,1,9,1,11,19,8,1,3,0,774,808,18
Task 774,Job 1,15,5,2,12,1,17,27,10,2,2,0,774,808,4
Task 775,Job 0,6,9,4,8,0,10,14,4,4,2,2,775,808,5
Task 775,Job 1,11,6,3,6,0,14,17,3,3,2,0,775,808,12
Task 776,Job 0,6,8,4,10,1,10,16,6,4,4,0,776,809,16
Task 776,Job 1,11,4,2,9,0,13,20,7,2,2,1,776,809,8
Task 777,Job 0,1,5,3,6,0,4,7,3,3,1,2,777,810,9
Task 777,Job 1,6,9,3,8,0,9,14,5,3,1,1,777,810,15
Task 778,Job 0,5,7,3,6,0,8,11,3,3,4,1,778,812,3
Task 778,Job 1,10,6,1,8,0,11,18,7,1,3,1,778,812,12
Task 779,Job 0,3,5,4,9,1,7,12,5,4,2,1,779,813,4
Task 779,Job 1,8,5,1,7,0,9,15,6,1,2,1,779,813,13
Task 780,Job 0,9,7,3,10,0,12,19,7,3,3,2,780,813,13
Task 780,Job 1,14,10,1,6,0,15,20,5,1,4,0,780,813,7
Task 781,Job 0,4,7,2,6,1,6,10,4,2,4,1,781,814,19
Task 781,Job 1,9,9,4,12,0,13,21,8,4,3,2,781,814,19
Task 782,Job 0,3,10,1,9,1,4,12,8,1,1,1,782,815,7
Task 782,Job 1,8,7,4,8,1,12,16,4,4,3,2,782,815,20
Task 783,Job 0,3,4,1,8,0,4,11,7,1,1,1,783,816,5
Task 783,Job 1,8,10,4,8,0,12,16,4,4,2,2,783,816,17
Task 784,Job 0,8,7,2,11,0,10,19,9,2,2,2,784,818,3
Task 784,Job 1,13,5,1,9,0,14,22,8,1,4,2,784,818,6
Task 785,Job 0,7,6,4,11,0,11,18,7,4,1,2,785,818,12
Task 785,Job 1,12,4,1,9,1,13,21,8,1,3,1,785,818,9
Task 786,Job 0,8,4,4,9,0,12,17,5,4,4,2,786,819,20
Task 786,Job 1,13,10,2,7,0,15,20,5,2,2,0,786,819,11
Task 787,Job 0,5,5,2,9,1,7,14,7,2,3,0,787,820,10
Task 787,Job 1,10,9,2,6,0,12,16,4,2,4,0,787,820,19
Task 788,Job 0,3,6,1,7,0,4,10,6,1,3,1,788,822,10
Task 788,Job 1,8,5,3,12,0,11,20,9,3,3,1,788,822,4
Task 789,Job 0,2,9,1,8,0,3,10,7,1,4,2,789,823,18
Task 789,Job 1,7,9,4,10,0,11,17,6,4,3,0,789,823,10
Task 790,Job 0,6,4,3,9,0,9,15,6,3,3,2,790,824,11
Task 790,Job 1,11,4,3,11,0,14,22,8,3,1,0,790,824,14
Task 791,Job 0,8,9,1,7,1,9,15,6,1,1,1,791,825,2
Task 791,Job 1,13,9,3,12,0,16,25,9,3,1,0,791,825,12
Task 792,Job 0,3,7,4,11,1,7,14,7,4,4,1,792,826,2
Task 792,Job 1,8,10,3,9,0,11,17,6,3,2,1,792,826,14
Task 793,Job 0,5,4,3,8,0,8,13,5,3,4,0,793,826,14
Task 793,Job 1,10,6,1,10,0,11,20,9,1,2,1,793,826,13
Task 794,Job 0,3,7,3,7,0,6,10,4,3,3,1,794,828,9
Task 794,Job 1,8,6,3,12,1,11,20,9,3,3,1,794,828,11
Task 795,Job 0,1,6,2,11,0,3,12,9,2,3,0,795,828,12
Task 795,Job 1,6,10,4,11,0,10,17,7,4,2,1,795,828,17
Task 796,Job 0,6,4,1,6,0,7,12,5,1,2,0,796,829,3
Task 796,Job 1,11,10,3,8,0,14,19,5,3,4,2,796,829,11
Task 797,Job 0,5,10,2,12,0,7,17,10,2,1,0,797,831,15
Task 797,Job 1,10,9,3,8,1,13,18,5,3,1,0,797,831,15
Task 798,Job 0,10,7,4,12,1,14,22,8,4,3,2,798,831,9
Task 798,Job 1,15,8,1,7,0,16,22,6,1,3,0,798,831,13
Task 799,Job 0,2,7,4,8,0,6,10,4,4,4,0,799,832,7
Task 799,Job 1,7,6,2,7,0,9,14,5,2,1,1,799,832,6
Task 800,Job 0,8,7,4,7,0,12,15,3,4,2,2,800,833,15
Task 800,Job 1,13,9,4,6,0,17,19,2,4,4,2,800,833,15
Task 801,Job 0,9,9,3,6,0,12,15,3,3,2,2,801,834,6
Task 801,Job 1,14,8,2,9,0,16,23,7,2,1,0,801,834,6
Task 802,Job 0,4,8,3,7,0,7,11,4,3,3,1,802,836,8
Task 802,Job 1,9,4,1,6,0,10,15,5,1,2,1,802,836,14
Task 803,Job 0,3,10,4,8,1,7,11,4,4,3,1,803,836,13
Task 803,Job 1,8,6,1,6,0,9,14,5,1,2,1,803,836,19
Task 804,Job 0,6,6,2,10,0,8,16,8,2,3,2,804,838,18
Task 804,Job 1,11,4,2,10,0,13,21,8,2,4,1,804,838,16
Task 805,Job 0,5,7,4,8,1,9,13,4,4,4,0,805,839,19
Task 805,Job 1,10,9,2,6,0,12,16,4,2,4,2,805,839,11
Task 806,Job 0,2,6,2,7,0,4,9,5,2,4,2,806,840,14
Task 806,Job 1,7,5,2,8,1,9,15,6,2,2,1,806,840,5
Task 807,Job 0,8,4,1,6,0,9,14,5,1,4,1,807,841,13
Task 807,Job 1,13,8,1,8,0,14,21,7,1,1,1,807,841,2
Task 808,Job 0,4,5,4,9,0,8,13,5,4,1,1,808,841,13
Task 808,Job 1,9,4,3,10,0,12,19,7,3,3,1,808,841,12
Task 809,Job 0,6,4,3,12,0,9,18,9,3,2,1,809,842,4
Task 809,Job 1,11,7,1,9,0,12,20,8,1,2,0,809,842,11
Task 810,Job 0,4,4,1,9,0,5,13,8,1,4,1,810,843,10
Task 810,Job 1,9,6,2,8,0,11,17,6,2,3,0,810,843,12
Task 811,Job 0,9,4,3,11,0,12,20,8,3,1,1,811,845,20
Task 811,Job 1,14,5,1,9,1,15,23,8,1,1,2,811,845,7
Task 812,Job 0,5,5,2,7,0,7,12,5,2,3,0,812,845,7
Task 812,Job 1,10,6,1,12,0,11,22,11,1,3,1,812,845,11
Task 813,Job 0,8,5,2,6,1,10,14,4,2,3,1,813,847,5
Task 813,Job 1,13,9,4,9,0,17,22,5,4,1,0,813,847,6
Task 814,Job 0,6,4,1,10,0,7,16,9,1,1,2,814,847,10
Task 814,Job 1,11,6,2,11,0,13,22,9,2,2,1,814,847,8
Task 815,Job 0,7,5,4,12,1,11,19,8,4,1,0,815,849,3
Task 815,Job 1,12,6,2,11,0,14,23,9,2,2,2,815,849,8
Task 816,Job 0,7,8,2,8,1,9,15,6,2,2,1,816,849,5
Task 816,Job 1,12,9,1,9,0,13,21,8,1,3,2,816,849,4
Task 817,Job 0,8,4,4,12,0,12,20,8,4,4,1,817,850,13
Task 817,Job 1,13,7,2,11,0,15,24,9,2,3,1,817,850,6
Task 818,Job 0,9,9,3,9,0,12,18,6,3,4,0,818,851,8
Task 818,Job 1,14,8,4,12,1,18,26,8,4,1,1,818,851,10
Task 819,Job 0,5,4,3,7,1,8,12,4,3,3,1,819,852,2
Task 819,Job 1,10,4,2,8,0,12,18,6,2,1,2,819,852,19
Task 820,Job 0,2,4,1,10,0,3,12,9,1,4,0,820,854,5
Task 820,Job 1,7,4,4,6,0,11,13,2,4,4,2,820,854,14
Task 821,Job 0,8,8,4,8,0,12,16,4,4,2,2,821,854,6
Task 821,Job 1,13,6,2,12,0,15,25,10,2,3,0,821,854,7
Task 822,Job 0,10,10,1,8,0,11,18,7,1,3,1,822,855,18
Task 822,Job 1,15,10,2,12,1,17,27,10,2,2,1,822,855,20
Task 823,Job 0,10,6,1,8,0,11,18,7,1,4,2,823,856,17
Task 823,Job 1,15,9,4,8,0,19,23,4,4,4,2,823,856,11
Task 824,Job 0,6,7,1,7,0,7,13,6,1,3,1,824,858,18
Task 824,Job 1,11,10,1,12,0,12,23,11,1,3,2,824,858,13
Task 825,Job 0,6,8,1,12,0,7,18,11,1,1,1,825,858,14
Task 825,Job 1,11,9,3,10,1,14,21,7,3,3,2,825,858,10
Task 826,Job 0,4,8,4,12,1,8,16,8,4,2,0,826,859,9
Task 826,Job 1,9,10,3,6,1,12,15,3,3,2,0,826,859,20
Task 827,Job 0,4,9,1,9,0,5,13,8,1,1,0,827,860,7
Task 827,Job 1,9,6,1,11,0,10,20,10,1,2,0,827,860,13
Task 828,Job 0,9,4,4,8,1,13,17,4,4,1,1,828,861,13
Task 828,Job 1,14,8,2,11,0,16,25,9,2,2,0,828,861,20
Task 829,Job 0,8,4,2,7,1,10,15,5,2,3,0,829,863,7
Task 829,Job 1,13,10,1,12,1,14,25,11,1,4,0,829,863,10
Task 830,Job 0,8,7,1,11,0,9,19,10,1,3,2,830,863,9
Task 830,Job 1,13,7,4,11,1,17,24,7,4,1,0,830,863,11
Task 831,Job 0,8,7,1,8,0,9,16,7,1,3,2,831,864,14
Task 831,Job 1,13,7,2,12,0,15,25,10,2,1,0,831,864,12
Task 832,Job 0,1,7,4,11,0,5,12,7,4,2,0,832,866,10
Task 832,Job 1,6,4,3,10,1,9,16,7,3,4,2,832,866,13
Task 833,Job 0,5,6,4,9,1,9,14,5,4,4,2,833,867,4
Task 833,Job 1,10,6,4,10,0,14,20,6,4,1,1,833,867,6
Task 834,Job 0,7,7,3,6,1,10,13,3,3,3,0,834,867,19
Task 834,Job 1,12,9,3,7,0,15,19,4,3,4,1,834,867,8
Task 835,Job 0,2,4,3,11,0,5,13,8,3,2,1,835,869,6
Task 835,Job 1,7,8,4,8,0,11,15,4,4,4,2,835,869,10
Task 836,Job 0,2,8,3,9,0,5,11,6,3,2,0,836,869,6
Task 836,Job 1,7,9,4,8,0,11,15,4,4,4,0,836,869,2
Task 837,Job 0,3,5,2,6,1,5,9,4,2,1,0,837,871,20
Task 837,Job 1,8,9,3,12,0,11,20,9,3,4,1,837,871,7
Task 838,Job 0,4,6,2,8,0,6,12,6,2,3,1,838,871,5
Task 838,Job 1,9,4,1,11,1,10,20,10,1,3,0,838,871,4
Task 839,Job 0,3,8,3,6,0,6,9,3,3,3,0,839,873,11
Task 839,Job 1,8,7,2,8,0,10,16,6,2,3,0,839,873,9
Task 840,Job 0,4,10,2,11,1,6,15,9,2,3,0,840,873,6
Task 840,Job 1,9,9,4,6,1,13,15,2,4,2,0,840,873,6
Task 841,Job 0,8,7,2,9,0,10,17,7,2,4,1,841,874,17
Task 841,Job 1,13,6,3,7,0,16,20,4,3,1,1,841,874,16
Task 842,Job 0,2,7,2,12,0,4,14,10,2,3,1,842,876,7
Task 842,Job 1,7,10,3,6,0,10,13,3,3,3,2,842,876,5
Task 843,Job 0,1,4,3,8,1,4,9,5,3,4,0,843,876,4
Task 843,Job 1,6,4,2,12,1,8,18,10,2,3,0,843,876,6
Task 844,Job 0,7,10,4,6,1,11,13,2,4,1,0,844,877,19
Task 844,Job 1,12,4,3,6,0,15,18,3,3,4,1,844,877,5
Task 845,Job 0,5,4,1,6,0,6,11,5,1,4,0,845,879,15
Task 845,Job 1,10,6,3,7,0,13,17,4,3,2,2,845,879,8
Task 846,Job 0,10,5,1,8,0,11,18,7,1,4,2,846,880,13
Task 846,Job 1,15,8,2,10,1,17,25,8,2,1,1,846,880,4
Task 847,Job 0,2,9,2,12,0,4,14,10,2,2,1,847,881,13
Task 847,Job 1,7,5,1,6,0,8,13,5,1,2,1,847,881,9
Task 848,Job 0,6,10,1,9,1,7,15,8,1,1,0,848,882,6
Task 848,Job 1,11,10,2,11,1,13,22,9,2,2,0,848,882,20
Task 849,Job 0,3,7,3,9,1,6,12,6,3,1,2,849,883,13
Task 849,Job 1,8,6,1,9,0,9,17,8,1,4,1,849,883,8
Task 850,Job 0,4,10,4,6,0,8,10,2,4,3,0,850,883,16
Task 850,Job 1,9,9,2,10,0,11,19,8,2,2,1,850,883,20
Task 851,Job 0,10,10,1,7,1,11,17,6,1,3,1,851,884,16
Task 851,Job 1,15,7,4,10,0,19,25,6,4,3,0,851,884,2
Task 852,Job 0,3,4,2,6,0,5,9,4,2,2,2,852,886,8
Task 852,Job 1,8,10,1,12,0,9,20,11,1,1,0,852,886,6
Task 853,Job 0,10,9,2,8,0,12,18,6,2,2,1,853,886,4
Task 853,Job 1,15,6,1,12,0,16,27,11,1,3,0,853,886,5
Task 854,Job 0,3,7,4,10,0,7,13,6,4,4,1,854,887,7
Task 854,Job 1,8,9,2,12,0,10,20,10,2,4,2,854,887,4
Task 855,Job 0,9,8,1,6,0,10,15,5,1,1,2,855,889,16
Task 855,Job 1,14,7,1,7,0,15,21,6,1,4,2,855,889,20
Task 856,Job 0,8,4,4,12,1,12,20,8,4,2,0,856,889,15
Task 856,Job 1,13,7,3,6,0,16,19,3,3,2,2,856,889,6
Task 857,Job 0,1,5,2,7,0,3,8,5,2,3,0,857,891,15
Task 857,Job 1,6,9,1,11,0,7,17,10,1,3,1,857,891,3
Task 858,Job 0,2,9,3,11,0,5,13,8,3,3,1,858,891,10
Task 858,Job 1,7,8,3,8,1,10,15,5,3,2,2,858,891,19
Task 859,Job 0,4,7,4,8,0,8,12,4,4,4,0,859,892,11
Task 859,Job 1,9,8,4,11,0,13,20,7,4,4,1,859,892,15
Task 860,Job 0,3,8,3,9,0,6,12,6,3,4,1,860,894,12
Task 860,Job 1,8,8,1,10,0,9,18,9,1,1,1,860,894,3
Task 861,Job 0,1,5,3,6,1,4,7,3,3,1,2,861,894,9
Task 861,Job 1,6,4,2,9,0,8,15,7,2,1,0,861,894,2
Task 862,Job 0,1,10,3,6,0,4,7,3,3,2,2,862,896,10
Task 862,Job 1,6,6,1,9,0,7,15,8,1,4,2,862,896,4
Task 863,Job 0,7,6,4,11,0,11,18,7,4,1,2,863,896,11
Task 863,Job 1,12,10,1,12,0,13,24,11,1,1,0,863,896,5
Task 864,Job 0,1,8,2,9,0,3,10,7,2,2,1,864,897,12
Task 864,Job 1,6,7,1,8,1,7,14,7,1,1,1,864,897,20
Task 865,Job 0,7,8,1,12,0,8,19,11,1,3,2,865,899,8
Task 865,Job 1,12,9,2,7,0,14,19,5,2,2,0,865,899,4
Task 866,Job 0,10,7,2,12,0,12,22,10,2,1,2,866,899,6
Task 866,Job 1,15,9,4,6,1,19,21,2,4,2,0,866,899,6
Task 867,Job 0,9,6,4,12,0,13,21,8,4,2,1,867,901,7
Task 867,Job 1,14,9,3,6,0,17,20,3,3,3,2,867,901,15
Task 868,Job 0,7,6,1,7,0,8,14,6,1,3,0,868,902,2
Task 868,Job 1,12,9,4,10,0,16,22,6,4,1,0,868,902,16
Task 869,Job 0,1,9,2,6,0,3,7,4,2,2,2,869,902,6
Task 869,Job 1,6,9,2,10,1,8,16,8,2,3,0,869,902,19
Task 870,Job 0,2,10,1,12,0,3,14,11,1,4,0,870,903,5
Task 870,Job 1,7,10,2,9,0,9,16,7,2,2,1,870,903,5
Task 871,Job 0,5,8,2,8,0,7,13,6,2,4,2,871,905,2
Task 871,Job 1,10,4,1,7,0,11,17,6,1,3,1,871,905,17
Task 872,Job 0,4,5,2,6,0,6,10,4,2,2,1,872,905,15
Task 872,Job 1,9,10,1,9,0,10,18,8,1,1,2,872,905,16
Task 873,Job 0,1,5,1,12,1,2,13,11,1,4,0,873,907,14
Task 873,Job 1,6,4,3,11,0,9,17,8,3,3,2,873,907,19
Task 874,Job 0,10,6,2,6,0,12,16,4,2,1,0,874,908,8
Task 874,Job 1,15,9,3,11,0,18,26,8,3,3,2,874,908,8
Task 875,Job 0,4,4,2,9,0,6,13,7,2,2,2,875,909,10
Task 875,Job 1,9,7,4,10,0,13,19,6,4,1,1,875,909,19
Task 876,Job 0,6,4,4,8,0,10,14,4,4,2,2,876,909,9
Task 876,Job 1,11,8,4,8,1,15,19,4,4,1,2,876,909,4
Task 877,Job 0,9,8,3,7,1,12,16,4,3,4,2,877,910,13
Task 877,Job 1,14,7,2,6,0,16,20,4,2,1,2,877,910,14
Task 878,Job 0,1,8,3,6,1,4,7,3,3,2,2,878,912,13
Task 878,Job 1,6,8,1,9,0,7,15,8,1,2,0,878,912,9
Task 879,Job 0,2,5,3,12,0,5,14,9,3,3,2,879,913,3
Task 879,Job 1,7,10,4,8,0,11,15,4,4,2,0,879,913,10
Task 880,Job 0,9,5,4,12,0,13,21,8,4,1,2,880,913,2
Task 880,Job 1,14,6,2,11,0,16,25,9,2,4,0,880,913,2
Task 881,Job 0,10,8,2,6,1,12,16,4,2,3,2,881,915,19
Task 881,Job 1,15,4,1,11,0,16,26,10,1,3,1,881,915,12
Task 882,Job 0,6,8,2,10,0,8,16,8,2,1,0,882,916,2
Task 882,Job 1,11,4,2,8,0,13,19,6,2,2,2,882,916,12
Task 883,Job 0,3,4,3,9,0,6,12,6,3,1,0,883,917,3
Task 883,Job 1,8,8,1,9,0,9,17,8,1,2,1,883,917,19
Task 884,Job 0,1,7,1,10,0,2,11,9,1,2,2,884,918,19
Task 884,Job 1,6,4,3,6,0,9,12,3,3,1,0,884,918,11
Task 885,Job 0,8,10,2,11,0,10,19,9,2,3,1,885,919,15
Task 885,Job 1,13,8,1,6,0,14,19,5,1,3,1,885,919,4
Task 886,Job 0,4,6,1,11,0,5,15,10,1,3,1,886,919,7
Task 886,Job 1,9,10,3,10,1,12,19,7,3,4,2,886,919,14
Task 887,Job 0,10,7,2,10,0,12,20,8,2,3,1,887,921,15
Task 887,Job 1,15,9,4,7,0,19,22,3,4,4,2,887,921,17
Task 888,Job 0,10,6,2,9,1,12,19,7,2,3,2,888,921,2
Task 888,Job 1,15,4,2,6,0,17,21,4,2,1,2,888,921,8
Task 889,Job 0,5,5,2,11,0,7,16,9,2,3,1,889,923,19
Task 889,Job 1,10,8,1,9,0,11,19,8,1,1,0,889,923,7
Task 890,Job 0,3,5,3,8,1,6,11,5,3,3,1,890,923,9
Task 890,Job 1,8,5,1,7,0,9,15,6,1,1,2,890,923,10
Task 891,Job 0,6,10,4,8,0,10,14,4,4,3,0,891,924,2
Task 891,Job 1,11,10,3,9,0,14,20,6,3,2,1,891,924,14
Task 892,Job 0,10,8,4,9,0,14,19,5,4,3,2,892,926,19
Task 892,Job 1,15,9,3,6,1,18,21,3,3,4,1,892,926,17
Task 893,Job 0,2,10,2,10,0,4,12,8,2,4,0,893,926,19
Task 893,Job 1,7,9,4,11,1,11,18,7,4,3,0,893,926,4
Task 894,Job 0,5,7,3,11,0,8,16,8,3,4,1,894,928,4
Task 894,Job 1,10,10,2,6,1,12,16,4,2,4,1,894,928,10
Task 895,Job 0,9,6,2,6,1,11,15,4,2,3,1,895,928,15
Task 895,Job 1,14,5,4,10,0,18,24,6,4,3,2,895,928,4
Task 896,Job 0,4,4,1,6,0,5,10,5,1,3,2,896,929,18
Task 896,Job 1,9,4,1,9,0,10,18,8,1,1,0,896,929,4
Task 897,Job 0,2,9,2,12,0,4,14,10,2,1,2,897,931,9
Task 897,Job 1,7,5,1,8,0,8,15,7,1,4,0,897,931,8
Task 898,Job 0,9,6,2,6,0,11,15,4,2,3,1,898,932,10
Task 898,Job 1,14,8,4,7,0,18,21,3,4,1,1,898,932,19
Task 899,Job 0,2,4,3,6,0,5,8,3,3,3,1,899,933,11
Task 899,Job 1,7,10,4,11,0,11,18,7,4,2,1,899,933,6
Task 900,Job 0,7,4,3,9,0,10,16,6,3,4,0,900,934,12
Task 900,Job 1,12,7,4,7,0,16,19,3,4,2,1,900,934,10
Task 901,Job 0,10,8,1,12,0,11,22,11,1,3,0,901,934,19
Task 901,Job 1,15,5,3,12,0,18,27,9,3,1,2,901,934,16
Task 902,Job 0,9,8,4,6,1,13,15,2,4,4,1,902,936,4
Task 902,Job 1,14,8,2,8,0,16,22,6,2,1,0,902,936,19
Task 903,Job 0,8,6,4,10,0,12,18,6,4,3,2,903,937,9
Task 903,Job 1,13,4,2,12,0,15,25,10,2,2,0,903,937,6
Task 904,Job 0,3,7,3,11,1,6,14,8,3,1,0,904,938,11
Task 904,Job 1,8,6,2,9,0,10,17,7,2,3,0,904,938,5
Task 905,Job 0,3,10,1,11,0,4,14,10,1,3,0,905,938,18
Task 905,Job 1,8,4,2,6,1,10,14,4,2,4,1,905,938,16
Task 906,Job 0,8,6,3,10,0,11,18,7,3,4,2,906,939,5
Task 906,Job 1,13,7,1,12,0,14,25,11,1,3,1,906,939,5
Task 907,Job 0,3,4,2,9,0,5,12,7,2,3,2,907,940,17
Task 907,Job 1,8,5,2,12,0,10,20,10,2,3,2,907,940,15
Task 908,Job 0,1,4,4,12,0,5,13,8,4,2,0,908,941,4
Task 908,Job 1,6,6,2,9,0,8,15,7,2,4,1,908,941,12
Task 909,Job 0,6,10,3,6,0,9,12,3,3,1,2,909,942,6
Task 909,Job 1,11,4,3,8,1,14,19,5,3,1,2,909,942,15
Task 910,Job 0,6,6,4,8,1,10,14,4,4,4,0,910,943,6
Task 910,Job 1,11,8,4,6,0,15,17,2,4,2,2,910,943,11
Task 911,Job 0,1,7,4,7,0,5,8,3,4,2,0,911,944,8
Task 911,Job 1,6,4,3,10,1,9,16,7,3,3,0,911,944,16
Task 912,Job 0,3,7,4,9,0,7,12,5,4,2,1,912,946,12
Task 912,Job 1,8,9,3,9,1,11,17,6,3,2,0,912,946,20
Task 913,Job 0,5,7,4,7,0,9,12,3,4,1,2,913,947,20
Task 913,Job 1,10,5,3,7,0,13,17,4,3,4,0,913,947,9
Task 914,Job 0,7,10,4,10,0,11,17,6,4,3,1,914,947,16
Task 914,Job 1,12,5,4,8,0,16,20,4,4,3,2,914,947,14
Task 915,Job 0,1,5,2,10,1,3,11,8,2,1,2,915,948,14
Task 915,Job 1,6,4,4,12,1,10,18,8,4,2,2,915,948,10
Task 916,Job 0,6,10,2,10,0,8,16,8,2,2,1,916,950,3
Task 916,Job 1,11,8,4,12,0,15,23,8,4,1,2,916,950,5
Task 917,Job 0,3,10,2,12,0,5,15,10,2,2,1,917,951,2
Task 917,Job 1,8,10,1,8,1,9,16,7,1,2,1,917,951,11
Task 918,Job 0,8,8,4,9,0,12,17,5,4,2,2,918,951,19
Task 918,Job 1,13,6,2,12,1,15,25,10,2,3,1,918,951,6
Task 919,Job 0,8,8,1,9,0,9,17,8,1,1,1,919,953,5
Task 919,Job 1,13,8,4,9,1,17,22,5,4,1,2,919,953,14
Task 920,Job 0,6,6,4,12,0,10,18,8,4,2,1,920,953,20
Task 920,Job 1,11,8,3,9,0,14,20,6,3,1,0,920,953,14
Task 921,Job 0,5,7,1,7,1,6,12,6,1,1,0,921,954,13
Task 921,Job 1,10,4,4,6,1,14,16,2,4,1,2,921,954,16
Task 922,Job 0,7,5,1,10,1,8,17,9,1,2,0,922,956,6
Task 922,Job 1,12,6,3,7,0,15,19,4,3,4,0,922,956,19
Task 923,Job 0,7,9,3,7,0,10,14,4,3,1,1,923,956,9
Task 923,Job 1,12,7,1,7,0,13,19,6,1,2,1,923,956,17
Task 924,Job 0,10,4,2,6,0,12,16,4,2,3,1,924,958,6
Task 924,Job 1,15,6,4,11,0,19,26,7,4,4,0,924,958,15
Task 925,Job 0,1,5,4,10,0,5,11,6,4,3,2,925,958,20
Task 925,Job 1,6,4,3,10,0,9,16,7,3,3,0,925,958,15
Task 926,Job 0,3,5,1,7,0,4,10,6,1,4,0,926,959,9
Task 926,Job 1,8,9,1,12,0,9,20,11,1,1,2,926,959,12
Task 927,Job 0,9,9,3,6,0,12,15,3,3,2,1,927,961,19
Task 927,Job 1,14,6,1,6,0,15,20,5,1,1,2,927,961,15
Task 928,Job 0,2,4,2,7,0,4,9,5,2,2,1,928,961,12
Task 928,Job 1,7,8,1,8,0,8,15,7,1,4,2,928,961,5
Task 929,Job 0,1,10,2,6,0,3,7,4,2,1,0,929,963,7
Task 929,Job 1,6,4,2,8,1,8,14,6,2,3,1,929,963,14
Task 930,Job 0,7,4,4,9,0,11,16,5,4,2,0,930,963,6
Task 930,Job 1,12,6,1,6,0,13,18,5,1,2,2,930,963,8
Task 931,Job 0,10,6,4,8,0,14,18,4,4,4,1,931,965,8
Task 931,Job 1,15,6,2,8,1,17,23,6,2,1,2,931,965,7
Task 932,Job 0,3,10,1,6,0,4,9,5,1,1,2,932,965,6
Task 932,Job 1,8,5,3,8,0,11,16,5,3,3,1,932,965,17
Task 933,Job 0,2,5,1,11,0,3,13,10,1,1,1,933,966,11
Task 933,Job 1,7,9,4,8,0,11,15,4,4,3,2,933,966,16
Task 934,Job 0,7,5,2,10,0,9,17,8,2,2,2,934,968,6
Task 934,Job 1,12,10,3,8,0,15,20,5,3,2,2,934,968,15
Task 935,Job 0,6,9,1,12,0,7,18,11,1,2,1,935,969,7
Task 935,Job 1,11,9,4,7,0,15,18,3,4,3,0,935,969,3
Task 936,Job 0,7,9,2,10,1,9,17,8,2,3,0,936,969,11
Task 936,Job 1,12,5,2,9,1,14,21,7,2,4,1,936,969,18
Task 937,Job 0,1,7,2,6,0,3,7,4,2,2,2,937,971,6
Task 937,Job 1,6,6,3,6,0,9,12,3,3,3,0,937,971,19
Task 938,Job 0,3,9,2,8,0,5,11,6,2,3,1,938,972,17
Task 938,Job 1,8,8,1,11,0,9,19,10,1,4,0,938,972,13
Task 939,Job 0,6,6,4,11,0,10,17,7,4,3,0,939,972,2
Task 939,Job 1,11,8,2,6,1,13,17,4,2,1,1,939,972,6
Task 940,Job 0,10,4,2,8,0,12,18,6,2,4,0,940,973,15
Task 940,Job 1,15,8,3,9,0,18,24,6,3,1,1,940,973,15
Task 941,Job 0,8,6,1,8,0,9,16,7,1,2,0,941,975,8
Task 941,Job 1,13,4,4,6,1,17,19,2,4,3,2,941,975,12
Task 942,Job 0,3,10,2,9,0,5,12,7,2,2,2,942,976,14
Task 942,Job 1,8,10,3,8,0,11,16,5,3,3,1,942,976,13
Task 943,Job 0,1,9,4,6,1,5,7,2,4,2,0,943,976,2
Task 943,Job 1,6,7,2,6,0,8,12,4,2,3,2,943,976,15
Task 944,Job 0,5,6,2,6,1,7,11,4,2,1,2,944,978,17
Task 944,Job 1,10,4,1,12,0,11,22,11,1,3,1,944,978,7
Task 945,Job 0,9,5,2,8,1,11,17,6,2,2,2,945,979,20
Task 945,Job 1,14,5,2,10,0,16,24,8,2,4,2,945,979,20
Task 946,Job 0,10,6,1,6,0,11,16,5,1,2,1,946,980,7
Task 946,Job 1,15,9,2,9,1,17,24,7,2,1,0,946,980,18
Task 947,Job 0,8,6,1,11,1,9,19,10,1,3,0,947,980,17
Task 947,Job 1,13,6,2,11,1,15,24,9,2,3,0,947,980,20
Task 948,Job 0,5,6,2,9,0,7,14,7,2,1,1,948,982,3
Task 948,Job 1,10,10,3,6,0,13,16,3,3,3,1,948,982,2
Task 949,Job 0,10,10,1,9,0,11,19,8,1,4,1,949,983,4
Task 949,Job 1,15,6,2,11,0,17,26,9,2,3,0,949,983,19
Task 950,Job 0,8,7,2,6,0,10,14,4,2,3,2,950,984,20
Task 950,Job 1,13,6,3,11,1,16,24,8,3,3,1,950,984,16
Task 951,Job 0,2,9,3,8,1,5,10,5,3,1,2,951,985,12
Task 951,Job 1,7,5,2,9,1,9,16,7,2,3,2,951,985,2
Task 952,Job 0,2,8,2,11,0,4,13,9,2,3,1,952,985,10
Task 952,Job 1,7,10,1,12,0,8,19,11,1,3,0,952,985,19
Task 953,Job 0,7,7,2,9,0,9,16,7,2,4,1,953,987,20
Task 953,Job 1,12,9,3,7,1,15,19,4,3,4,2,953,987,15
Task 954,Job 0,6,6,1,11,0,7,17,10,1,4,1,954,987,20
Task 954,Job 1,11,6,1,7,0,12,18,6,1,1,1,954,987,7
Task 955,Job 0,7,8,2,11,0,9,18,9,2,2,1,955,989,8
Task 955,Job 1,12,7,1,7,0,13,19,6,1,2,0,955,989,3
Task 956,Job 0,4,8,3,12,1,7,16,9,3,4,1,956,990,4
Task 956,Job 1,9,6,1,9,0,10,18,8,1,4,2,956,990,8
Task 957,Job 0,7,9,4,7,1,11,14,3,4,1,0,957,991,11
Task 957,Job 1,12,4,1,6,0,13,18,5,1,2,0,957,991,12
Task 958,Job 0,8,7,1,9,0,9,17,8,1,2,1,958,992,18
Task 958,Job 1,13,5,2,6,0,15,19,4,2,1,0,958,992,14
Task 959,Job 0,9,10,3,10,1,12,19,7,3,4,0,959,992,18
Task 959,Job 1,14,6,1,9,0,15,23,8,1,4,0,959,992,18
Task 960,Job 0,7,9,1,12,0,8,19,11,1,3,1,960,994,11
Task 960,Job 1,12,4,2,8,1,14,20,6,2,4,0,960,994,19
Task 961,Job 0,9,4,4,8,0,13,17,4,4,2,2,961,994,15
Task 961,Job 1,14,10,4,6,0,18,20,2,4,1,2,961,994,13
Task 962,Job 0,3,6,3,9,1,6,12,6,3,1,2,962,996,5
Task 962,Job 1,8,5,3,11,0,11,19,8,3,4,2,962,996,4
Task 963,Job 0,10,6,3,6,0,13,16,3,3,3,0,963,996,8
Task 963,Job 1,15,6,2,9,0,17,24,7,2,1,2,963,996,17
Task 964,Job 0,8,7,4,12,1,12,20,8,4,4,1,964,998,9
Task 964,Job 1,13,10,2,6,0,15,19,4,2,2,0,964,998,5
Task 965,Job 0,9,10,4,10,1,13,19,6,4,1,1,965,999,16
Task 965,Job 1,14,8,4,10,0,18,24,6,4,3,2,965,999,14
Task 966,Job 0,6,6,3,6,1,9,12,3,3,3,0,966,1000,10
Task 966,Job 1,11,4,1,10,0,12,21,9,1,4,2,966,1000,3
Task 967,Job 0,2,7,1,12,0,3,14,11,1,4,1,967,1000,15
Task 967,Job 1,7,7,1,11,0,8,18,10,1,4,0,967,1000,16
Task 968,Job 0,10,9,1,8,0,11,18,7,1,3,2,968,1001,13
Task 968,Job 1,15,4,3,8,0,18,23,5,3,2,2,968,1001,6
Task 969,Job 0,10,8,3,6,1,13,16,3,3,1,0,969,1002,16
Task 969,Job 1,15,7,3,9,0,18,24,6,3,4,0,969,1002,20
Task 970,Job 0,4,10,4,10,0,8,14,6,4,2,0,970,1003,12
Task 970,Job 1,9,5,3,6,0,12,15,3,3,1,1,970,1003,8
Task 971,Job 0,9,10,2,7,0,11,16,5,2,3,0,971,1004,16
Task 971,Job 1,14,6,2,6,1,16,20,4,2,2,0,971,1004,15
Task 972,Job 0,3,5,2,11,0,5,14,9,2,1,1,972,1005,10
Task 972,Job 1,8,6,2,11,0,10,19,9,2,4,0,972,1005,10
Task 973,Job 0,6,9,2,10,0,8,16,8,2,3,0,973,1006,18
Task 973,Job 1,11,5,3,7,0,14,18,4,3,4,0,973,1006,8
Task 974,Job 0,1,9,4,10,1,5,11,6,4,1,0,974,1008,6
Task 974,Job 1,6,5,1,10,1,7,16,9,1,3,1,974,1008,13
Task 975,Job 0,6,8,4,11,1,10,17,7,4,2,2,975,1009,10
Task 975,Job 1,11,6,2,9,0,13,20,7,2,2,0,975,1009,8
Task 976,Job 0,1,7,1,6,0,2,7,5,1,2,2,976,1009,18
Task 976,Job 1,6,10,1,12,0,7,18,11,1,3,1,976,1009,12
Task 977,Job 0,10,5,2,10,0,12,20,8,2,3,0,977,1011,17
Task 977,Job 1,15,8,3,9,0,18,24,6,3,4,1,977,1011,10
Task 978,Job 0,7,8,3,6,0,10,13,3,3,3,2,978,1012,16
Task 978,Job 1,12,8,2,11,0,14,23,9,2,1,0,978,1012,9
Task 979,Job 0,5,8,4,10,0,9,15,6,4,1,1,979,1013,5
Task 979,Job 1,10,5,3,10,0,13,20,7,3,1,1,979,1013,4
Task 980,Job 0,10,7,4,9,0,14,19,5,4,2,0,980,1013,2
Task 980,Job 1,15,4,1,9,0,16,24,8,1,3,1,980,1013,18
Task 981,Job 0,5,9,4,10,0,9,15,6,4,2,0,981,1014,6
Task 981,Job 1,10,4,2,7,0,12,17,5,2,3,0,981,1014,11
Task 982,Job 0,6,4,1,7,0,7,13,6,1,3,0,982,1015,11
Task 982,Job 1,11,7,1,12,1,12,23,11,1,1,0,982,1015,16
Task 983,Job 0,10,10,1,12,1,11,22,11,1,4,1,983,1016,12
Task 983,Job 1,15,8,3,6,1,18,21,3,3,2,1,983,1016,12
Task 984,Job 0,1,10,4,8,0,5,9,4,4,4,0,984,1017,13
Task 984,Job 1,6,9,2,10,0,8,16,8,2,1,1,984,1017,3
Task 985,Job 0,3,5,2,12,0,5,15,10,2,3,1,985,1018,19
Task 985,Job 1,8,4,4,10,0,12,18,6,4,4,1,985,1018,20
Task 986,Job 0,5,5,2,7,0,7,12,5,2,1,0,986,1020,18
Task 986,Job 1,10,6,1,11,1,11,21,10,1,2,0,986,1020,15
Task 987,Job 0,1,7,3,9,0,4,10,6,3,3,1,987,1021,17
Task 987,Job 1,6,5,3,8,1,9,14,5,3,4,1,987,1021,20
Task 988,Job 0,5,9,3,11,0,8,16,8,3,3,2,988,1021,9
Task 988,Job 1,10,7,3,11,0,13,21,8,3,1,1,988,1021,2
Task 989,Job 0,3,5,4,12,0,7,15,8,4,1,1,989,1023,18
Task 989,Job 1,8,4,3,11,0,11,19,8,3,1,0,989,1023,8
Task 990,Job 0,4,4,1,12,1,5,16,11,1,1,2,990,1023,11
Task 990,Job 1,9,8,4,12,0,13,21,8,4,2,1,990,1023,20
Task 991,Job 0,2,4,1,6,1,3,8,5,1,4,1,991,1024,15
Task 991,Job 1,7,4,4,8,0,11,15,4,4,4,2,991,1024,19
Task 992,Job 0,10,9,2,10,1,12,20,8,2,2,1,992,1026,7
Task 992,Job 1,15,7,2,10,0,17,25,8,2,2,2,992,1026,6
Task 993,Job 0,7,6,1,8,0,8,15,7,1,4,0,993,1026,16
Task 993,Job 1,12,5,4,8,0,16,20,4,4,2,2,993,1026,20
Task 994,Job 0,3,9,1,11,0,4,14,10,1,4,1,994,1027,16
Task 994,Job 1,8,10,1,10,0,9,18,9,1,1,0,994,1027,19
Task 995,Job 0,5,8,1,9,1,6,14,8,1,2,0,995,1028,19
Task 995,Job 1,10,6,1,10,0,11,20,9,1,3,1,995,1028,5
Task 996,Job 0,6,9,4,8,0,10,14,4,4,1,0,996,1029,3
Task 996,Job 1,11,7,4,8,1,15,19,4,4,1,2,996,1029,8
Task 997,Job 0,2,5,2,9,0,4,11,7,2,2,1,997,1030,3
Task 997,Job 1,7,9,2,6,0,9,13,4,2,4,2,997,1030,20
Task 998,Job 0,10,10,4,8,0,14,18,4,4,3,1,998,1032,15
Task 998,Job 1,15,10,1,7,1,16,22,6,1,2,0,998,1032,18
Task 999,Job 0,8,7,3,6,0,11,14,3,3,3,0,999,1032,16
Task 999,Job 1,13,6,1,10,0,14,23,9,1,2,1,999,1032,19
Task 1000,Job 0,9,5,2,12,0,11,21,10,2,3,2,1000,1033,14
Task 1000,Job 1,14,4,4,7,0,18,21,3,4,3,2,1000,1033,14
Task 1001,Job 0,4,9,2,10,0,6,14,8,2,4,2,1001,1035,20
Task 1001,Job 1,9,7,1,7,0,10,16,6,1,3,2,1001,1035,6
Task 1002,Job 0,6,6,4,8,1,10,14,4,4,4,1,1002,1035,3
Task 1002,Job 1,11,6,3,9,0,14,20,6,3,1,0,1002,1035,12
Task 1003,Job 0,8,10,3,6,0,11,14,3,3,4,1,1003,1036,8
Task 1003,Job 1,13,8,1,12,1,14,25,11,1,1,0,1003,1036,19
Task 1004,Job 0,7,8,3,12,0,10,19,9,3,2,0,1004,1037,17
Task 1004,Job 1,12,10,1,8,0,13,20,7,1,1,2,1004,1037,2
Task 1005,Job 0,5,10,3,7,0,8,12,4,3,2,0,1005,1039,17
Task 1005,Job 1,10,10,2,10,1,12,20,8,2,3,1,1005,1039,20
Task 1006,Job 0,5,10,2,7,0,7,12,5,2,1,1,1006,1039,6
Task 1006,Job 1,10,7,1,8,0,11,18,7,1,1,1,1006,1039,14
Task 1007,Job 0,1,7,3,7,1,4,8,4,3,2,2,1007,1041,7
Task 1007,Job 1,6,6,1,7,1,7,13,6,1,2,0,1007,1041,20
Task 1008,Job 0,5,7,4,11,0,9,16,7,4,1,1,1008,1042,3
Task 1008,Job 1,10,6,4,6,0,14,16,2,4,3,2,1008,1042,8
Task 1009,Job 0,4,4,3,6,1,7,10,3,3,2,2,1009,1043,17
Task 1009,Job 1,9,10,4,9,1,13,18,5,4,1,1,1009,1043,4
Task 1010,Job 0,6,6,2,9,0,8,15,7,2,3,0,1010,1043,20
Task 1010,Job 1,11,6,2,6,0,13,17,4,2,1,2,1010,1043,20
Task 1011,Job 0,4,7,1,9,1,5,13,8,1,1,1,1011,1045,8
Task 1011,Job 1,9,4,2,6,0,11,15,4,2,1,1,1011,1045,17
Task 1012,Job 0,4,9,2,6,0,6,10,4,2,2,0,1012,1046,3
Task 1012,Job 1,9,6,2,10,0,11,19,8,2,1,0,1012,1046,3
Task 1013,Job 0,1,7,4,9,1,5,10,5,4,3,1,1013,1047,17
Task 1013,Job 1,6,5,4,11,1,10,17,7,4,2,0,1013,1047,7
Task 1014,Job 0,10,7,4,9,0,14,19,5,4,3,1,1014,1047,13
Task 1014,Job 1,15,4,4,9,0,19,24,5,4,1,2,1014,1047,5
Task 1015,Job 0,5,6,2,9,1,7,14,7,2,1,2,1015,1048,2
Task 1015,Job 1,10,8,2,9,0,12,19,7,2,2,2,1015,1048,7
Task 1016,Job 0,1,4,2,9,0,3,10,7,2,2,0,1016,1050,14
Task 1016,Job 1,6,6,4,9,0,10,15,5,4,1,0,1016,1050,16
Task 1017,Job 0,8,10,1,9,1,9,17,8,1,2,2,1017,1050,18
Task 1017,Job 1,13,9,1,9,0,14,22,8,1,4,2,1017,1050,6
Task 1018,Job 0,8,7,4,12,0,12,20,8,4,4,0,1018,1051,12
Task 1018,Job 1,13,8,3,11,0,16,24,8,3,1,1,1018,1051,20
Task 1019,Job 0,4,6,2,6,0,6,10,4,2,4,0,1019,1053,6
Task 1019,Job 1,9,6,3,9,0,12,18,6,3,1,0,1019,1053,2
Task 1020,Job 0,9,5,2,9,0,11,18,7,2,4,0,1020,1053,10
Task 1020,Job 1,14,8,2,11,0,16,25,9,2,1,2,1020,1053,18
Task 1021,Job 0,9,6,1,6,0,10,15,5,1,1,0,1021,1054,3
Task 1021,Job 1,14,4,1,10,0,15,24,9,1,4,1,1021,1054,19
Task 1022,Job 0,8,7,2,9,0,10,17,7,2,4,0,1022,1055,3
Task 1022,Job 1,13,6,2,9,1,15,22,7,2,1,2,1022,1055,11
Task 1023,Job 0,4,10,3,12,0,7,16,9,3,1,0,1023,1056,5
Task 1023,Job 1,9,8,3,8,0,12,17,5,3,1,2,1023,1056,11
Task 1024,Job 0,10,6,2,10,0,12,20,8,2,1,1,1024,1057,7
Task 1024,Job 1,15,10,1,12,1,16,27,11,1,3,1,1024,1057,13
Task 1025,Job 0,2,7,1,6,0,3,8,5,1,2,2,1025,1059,3
Task 1025,Job 1,7,7,4,9,0,11,16,5,4,2,1,1025,1059,8
Task 1026,Job 0,7,6,1,9,0,8,16,8,1,1,1,1026,1059,15
Task 1026,Job 1,12,9,4,7,0,16,19,3,4,2,1,1026,1059,19
Task 1027,Job 0,7,6,2,12,1,9,19,10,2,2,0,1027,1060,15
Task 1027,Job 1,12,6,4,8,0,16,20,4,4,1,1,1027,1060,2
Task 1028,Job 0,8,8,3,10,0,11,18,7,3,4,1,1028,1062,5
Task 1028,Job 1,13,4,4,9,0,17,22,5,4,3,1,1028,1062,19
Task 1029,Job 0,6,6,4,7,0,10,13,3,4,3,0,1029,1062,5
Task 1029,Job 1,11,7,3,11,0,14,22,8,3,2,1,1029,1062,20
Task 1030,Job 0,8,10,1,7,0,9,15,6,1,1,1,1030,1063,2
Task 1030,Job 1,13,6,3,11,0,16,24,8,3,1,2,1030,1063,5
Task 1031,Job 0,3,4,1,10,0,4,13,9,1,4,0,1031,1065,15
Task 1031,Job 1,8,7,1,12,1,9,20,11,1,2,2,1031,1065,20
Task 1032,Job 0,3,8,4,6,0,7,9,2,4,3,0,1032,1065,3
Task 1032,Job 1,8,9,4,6,0,12,14,2,4,1,0,1032,1065,12
Task 1033,Job 0,7,6,3,10,1,10,17,7,3,1,0,1033,1066,18
Task 1033,Job 1,12,9,2,10,0,14,22,8,2,2,1,1033,1066,16
Task 1034,Job 0,2,6,3,12,1,5,14,9,3,2,1,1034,1068,8
Task 1034,Job 1,7,4,3,12,0,10,19,9,3,1,1,1034,1068,17
Task 1035,Job 0,4,5,2,7,0,6,11,5,2,2,1,1035,1069,8
Task 1035,Job 1,9,4,4,8,1,13,17,4,4,2,0,1035,1069,11
Task 1036,Job 0,6,10,3,10,0,9,16,7,3,2,2,1036,1070,8
Task 1036,Job 1,11,8,4,11,0,15,22,7,4,4,2,1036,1070,14
Task 1037,Job 0,4,9,2,10,0,6,14,8,2,3,1,1037,1070,17
Task 1037,Job 1,9,6,4,11,0,13,20,7,4,1,0,1037,1070,18
Task 1038,Job 0,5,10,2,7,0,7,12,5,2,1,0,1038,1071,2
Task 1038,Job 1,10,8,1,12,1,11,22,11,1,4,2,1038,1071,3
Task 1039,Job 0,3,5,1,6,0,4,9,5,1,3,2,1039,1073,5
Task 1039,Job 1,8,5,1,8,0,9,16,7,1,2,2,1039,1073,3
Task 1040,Job 0,9,5,3,11,0,12,20,8,3,4,2,1040,1073,2
Task 1040,Job 1,14,7,4,12,0,18,26,8,4,2,2,1040,1073,9
Task 1041,Job 0,3,7,2,11,0,5,14,9,2,1,0,1041,1074,18
Task 1041,Job 1,8,5,3,6,1,11,14,3,3,1,0,1041,1074,4
Task 1042,Job 0,5,5,4,10,1,9,15,6,4,3,0,1042,1075,18
Task 1042,Job 1,10,6,1,6,1,11,16,5,1,2,1,1042,1075,18
Task 1043,Job 0,3,7,3,11,0,6,14,8,3,1,2,1043,1076,14
Task 1043,Job 1,8,7,1,6,0,9,14,5,1,1,1,1043,1076,8
Task 1044,Job 0,2,8,1,9,0,3,11,8,1,3,0,1044,1077,8
Task 1044,Job 1,7,9,2,9,0,9,16,7,2,2,2,1044,1077,9
Task 1045,Job 0,1,8,4,11,0,5,12,7,4,1,0,1045,1079,16
Task 1045,Job 1,6,7,3,7,0,9,13,4,3,1,1,1045,1079,12
Task 1046,Job 0,2,10,3,10,0,5,12,7,3,4,0,1046,1080,8
Task 1046,Job 1,7,5,2,9,0,9,16,7,2,4,2,1046,1080,14
Task 1047,Job 0,1,7,3,6,0,4,7,3,3,4,1,1047,1080,20
Task 1047,Job 1,6,10,2,11,0,8,17,9,2,4,2,1047,1080,4
Task 1048,Job 0,7,6,1,11,0,8,18,10,1,2,1,1048,1082,16
Task 1048,Job 1,12,5,3,6,0,15,18,3,3,4,1,1048,1082,6
Task 1049,Job 0,2,7,2,6,1,4,8,4,2,4,0,1049,1082,15
Task 1049,Job 1,7,10,4,10,0,11,17,6,4,1,2,1049,1082,12
Task 1050,Job 0,1,10,1,11,0,2,12,10,1,2,0,1050,1084,15
Task 1050,Job 1,6,7,3,7,0,9,13,4,3,1,0,1050,1084,4
Task 1051,Job 0,2,7,4,10,0,6,12,6,4,4,2,1051,1085,12
Task 1051,Job 1,7,6,2,7,1,9,14,5,2,3,2,1051,1085,8
Task 1052,Job 0,8,9,1,11,0,9,19,10,1,4,1,1052,1085,20
Task 1052,Job 1,13,7,3,6,0,16,19,3,3,2,0,1052,1085,9
Task 1053,Job 0,10,9,3,7,1,13,17,4,3,4,0,1053,1086,14
Task 1053,Job 1,15,9,1,7,0,16,22,6,1,3,0,1053,1086,6
Task 1054,Job 0,8,10,2,12,0,10,20,10,2,2,1,1054,1088,4
Task 1054,Job 1,13,5,3,12,0,16,25,9,3,1,1,1054,1088,15
Task 1055,Job 0,8,4,2,12,0,10,20,10,2,2,1,1055,1089,18
Task 1055,Job 1,13,6,1,9,0,14,22,8,1,4,1,1055,1089,4
Task 1056,Job 0,4,6,4,11,0,8,15,7,4,3,1,1056,1090,19
Task 1056,Job 1,9,8,3,10,0,12,19,7,3,4,1,1056,1090,8
Task 1057,Job 0,6,4,3,9,1,9,15,6,3,3,0,1057,1090,18
Task 1057,Job 1,11,7,2,6,1,13,17,4,2,1,1,1057,1090,20
Task 1058,Job 0,10,5,4,11,0,14,21,7,4,4,1,1058,1091,20
Task 1058,Job 1,15,7,1,11,1,16,26,10,1,2,2,1058,1091,3
Task 1059,Job 0,6,10,4,7,0,10,13,3,4,4,0,1059,1093,3
Task 1059,Job 1,11,4,4,12,0,15,23,8,4,2,0,1059,1093,20
Task 1060,Job 0,4,7,1,6,1,5,10,5,1,2,1,1060,1094,18
Task 1060,Job 1,9,6,1,8,0,10,17,7,1,4,1,1060,1094,16
Task 1061,Job 0,7,8,4,12,0,11,19,8,4,4,2,1061,1095,18
Task 1061,Job 1,12,8,1,9,1,13,21,8,1,3,2,1061,1095,10
Task 1062,Job 0,6,6,1,9,0,7,15,8,1,1,1,1062,1096,13
Task 1062,Job 1,11,5,2,11,1,13,22,9,2,4,2,1062,1096,20
Task 1063,Job 0,1,6,1,11,0,2,12,10,1,1,1,1063,1096,18
Task 1063,Job 1,6,9,4,8,0,10,14,4,4,3,1,1063,1096,7
Task 1064,Job 0,5,7,1,6,1,6,11,5,1,2,1,1064,1097,7
Task 1064,Job 1,10,7,2,11,0,12,21,9,2,4,1,1064,1097,5
Task 1065,Job 0,8,8,4,10,0,12,18,6,4,4,1,1065,1099,3
Task 1065,Job 1,13,10,3,7,0,16,20,4,3,1,1,1065,1099,17
Task 1066,Job 0,6,9,2,8,0,8,14,6,2,1,1,1066,1099,18
Task 1066,Job 1,11,6,4,10,0,15,21,6,4,3,1,1066,1099,18
Task 1067,Job 0,2,7,3,10,0,5,12,7,3,4,2,1067,1100,13
Task 1067,Job 1,7,9,3,9,0,10,16,6,3,2,1,1067,1100,12
Task 1068,Job 0,3,8,1,12,0,4,15,11,1,2,2,1068,1102,5
Task 1068,Job 1,8,8,3,9,0,11,17,6,3,1,1,1068,1102,18
Task 1069,Job 0,3,6,4,11,1,7,14,7,4,4,1,1069,1102,19
Task 1069,Job 1,8,5,2,12,1,10,20,10,2,3,2,1069,1102,8
Task 1070,Job 0,3,8,4,12,0,7,15,8,4,4,1,1070,1103,16
Task 1070,Job 1,8,7,2,12,0,10,20,10,2,2,2,1070,1103,16
Task 1071,Job 0,1,7,3,10,0,4,11,7,3,2,2,1071,1105,7
Task 1071,Job 1,6,6,2,11,0,8,17,9,2,1,2,1071,1105,16
Task 1072,Job 0,8,9,1,9,0,9,17,8,1,4,0,1072,1105,12
Task 1072,Job 1,13,4,1,8,1,14,21,7,1,3,0,1072,1105,13
Task 1073,Job 0,7,7,2,7,0,9,14,5,2,1,1,1073,1107,2
Task 1073,Job 1,12,9,2,6,0,14,18,4,2,1,0,1073,1107,2
Task 1074,Job 0,5,6,2,7,0,7,12,5,2,4,0,1074,1108,8
Task 1074,Job 1,10,9,1,12,0,11,22,11,1,4,0,1074,1108,7
Task 1075,Job 0,8,7,4,6,1,12,14,2,4,1,1,1075,1108,14
Task 1075,Job 1,13,6,1,12,0,14,25,11,1,1,1,1075,1108,12
Task 1076,Job 0,3,6,1,8,0,4,11,7,1,1,2,1076,1109,20
Task 1076,Job 1,8,9,1,12,0,9,20,11,1,2,2,1076,1109,10
Task 1077,Job 0,7,9,2,9,0,9,16,7,2,4,0,1077,1110,20
Task 1077,Job 1,12,7,4,9,0,16,21,5,4,1,2,1077,1110,8
Task 1078,Job 0,5,8,4,8,0,9,13,4,4,2,1,1078,1112,9
Task 1078,Job 1,10,4,4,10,0,14,20,6,4,3,1,1078,1112,5
Task 1079,Job 0,5,4,1,9,1,6,14,8,1,1,2,1079,1112,9
Task 1079,Job 1,10,8,4,11,1,14,21,7,4,3,2,1079,1112,14
Task 1080,Job 0,10,7,2,8,0,12,18,6,2,1,2,1080,1114,20
Task 1080,Job 1,15,8,4,8,1,19,23,4,4,3,0,1080,1114,2
Task 1081,Job 0,8,7,4,11,0,12,19,7,4,3,0,1081,1114,6
Task 1081,Job 1,13,6,4,11,0,17,24,7,4,1,1,1081,1114,3
Task 1082,Job 0,8,7,3,8,0,11,16,5,3,1,2,1082,1116,18
Task 1082,Job 1,13,4,2,7,0,15,20,5,2,3,2,1082,1116,13
Task 1083,Job 0,6,5,3,11,0,9,17,8,3,2,1,1083,1117,6
Task 1083,Job 1,11,10,2,9,0,13,20,7,2,2,1,1083,1117,18
Task 1084,Job 0,9,5,3,8,0,12,17,5,3,4,0,1084,1117,9
Task 1084,Job 1,14,7,3,9,0,17,23,6,3,3,1,1084,1117,16
Task 1085,Job 0,1,7,2,8,1,3,9,6,2,2,0,1085,1119,9
Task 1085,Job 1,6,5,2,7,0,8,13,5,2,4,2,1085,1119,17
Task 1086,Job 0,9,5,2,10,0,11,19,8,2,2,1,1086,1119,15
Task 1086,Job 1,14,5,2,7,0,16,21,5,2,4,2,1086,1119,2
Task 1087,Job 0,2,8,2,8,0,4,10,6,2,2,1,1087,1121,13
Task 1087,Job 1,7,6,1,9,0,8,16,8,1,1,2,1087,1121,19
Task 1088,Job 0,10,8,1,6,0,11,16,5,1,1,2,1088,1121,8
Task 1088,Job 1,15,9,1,7,0,16,22,6,1,4,1,1088,1121,11
Task 1089,Job 0,6,6,3,10,0,9,16,7,3,4,2,1089,1122,8
Task 1089,Job 1,11,9,4,12,0,15,23,8,4,4,1,1089,1122,11
Task 1090,Job 0,7,7,2,10,0,9,17,8,2,4,0,1090,1123,5
Task 1090,Job 1,12,7,3,7,0,15,19,4,3,1,0,1090,1123,3
Task 1091,Job 0,1,8,4,8,0,5,9,4,4,2,2,1091,1125,5
Task 1091,Job 1,6,6,4,10,0,10,16,6,4,4,1,1091,1125,13
Task 1092,Job 0,6,6,2,7,0,8,13,5,2,2,1,1092,1126,18
Task 1092,Job 1,11,9,4,9,1,15,20,5,4,2,0,1092,1126,6
Task 1093,Job 0,8,10,4,7,0,12,15,3,4,2,1,1093,1127,4
Task 1093,Job 1,13,9,2,7,0,15,20,5,2,2,2,1093,1127,10
Task 1094,Job 0,8,6,1,7,0,9,15,6,1,3,0,1094,1127,10
Task 1094,Job 1,13,9,4,11,0,17,24,7,4,3,1,1094,1127,14
Task 1095,Job 0,6,9,2,9,0,8,15,7,2,2,1,1095,1129,18
Task 1095,Job 1,11,7,2,11,0,13,22,9,2,1,2,1095,1129,19
Task 1096,Job 0,8,4,2,7,0,10,15,5,2,4,0,1096,1130,2
Task 1096,Job 1,13,10,3,8,0,16,21,5,3,4,0,1096,1130,12
Task 1097,Job 0,1,5,4,10,1,5,11,6,4,2,2,1097,1131,7
Task 1097,Job 1,6,9,3,8,0,9,14,5,3,1,0,1097,1131,19
Task 1098,Job 0,4,10,2,6,0,6,10,4,2,1,1,1098,1132,10
Task 1098,Job 1,9,8,2,11,1,11,20,9,2,2,1,1098,1132,9
Task 1099,Job 0,3,10,2,10,0,5,13,8,2,3,1,1099,1133,13
Task 1099,Job 1,8,5,1,8,0,9,16,7,1,1,2,1099,1133,20
Task 1100,Job 0,6,4,1,11,0,7,17,10,1,3,0,1100,1133,8
Task 1100,Job 1,11,7,2,8,0,13,19,6,2,3,1,1100,1133,10
Task 1101,Job 0,2,9,3,7,0,5,9,4,3,3,0,1101,1134,5
Task 1101,Job 1,7,8,4,12,0,11,19,8,4,1,1,1101,1134,14
Task 1102,Job 0,5,4,4,6,1,9,11,2,4,3,1,1102,1135,18
Task 1102,Job 1,10,4,4,11,0,14,21,7,4,3,0,1102,1135,4
Task 1103,Job 0,9,8,2,11,1,11,20,9,2,3,2,1103,1137,7
Task 1103,Job 1,14,5,4,7,0,18,21,3,4,4,2,1103,1137,16
Task 1104,Job 0,1,9,2,12,1,3,13,10,2,4,2,1104,1137,19
Task 1104,Job 1,6,5,4,6,0,10,12,2,4,1,2,1104,1137,13
Task 1105,Job 0,5,9,1,10,0,6,15,9,1,1,2,1105,1139,18
Task 1105,Job 1,10,5,4,12,0,14,22,8,4,2,1,1105,1139,18
Task 1106,Job 0,6,9,1,6,1,7,12,5,1,1,2,1106,1139,14
Task 1106,Job 1,11,5,4,7,1,15,18,3,4,3,2,1106,1139,16
Task 1107,Job 0,1,5,1,11,0,2,12,10,1,1,0,1107,1140,3
Task 1107,Job 1,6,9,1,12,0,7,18,11,1,4,2,1107,1140,12
Task 1108,Job 0,8,4,2,6,0,10,14,4,2,2,2,1108,1141,5
Task 1108,Job 1,13,5,4,11,1,17,24,7,4,4,0,1108,1141,13
Task 1109,Job 0,2,6,2,8,0,4,10,6,2,4,0,1109,1142,17
Task 1109,Job 1,7,7,3,7,0,10,14,4,3,2,0,1109,1142,14
Task 1110,Job 0,2,8,4,12,0,6,14,8,4,3,1,1110,1143,5
Task 1110,Job 1,7,9,4,11,0,11,18,7,4,3,1,1110,1143,20
Task 1111,Job 0,6,8,3,12,0,9,18,9,3,4,1,1111,1144,14
Task 1111,Job 1,11,4,2,11,0,13,22,9,2,2,0,1111,1144,15
Task 1112,Job 0,9,6,2,6,0,11,15,4,2,1,1,1112,1146,6
Task 1112,Job 1,14,9,3,12,0,17,26,9,3,3,2,1112,1146,4
Task 1113,Job 0,7,6,4,8,0,11,15,4,4,4,1,1113,1146,7
Task 1113,Job 1,12,4,2,6,0,14,18,4,2,1,0,1113,1146,8
Task 1114,Job 0,4,6,2,8,0,6,12,6,2,3,2,1114,1148,17
Task 1114,Job 1,9,9,4,10,0,13,19,6,4,1,2,1114,1148,12
Task 1115,Job 0,6,5,2,7,0,8,13,5,2,4,2,1115,1149,10
Task 1115,Job 1,11,8,4,8,0,15,19,4,4,2,0,1115,1149,2
Task 1116,Job 0,7,6,3,9,1,10,16,6,3,4,2,1116,1149,2
Task 1116,Job 1,12,9,1,12,0,13,24,11,1,3,0,1116,1149,17
Task 1117,Job 0,3,8,2,8,1,5,11,6,2,4,0,1117,1150,14
Task 1117,Job 1,8,10,3,12,1,11,20,9,3,4,2,1117,1150,20
Task 1118,Job 0,1,8,1,12,0,2,13,11,1,1,1,1118,1152,4
Task 1118,Job 1,6,4,4,8,0,10,14,4,4,1,2,1118,1152,3
Task 1119,Job 0,2,9,4,12,1,6,14,8,4,1,1,1119,1153,12
Task 1119,Job 1,7,7,4,12,0,11,19,8,4,2,0,1119,1153,11
Task 1120,Job 0,9,10,4,12,0,13,21,8,4,4,0,1120,1153,11
Task 1120,Job 1,14,5,1,6,0,15,20,5,1,3,0,1120,1153,4
Task 1121,Job 0,9,9,3,10,0,12,19,7,3,1,2,1121,1155,11
Task 1121,Job 1,14,10,4,7,0,18,21,3,4,4,2,1121,1155,10
Task 1122,Job 0,10,8,3,7,1,13,17,4,3,4,1,1122,1155,15
Task 1122,Job 1,15,9,4,12,1,19,27,8,4,4,0,1122,1155,16
Task 1123,Job 0,10,9,2,12,0,12,22,10,2,4,0,1123,1157,10
Task 1123,Job 1,15,5,4,9,0,19,24,5,4,1,2,1123,1157,5
Task 1124,Job 0,4,8,1,9,0,5,13,8,1,4,2,1124,1158,8
Task 1124,Job 1,9,8,3,10,0,12,19,7,3,4,2,1124,1158,20
Task 1125,Job 0,9,6,3,7,0,12,16,4,3,2,0,1125,1159,4
Task 1125,Job 1,14,5,4,12,0,18,26,8,4,1,0,1125,1159,17
Task 1126,Job 0,10,7,1,10,0,11,20,9,1,1,2,1126,1159,19
Task 1126,Job 1,15,9,1,12,0,16,27,11,1,1,0,1126,1159,12
Task 1127,Job 0,1,10,2,7,1,3,8,5,2,4,0,1127,1160,16
Task 1127,Job 1,6,5,4,11,0,10,17,7,4,3,1,1127,1160,20
Task 1128,Job 0,10,7,2,6,1,12,16,4,2,3,2,1128,1161,6
Task 1128,Job 1,15,5,4,6,0,19,21,2,4,4,1,1128,1161,7
Task 1129,Job 0,8,7,3,12,0,11,20,9,3,1,1,1129,1163,12
Task 1129,Job 1,13,7,4,12,0,17,25,8,4,2,0,1129,1163,8
Task 1130,Job 0,8,6,1,7,0,9,15,6,1,4,1,1130,1163,6
Task 1130,Job 1,13,10,1,8,1,14,21,7,1,3,0,1130,1163,7
Task 1131,Job 0,4,7,1,6,1,5,10,5,1,4,1,1131,1165,20
Task 1131,Job 1,9,9,4,11,0,13,20,7,4,4,2,1131,1165,18
Task 1132,Job 0,9,8,4,12,1,13,21,8,4,3,0,1132,1165,18
Task 1132,Job 1,14,7,3,6,1,17,20,3,3,1,2,1132,1165,13
Task 1133,Job 0,8,5,1,9,0,9,17,8,1,3,0,1133,1167,16
Task 1133,Job 1,13,10,1,7,0,14,20,6,1,4,2,1133,1167,5
Task 1134,Job 0,8,10,4,7,0,12,15,3,4,2,2,1134,1167,19
Task 1134,Job 1,13,9,3,7,0,16,20,4,3,2,0,1134,1167,5
Task 1135,Job 0,3,9,3,8,0,6,11,5,3,4,0,1135,1168,11
Task 1135,Job 1,8,7,1,7,0,9,15,6,1,2,2,1135,1168,4
Task 1136,Job 0,5,10,3,9,0,8,14,6,3,1,0,1136,1169,6
Task 1136,Job 1,10,6,3,12,0,13,22,9,3,4,0,1136,1169,18
Task 1137,Job 0,4,6,1,6,1,5,10,5,1,2,1,1137,1171,16
Task 1137,Job 1,9,9,1,7,0,10,16,6,1,4,1,1137,1171,13
Task 1138,Job 0,2,6,2,7,1,4,9,5,2,1,1,1138,1171,2
Task 1138,Job 1,7,7,1,10,0,8,17,9,1,4,2,1138,1171,17
Task 1139,Job 0,10,4,2,10,0,12,20,8,2,2,1,1139,1172,19
Task 1139,Job 1,15,9,1,8,1,16,23,7,1,4,2,1139,1172,19
Task 1140,Job 0,7,7,1,7,1,8,14,6,1,3,2,1140,1174,11
Task 1140,Job 1,12,5,2,12,0,14,24,10,2,4,2,1140,1174,19
Task 1141,Job 0,2,10,4,8,0,6,10,4,4,4,1,1141,1175,16
Task 1141,Job 1,7,4,1,11,0,8,18,10,1,4,2,1141,1175,14
Task 1142,Job 0,5,9,1,11,0,6,16,10,1,4,2,1142,1175,6
Task 1142,Job 1,10,8,2,7,0,12,17,5,2,4,0,1142,1175,15
Task 1143,Job 0,10,6,4,12,0,14,22,8,4,1,2,1143,1176,6
Task 1143,Job 1,15,8,1,11,1,16,26,10,1,3,0,1143,1176,12
Task 1144,Job 0,1,10,3,12,0,4,13,9,3,1,1,1144,1178,12
Task 1144,Job 1,6,7,4,12,0,10,18,8,4,2,0,1144,1178,17
Task 1145,Job 0,10,9,3,12,0,13,22,9,3,3,2,1145,1178,17
Task 1145,Job 1,15,4,1,12,0,16,27,11,1,2,2,1145,1178,6
Task 1146,Job 0,8,6,4,10,0,12,18,6,4,2,1,1146,1180,11
Task 1146,Job 1,13,10,2,10,0,15,23,8,2,3,0,1146,1180,11
Task 1147,Job 0,4,6,4,8,0,8,12,4,4,1,1,1147,1181,19
Task 1147,Job 1,9,7,2,6,0,11,15,4,2,2,1,1147,1181,19
Task 1148,Job 0,3,4,2,6,0,5,9,4,2,3,2,1148,1181,20
Task 1148,Job 1,8,4,3,10,0,11,18,7,3,3,2,1148,1181,10
Task 1149,Job 0,1,7,1,10,0,2,11,9,1,1,1,1149,1182,9
Task 1149,Job 1,6,4,1,9,0,7,15,8,1,2,0,1149,1182,6
Task 1150,Job 0,10,9,3,10,0,13,20,7,3,3,0,1150,1183,20
Task 1150,Job 1,15,10,3,8,1,18,23,5,3,4,0,1150,1183,14
Task 1151,Job 0,4,8,1,9,0,5,13,8,1,3,2,1151,1185,7
Task 1151,Job 1,9,6,3,12,0,12,21,9,3,1,1,1151,1185,12
Task 1152,Job 0,8,9,3,12,1,11,20,9,3,2,2,1152,1186,5
Task 1152,Job 1,13,7,1,12,1,14,25,11,1,4,2,1152,1186,8
Task 1153,Job 0,4,8,3,7,0,7,11,4,3,2,1,1153,1187,15
Task 1153,Job 1,9,4,2,9,0,11,18,7,2,2,2,1153,1187,3
Task 1154,Job 0,4,7,4,7,1,8,11,3,4,1,1,1154,1188,14
Task 1154,Job 1,9,6,4,7,0,13,16,3,4,4,2,1154,1188,11
Task 1155,Job 0,10,5,4,10,0,14,20,6,4,2,2,1155,1189,5
Task 1155,Job 1,15,4,1,9,1,16,24,8,1,1,0,1155,1189,13
Task 1156,Job 0,5,8,4,7,0,9,12,3,4,4,1,1156,1190,20
Task 1156,Job 1,10,10,3,11,1,13,21,8,3,3,2,1156,1190,2
Task 1157,Job 0,3,8,1,6,1,4,9,5,1,1,2,1157,1191,10
Task 1157,Job 1,8,6,4,7,1,12,15,3,4,4,0,1157,1191,14
Task 1158,Job 0,8,9,1,8,0,9,16,7,1,4,1,1158,1191,17
Task 1158,Job 1,13,6,2,12,0,15,25,10,2,1,1,1158,1191,15
Task 1159,Job 0,1,7,1,11,0,2,12,10,1,1,0,1159,1192,3
Task 1159,Job 1,6,4,1,11,0,7,17,10,1,2,1,1159,1192,10
Task 1160,Job 0,2,7,4,10,0,6,12,6,4,4,0,1160,1193,12
Task 1160,Job 1,7,7,3,7,0,10,14,4,3,2,2,1160,1193,4
Task 1161,Job 0,1,7,2,10,0,3,11,8,2,3,2,1161,1194,9
Task 1161,Job 1,6,6,4,6,0,10,12,2,4,3,1,1161,1194,6
Task 1162,Job 0,10,6,4,9,1,14,19,5,4,4,2,1162,1195,13
Task 1162,Job 1,15,10,3,7,0,18,22,4,3,1,2,1162,1195,17
Task 1163,Job 0,7,10,1,12,0,8,19,11,1,3,0,1163,1197,12
Task 1163,Job 1,12,4,4,6,1,16,18,2,4,4,0,1163,1197,7
Task 1164,Job 0,1,5,3,12,0,4,13,9,3,4,2,1164,1197,8
Task 1164,Job 1,6,9,2,7,0,8,13,5,2,2,2,1164,1197,3
Task 1165,Job 0,4,6,2,9,1,6,13,7,2,1,2,1165,1198,15
Task 1165,Job 1,9,6,4,11,0,13,20,7,4,2,0,1165,1198,19
Task 1166,Job 0,4,8,3,9,1,7,13,6,3,4,1,1166,1199,9
Task 1166,Job 1,9,4,2,7,0,11,16,5,2,1,2,1166,1199,18
Task 1167,Job 0,8,6,2,9,0,10,17,7,2,2,1,1167,1201,11
Task 1167,Job 1,13,8,2,12,1,15,25,10,2,3,0,1167,1201,7
Task 1168,Job 0,1,4,1,12,0,2,13,11,1,1,0,1168,1202,16
Task 1168,Job 1,6,8,4,7,0,10,13,3,4,4,2,1168,1202,14
Task 1169,Job 0,9,8,2,7,0,11,16,5,2,1,1,1169,1203,17
Task 1169,Job 1,14,4,1,8,1,15,22,7,1,3,1,1169,1203,7
Task 1170,Job 0,3,9,1,8,0,4,11,7,1,4,1,1170,1204,13
Task 1170,Job 1,8,5,2,6,0,10,14,4,2,2,1,1170,1204,10
Task 1171,Job 0,2,6,4,10,0,6,12,6,4,4,2,1171,1205,2
Task 1171,Job 1,7,4,1,6,0,8,13,5,1,4,0,1171,1205,6
Task 1172,Job 0,9,7,2,12,0,11,21,10,2,1,1,1172,1205,17
Task 1172,Job 1,14,5,3,10,0,17,24,7,3,2,2,1172,1205,2
Task 1173,Job 0,3,9,3,6,0,6,9,3,3,2,2,1173,1207,20
Task 1173,Job 1,8,10,3,9,1,11,17,6,3,1,0,1173,1207,18
Task 1174,Job 0,4,8,1,12,0,5,16,11,1,1,2,1174,1208,2
Task 1174,Job 1,9,9,2,10,1,11,19,8,2,3,0,1174,1208,19
Task 1175,Job 0,6,7,2,12,0,8,18,10,2,1,1,1175,1209,19
Task 1175,Job 1,11,9,4,11,0,15,22,7,4,2,1,1175,1209,8
Task 1176,Job 0,2,7,4,6,0,6,8,2,4,1,1,1176,1210,4
Task 1176,Job 1,7,8,2,6,0,9,13,4,2,2,1,1176,1210,20
Task 1177,Job 0,5,8,1,8,0,6,13,7,1,3,2,1177,1210,12
Task 1177,Job 1,10,4,3,11,0,13,21,8,3,4,2,1177,1210,7
Task 1178,Job 0,4,4,1,12,0,5,16,11,1,3,1,1178,1211,10
Task 1178,Job 1,9,10,1,8,0,10,17,7,1,3,0,1178,1211,8
Task 1179,Job 0,8,6,4,10,0,12,18,6,4,4,0,1179,1213,7
Task 1179,Job 1,13,5,3,9,0,16,22,6,3,3,0,1179,1213,10
Task 1180,Job 0,7,9,3,10,0,10,17,7,3,1,1,1180,1214,5
Task 1180,Job 1,12,10,2,12,0,14,24,10,2,1,2,1180,1214,12
Task 1181,Job 0,6,10,2,6,0,8,12,4,2,1,2,1181,1214,6
Task 1181,Job 1,11,7,4,8,0,15,19,4,4,2,2,1181,1214,12
Task 1182,Job 0,3,8,2,11,0,5,14,9,2,2,0,1182,1216,14
Task 1182,Job 1,8,9,4,11,0,12,19,7,4,1,0,1182,1216,17
Task 1183,Job 0,3,7,2,10,0,5,13,8,2,2,2,1183,1217,2
Task 1183,Job 1,8,10,1,10,0,9,18,9,1,1,1,1183,1217,3
Task 1184,Job 0,3,7,4,6,0,7,9,2,4,3,1,1184,1217,16
Task 1184,Job 1,8,9,4,7,0,12,15,3,4,3,2,1184,1217,18
Task 1185,Job 0,10,5,4,11,0,14,21,7,4,3,0,1185,1219,5
Task 1185,Job 1,15,9,1,12,0,16,27,11,1,4,0,1185,1219,18
Task 1186,Job 0,1,7,1,11,0,2,12,10,1,3,1,1186,1220,20
Task 1186,Job 1,6,9,2,9,0,8,15,7,2,1,0,1186,1220,12
Task 1187,Job 0,10,8,2,9,0,12,19,7,2,2,1,1187,1221,18
Task 1187,Job 1,15,7,2,7,0,17,22,5,2,2,2,1187,1221,11
Task 1188,Job 0,3,8,1,9,0,4,12,8,1,2,1,1188,1221,18
Task 1188,Job 1,8,7,2,9,0,10,17,7,2,1,0,1188,1221,20
Task 1189,Job 0,5,5,4,6,1,9,11,2,4,1,1,1189,1222,16
Task 1189,Job 1,10,9,2,9,0,12,19,7,2,4,1,1189,1222,15
Task 1190,Job 0,10,5,2,12,0,12,22,10,2,2,0,1190,1224,15
Task 1190,Job 1,15,7,4,7,1,19,22,3,4,1,0,1190,1224,17
Task 1191,Job 0,5,9,1,11,0,6,16,10,1,4,2,1191,1224,16
Task 1191,Job 1,10,8,4,7,0,14,17,3,4,2,2,1191,1224,6
Task 1192,Job 0,6,8,1,10,0,7,16,9,1,2,1,1192,1225,13
Task 1192,Job 1,11,6,2,9,0,13,20,7,2,2,0,1192,1225,14
Task 1193,Job 0,4,9,4,10,1,8,14,6,4,1,0,1193,1226,13
Task 1193,Job 1,9,6,2,12,0,11,21,10,2,4,1,1193,1226,17
Task 1194,Job 0,5,6,2,11,1,7,16,9,2,2,2,1194,1227,12
Task 1194,Job 1,10,4,3,9,0,13,19,6,3,1,1,1194,1227,17
Task 1195,Job 0,2,8,1,11,0,3,13,10,1,2,2,1195,1228,8
Task 1195,Job 1,7,9,2,6,1,9,13,4,2,3,1,1195,1228,10
Task 1196,Job 0,5,10,3,11,1,8,16,8,3,3,0,1196,1229,7
Task 1196,Job 1,10,9,1,11,0,11,21,10,1,3,2,1196,1229,5
Task 1197,Job 0,10,10,2,11,0,12,21,9,2,4,0,1197,1230,18
Task 1197,Job 1,15,5,1,12,0,16,27,11,1,4,0,1197,1230,19
Task 1198,Job 0,3,8,2,9,0,5,12,7,2,3,2,1198,1231,18
Task 1198,Job 1,8,7,2,11,0,10,19,9,2,3,0,1198,1231,20
Task 1199,Job 0,10,9,3,7,1,13,17,4,3,3,0,1199,1232,19
Task 1199,Job 1,15,6,4,10,0,19,25,6,4,4,1,1199,1232,8
Task 1200,Job 0,6,8,1,11,0,7,17,10,1,2,2,1200,1234,12
Task 1200,Job 1,11,8,1,6,0,12,17,5,1,2,2,1200,1234,3
Task 1201,Job 0,3,6,2,7,0,5,10,5,2,2,0,1201,1234,15
Task 1201,Job 1,8,4,1,7,0,9,15,6,1,3,2,1201,1234,4
Task 1202,Job 0,3,6,3,7,0,6,10,4,3,4,2,1202,1235,7
Task 1202,Job 1,8,8,1,10,0,9,18,9,1,4,0,1202,1235,17
Task 1203,Job 0,7,7,1,10,0,8,17,9,1,4,2,1203,1237,18
Task 1203,Job 1,12,7,4,7,0,16,19,3,4,1,2,1203,1237,8
Task 1204,Job 0,9,6,2,8,0,11,17,6,2,2,2,1204,1237,10
Task 1204,Job 1,14,9,2,12,0,16,26,10,2,1,2,1204,1237,15
Task 1205,Job 0,2,4,4,11,0,6,13,7,4,3,1,1205,1239,8
Task 1205,Job 1,7,4,2,8,1,9,15,6,2,3,1,1205,1239,3
Task 1206,Job 0,4,7,2,7,0,6,11,5,2,2,1,1206,1240,13
Task 1206,Job 1,9,4,1,11,0,10,20,10,1,4,2,1206,1240,16
Task 1207,Job 0,4,10,1,12,1,5,16,11,1,1,1,1207,1241,17
Task 1207,Job 1,9,8,1,6,0,10,15,5,1,4,0,1207,1241,19
Task 1208,Job 0,4,9,4,12,0,8,16,8,4,1,0,1208,1241,14
Task 1208,Job 1,9,6,1,6,0,10,15,5,1,1,1,1208,1241,10
Task 1209,Job 0,4,10,4,10,1,8,14,6,4,3,1,1209,1242,20
Task 1209,Job 1,9,10,1,6,0,10,15,5,1,3,2,1209,1242,11
Task 1210,Job 0,7,7,4,7,1,11,14,3,4,2,2,1210,1243,10
Task 1210,Job 1,12,6,4,11,0,16,23,7,4,3,0,1210,1243,16
Task 1211,Job 0,4,5,4,8,0,8,12,4,4,4,1,1211,1244,10
Task 1211,Job 1,9,10,4,10,1,13,19,6,4,1,2,1211,1244,18
Task 1212,Job 0,1,7,1,8,1,2,9,7,1,4,2,1212,1245,3
Task 1212,Job 1,6,10,1,9,1,7,15,8,1,2,2,1212,1245,14
Task 1213,Job 0,4,5,1,11,0,5,15,10,1,3,0,1213,1246,20
Task 1213,Job 1,9,4,3,7,0,12,16,4,3,3,1,1213,1246,4
Task 1214,Job 0,9,8,4,12,1,13,21,8,4,4,1,1214,1247,4
Task 1214,Job 1,14,6,1,9,0,15,23,8,1,1,1,1214,1247,20
Task 1215,Job 0,4,5,3,7,1,7,11,4,3,1,0,1215,1249,16
Task 1215,Job 1,9,4,1,7,1,10,16,6,1,2,0,1215,1249,12
Task 1216,Job 0,3,6,3,12,0,6,15,9,3,3,0,1216,1249,6
Task 1216,Job 1,8,6,2,11,1,10,19,9,2,4,0,1216,1249,7
Task 1217,Job 0,3,4,3,12,0,6,15,9,3,3,1,1217,1250,10
Task 1217,Job 1,8,10,1,6,0,9,14,5,1,4,1,1217,1250,8
Task 1218,Job 0,9,4,2,9,0,11,18,7,2,1,1,1218,1252,7
Task 1218,Job 1,14,8,4,11,0,18,25,7,4,3,1,1218,1252,5
Task 1219,Job 0,9,10,3,12,0,12,21,9,3,1,0,1219,1252,13
Task 1219,Job 1,14,6,3,9,0,17,23,6,3,3,2,1219,1252,2
Task 1220,Job 0,7,9,3,7,0,10,14,4,3,1,2,1220,1254,12
Task 1220,Job 1,12,5,1,8,0,13,20,7,1,1,2,1220,1254,5
Task 1221,Job 0,2,4,3,12,0,5,14,9,3,1,0,1221,1254,12
Task 1221,Job 1,7,9,4,12,0,11,19,8,4,1,0,1221,1254,5
Task 1222,Job 0,7,8,2,9,0,9,16,7,2,1,2,1222,1255,19
Task 1222,Job 1,12,4,1,6,0,13,18,5,1,3,2,1222,1255,17
Task 1223,Job 0,4,5,2,9,0,6,13,7,2,1,2,1223,1257,7
Task 1223,Job 1,9,9,2,7,1,11,16,5,2,1,1,1223,1257,7
Task 1224,Job 0,5,9,1,9,0,6,14,8,1,1,0,1224,1258,8
Task 1224,Job 1,10,5,4,12,0,14,22,8,4,1,1,1224,1258,17
Task 1225,Job 0,3,9,2,6,0,5,9,4,2,4,0,1225,1259,10
Task 1225,Job 1,8,5,2,8,0,10,16,6,2,1,2,1225,1259,8
Task 1226,Job 0,8,10,3,11,1,11,19,8,3,2,2,1226,1259,16
Task 1226,Job 1,13,10,2,10,0,15,23,8,2,2,1,1226,1259,15
Task 1227,Job 0,4,8,1,12,1,5,16,11,1,2,0,1227,1261,15
Task 1227,Job 1,9,4,3,9,0,12,18,6,3,3,1,1227,1261,14
Task 1228,Job 0,6,8,2,10,0,8,16,8,2,2,1,1228,1262,20
Task 1228,Job 1,11,9,1,6,0,12,17,5,1,3,1,1228,1262,14
Task 1229,Job 0,10,10,2,12,0,12,22,10,2,3,2,1229,1263,14
Task 1229,Job 1,15,7,2,6,0,17,21,4,2,2,0,1229,1263,16
Task 1230,Job 0,4,6,1,11,0,5,15,10,1,4,0,1230,1264,14
Task 1230,Job 1,9,5,4,12,0,13,21,8,4,4,2,1230,1264,7
Task 1231,Job 0,7,10,4,10,1,11,17,6,4,4,1,1231,1265,11
Task 1231,Job 1,12,9,4,10,0,16,22,6,4,1,1,1231,1265,7
Task 1232,Job 0,1,9,4,7,0,5,8,3,4,2,2,1232,1266,12
Task 1232,Job 1,6,6,2,12,1,8,18,10,2,2,1,1232,1266,12
Task 1233,Job 0,1,8,3,10,1,4,11,7,3,1,0,1233,1266,16
Task 1233,Job 1,6,9,2,9,0,8,15,7,2,1,1,1233,1266,12
Task 1234,Job 0,8,9,4,6,1,12,14,2,4,3,0,1234,1267,15
Task 1234,Job 1,13,6,1,11,0,14,24,10,1,1,0,1234,1267,20
Task 1235,Job 0,5,10,4,6,0,9,11,2,4,4,0,1235,1269,16
Task 1235,Job 1,10,6,2,10,0,12,20,8,2,3,1,1235,1269,7
Task 1236,Job 0,8,5,1,8,0,9,16,7,1,2,0,1236,1270,14
Task 1236,Job 1,13,8,2,12,1,15,25,10,2,2,2,1236,1270,16
Task 1237,Job 0,5,10,2,10,0,7,15,8,2,4,0,1237,1271,11
Task 1237,Job 1,10,6,2,7,0,12,17,5,2,4,1,1237,1271,4
Task 1238,Job 0,8,5,4,6,0,12,14,2,4,3,0,1238,1271,19
Task 1238,Job 1,13,7,4,12,0,17,25,8,4,2,2,1238,1271,19
Task 1239,Job 0,8,8,2,7,0,10,15,5,2,4,1,1239,1272,3
Task 1239,Job 1,13,5,4,6,1,17,19,2,4,1,2,1239,1272,3
Task 1240,Job 0,1,6,3,12,0,4,13,9,3,1,2,1240,1274,11
Task 1240,Job 1,6,5,2,12,0,8,18,10,2,3,2,1240,1274,7
Task 1241,Job 0,6,6,4,11,0,10,17,7,4,2,2,1241,1275,15
Task 1241,Job 1,11,8,3,11,0,14,22,8,3,1,2,1241,1275,20
Task 1242,Job 0,3,7,4,6,1,7,9,2,4,1,2,1242,1276,11
Task 1242,Job 1,8,7,4,7,0,12,15,3,4,1,1,1242,1276,3
Task 1243,Job 0,4,6,4,10,1,8,14,6,4,4,0,1243,1276,10
Task 1243,Job 1,9,8,2,12,0,11,21,10,2,3,0,1243,1276,8
Task 1244,Job 0,2,10,1,7,0,3,9,6,1,3,1,1244,1277,4
Task 1244,Job 1,7,9,1,10,1,8,17,9,1,3,1,1244,1277,20
Task 1245,Job 0,4,4,4,10,0,8,14,6,4,2,1,1245,1279,15
Task 1245,Job 1,9,6,1,6,0,10,15,5,1,1,1,1245,1279,15
Task 1246,Job 0,9,4,3,9,1,12,18,6,3,3,0,1246,1280,2
Task 1246,Job 1,14,9,3,6,1,17,20,3,3,3,2,1246,1280,13
Task 1247,Job 0,6,10,3,11,0,9,17,8,3,1,1,1247,1281,6
Task 1247,Job 1,11,10,3,9,0,14,20,6,3,4,0,1247,1281,8
Task 1248,Job 0,10,6,4,7,0,14,17,3,4,1,2,1248,1282,20
Task 1248,Job 1,15,5,4,12,0,19,27,8,4,3,0,1248,1282,7
Task 1249,Job 0,2,4,1,8,1,3,10,7,1,3,1,1249,1283,13
Task 1249,Job 1,7,5,3,7,0,10,14,4,3,4,0,1249,1283,15
Task 1250,Job 0,6,5,3,11,0,9,17,8,3,1,0,1250,1283,2
Task 1250,Job 1,11,7,3,8,0,14,19,5,3,2,1,1250,1283,15
Task 1251,Job 0,2,6,1,10,1,3,12,9,1,2,1,1251,1285,5
Task 1251,Job 1,7,8,2,12,0,9,19,10,2,1,0,1251,1285,4
Task 1252,Job 0,5,6,3,11,0,8,16,8,3,3,1,1252,1286,8
Task 1252,Job 1,10,8,2,11,0,12,21,9,2,3,0,1252,1286,17
Task 1253,Job 0,8,7,3,12,1,11,20,9,3,1,0,1253,1287,14
Task 1253,Job 1,13,7,4,10,0,17,23,6,4,1,1,1253,1287,12
Task 1254,Job 0,3,9,4,12,0,7,15,8,4,3,1,1254,1287,11
Task 1254,Job 1,8,7,2,8,0,10,16,6,2,3,1,1254,1287,4
Task 1255,Job 0,4,10,4,11,0,8,15,7,4,3,2,1255,1288,20
Task 1255,Job 1,9,10,2,10,0,11,19,8,2,3,2,1255,1288,19
Task 1256,Job 0,3,10,2,12,0,5,15,10,2,2,2,1256,1289,18
Task 1256,Job 1,8,10,2,8,0,10,16,6,2,1,2,1256,1289,16
Task 1257,Job 0,8,10,2,7,0,10,15,5,2,1,0,1257,1290,7
Task 1257,Job 1,13,9,4,6,0,17,19,2,4,4,0,1257,1290,20
Task 1258,Job 0,8,7,4,10,1,12,18,6,4,3,0,1258,1292,10
Task 1258,Job 1,13,7,4,8,0,17,21,4,4,1,1,1258,1292,3
Task 1259,Job 0,6,10,2,12,0,8,18,10,2,4,2,1259,1292,8
Task 1259,Job 1,11,8,1,11,0,12,22,10,1,3,1,1259,1292,8
Task 1260,Job 0,2,8,1,10,0,3,12,9,1,3,1,1260,1293,19
Task 1260,Job 1,7,9,2,9,1,9,16,7,2,2,1,1260,1293,17
Task 1261,Job 0,3,6,3,6,0,6,9,3,3,4,0,1261,1294,20
Task 1261,Job 1,8,8,3,6,1,11,14,3,3,3,0,1261,1294,10
Task 1262,Job 0,9,7,4,7,0,13,16,3,4,1,1,1262,1295,10
Task 1262,Job 1,14,5,2,9,0,16,23,7,2,2,1,1262,1295,17
Task 1263,Job 0,2,7,1,6,0,3,8,5,1,3,1,1263,1296,5
Task 1263,Job 1,7,6,4,10,0,11,17,6,4,2,1,1263,1296,18
Task 1264,Job 0,6,4,4,11,0,10,17,7,4,1,0,1264,1298,19
Task 1264,Job 1,11,8,4,10,0,15,21,6,4,2,0,1264,1298,15
Task 1265,Job 0,10,6,2,6,0,12,16,4,2,1,1,1265,1299,16
Task 1265,Job 1,15,4,1,10,0,16,25,9,1,1,0,1265,1299,10
Task 1266,Job 0,5,5,2,9,0,7,14,7,2,2,0,1266,1300,3
Task 1266,Job 1,10,7,4,9,0,14,19,5,4,2,0,1266,1300,8
Task 1267,Job 0,3,6,4,12,0,7,15,8,4,1,2,1267,1301,9
Task 1267,Job 1,8,7,4,6,0,12,14,2,4,3,0,1267,1301,19
Task 1268,Job 0,6,4,2,9,1,8,15,7,2,4,0,1268,1302,10
Task 1268,Job 1,11,6,4,8,0,15,19,4,4,2,2,1268,1302,15
Task 1269,Job 0,4,4,3,7,0,7,11,4,3,1,2,1269,1302,9
Task 1269,Job 1,9,10,1,8,0,10,17,7,1,4,2,1269,1302,3
Task 1270,Job 0,2,7,4,6,1,6,8,2,4,1,2,1270,1303,5
Task 1270,Job 1,7,5,3,11,0,10,18,8,3,4,0,1270,1303,5
Task 1271,Job 0,7,10,1,10,0,8,17,9,1,2,1,1271,1305,3
Task 1271,Job 1,12,9,3,6,0,15,18,3,3,2,2,1271,1305,7
Task 1272,Job 0,1,9,2,6,0,3,7,4,2,1,0,1272,1306,16
Task 1272,Job 1,6,5,3,7,0,9,13,4,3,1,2,1272,1306,12
Task 1273,Job 0,1,5,4,12,0,5,13,8,4,1,2,1273,1307,13
Task 1273,Job 1,6,9,2,10,0,8,16,8,2,4,1,1273,1307,10
Task 1274,Job 0,1,9,4,7,0,5,8,3,4,3,1,1274,1307,20
Task 1274,Job 1,6,8,2,8,0,8,14,6,2,1,2,1274,1307,6
Task 1275,Job 0,6,7,4,12,0,10,18,8,4,3,0,1275,1308,12
Task 1275,Job 1,11,10,2,6,0,13,17,4,2,2,1,1275,1308,7
Task 1276,Job 0,4,4,1,9,0,5,13,8,1,1,1,1276,1309,20
Task 1276,Job 1,9,7,2,11,1,11,20,9,2,3,0,1276,1309,18
Task 1277,Job 0,5,9,1,11,0,6,16,10,1,1,1,1277,1311,10
Task 1277,Job 1,10,10,3,9,1,13,19,6,3,4,1,1277,1311,8
Task 1278,Job 0,8,6,2,11,0,10,19,9,2,1,2,1278,1311,19
Task 1278,Job 1,13,4,3,9,1,16,22,6,3,3,1,1278,1311,2
Task 1279,Job 0,2,10,1,8,1,3,10,7,1,1,0,1279,1312,17
Task 1279,Job 1,7,5,1,11,1,8,18,10,1,2,1,1279,1312,16
Task 1280,Job 0,1,8,3,12,0,4,13,9,3,4,1,1280,1314,14
Task 1280,Job 1,6,8,1,12,0,7,18,11,1,4,0,1280,1314,15
Task 1281,Job 0,9,5,2,7,0,11,16,5,2,2,1,1281,1315,17
Task 1281,Job 1,14,7,4,12,0,18,26,8,4,4,1,1281,1315,9
Task 1282,Job 0,9,7,1,9,0,10,18,8,1,1,0,1282,1316,6
Task 1282,Job 1,14,9,2,11,1,16,25,9,2,3,1,1282,1316,2
Task 1283,Job 0,10,8,4,11,0,14,21,7,4,2,1,1283,1316,13
Task 1283,Job 1,15,9,1,12,0,16,27,11,1,3,1,1283,1316,5
Task 1284,Job 0,8,10,4,7,1,12,15,3,4,4,1,1284,1317,10
Task 1284,Job 1,13,10,3,10,0,16,23,7,3,2,0,1284,1317,12
Task 1285,Job 0,8,9,3,7,1,11,15,4,3,1,0,1285,1319,15
Task 1285,Job 1,13,9,3,9,0,16,22,6,3,4,2,1285,1319,18
Task 1286,Job 0,9,9,3,8,0,12,17,5,3,1,0,1286,1319,10
Task 1286,Job 1,14,9,1,9,0,15,23,8,1,3,2,1286,1319,4
Task 1287,Job 0,4,10,1,8,1,5,12,7,1,3,2,1287,1321,8
Task 1287,Job 1,9,4,2,8,0,11,17,6,2,3,0,1287,1321,10
Task 1288,Job 0,8,7,4,7,0,12,15,3,4,4,2,1288,1321,17
Task 1288,Job 1,13,8,3,8,0,16,21,5,3,4,1,1288,1321,10
Task 1289,Job 0,3,7,2,6,0,5,9,4,2,4,0,1289,1322,3
Task 1289,Job 1,8,4,4,8,1,12,16,4,4,1,1,1289,1322,19
Task 1290,Job 0,3,4,3,7,0,6,10,4,3,1,2,1290,1323,2
Task 1290,Job 1,8,4,1,7,0,9,15,6,1,2,2,1290,1323,15
Task 1291,Job 0,6,7,3,10,0,9,16,7,3,4,1,1291,1324,14
Task 1291,Job 1,11,5,2,7,0,13,18,5,2,2,0,1291,1324,9
Task 1292,Job 0,5,9,4,11,1,9,16,7,4,4,0,1292,1325,7
Task 1292,Job 1,10,4,3,9,0,13,19,6,3,1,0,1292,1325,9
Task 1293,Job 0,10,9,2,7,0,12,17,5,2,1,2,1293,1327,15
Task 1293,Job 1,15,7,4,6,0,19,21,2,4,1,2,1293,1327,3
Task 1294,Job 0,5,6,1,6,0,6,11,5,1,1,0,1294,1327,20
Task 1294,Job 1,10,5,2,10,0,12,20,8,2,4,1,1294,1327,4
Task 1295,Job 0,8,4,1,11,0,9,19,10,1,1,1,1295,1328,2
Task 1295,Job 1,13,7,4,12,0,17,25,8,4,4,0,1295,1328,19
Task 1296,Job 0,1,4,2,6,0,3,7,4,2,3,1,1296,1329,20
Task 1296,Job 1,6,4,2,6,1,8,12,4,2,4,1,1296,1329,8
Task 1297,Job 0,7,6,2,7,0,9,14,5,2,4,1,1297,1330,5
Task 1297,Job 1,12,9,4,10,1,16,22,6,4,3,2,1297,1330,14
Task 1298,Job 0,5,5,4,12,0,9,17,8,4,2,1,1298,1331,13
Task 1298,Job 1,10,4,3,10,0,13,20,7,3,4,0,1298,1331,16
Task 1299,Job 0,6,10,2,8,1,8,14,6,2,1,0,1299,1332,18
Task 1299,Job 1,11,7,4,7,1,15,18,3,4,1,2,1299,1332,5
Task 1300,Job 0,6,5,4,12,1,10,18,8,4,3,1,1300,1334,9
Task 1300,Job 1,11,4,2,6,0,13,17,4,2,1,1,1300,1334,8
Task 1301,Job 0,1,6,3,9,0,4,10,6,3,4,1,1301,1335,16
Task 1301,Job 1,6,9,2,6,0,8,12,4,2,3,2,1301,1335,13
Task 1302,Job 0,7,8,4,9,0,11,16,5,4,4,1,1302,1336,8
Task 1302,Job 1,12,9,4,7,0,16,19,3,4,2,0,1302,1336,11
Task 1303,Job 0,10,7,1,10,0,11,20,9,1,1,2,1303,1337,20
Task 1303,Job 1,15,10,1,10,0,16,25,9,1,3,0,1303,1337,13
Task 1304,Job 0,4,7,4,6,0,8,10,2,4,1,1,1304,1338,20
Task 1304,Job 1,9,5,3,9,0,12,18,6,3,4,2,1304,1338,2
Task 1305,Job 0,4,5,1,7,0,5,11,6,1,1,2,1305,1339,16
Task 1305,Job 1,9,8,4,6,0,13,15,2,4,2,0,1305,1339,15
Task 1306,Job 0,5,4,3,10,0,8,15,7,3,2,0,1306,1340,8
Task 1306,Job 1,10,9,2,6,0,12,16,4,2,4,2,1306,1340,4
Task 1307,Job 0,6,10,3,11,0,9,17,8,3,3,2,1307,1341,3
Task 1307,Job 1,11,5,4,11,0,15,22,7,4,3,0,1307,1341,12
Task 1308,Job 0,2,7,1,8,1,3,10,7,1,1,0,1308,1341,18
Task 1308,Job 1,7,8,4,8,1,11,15,4,4,2,1,1308,1341,9
Task 1309,Job 0,5,4,1,8,0,6,13,7,1,3,1,1309,1343,14
Task 1309,Job 1,10,6,3,9,0,13,19,6,3,1,0,1309,1343,10
Task 1310,Job 0,3,8,2,7,0,5,10,5,2,2,0,1310,1344,7
Task 1310,Job 1,8,5,2,10,0,10,18,8,2,2,1,1310,1344,20
Task 1311,Job 0,1,10,3,9,0,4,10,6,3,4,2,1311,1344,6
Task 1311,Job 1,6,8,1,11,0,7,17,10,1,2,1,1311,1344,5
Task 1312,Job 0,2,4,4,6,0,6,8,2,4,1,0,1312,1346,4
Task 1312,Job 1,7,10,2,6,1,9,13,4,2,4,1,1312,1346,17
Task 1313,Job 0,7,7,3,9,0,10,16,6,3,4,0,1313,1346,15
Task 1313,Job 1,12,4,2,6,1,14,18,4,2,1,2,1313,1346,5
Task 1314,Job 0,4,6,2,6,0,6,10,4,2,2,2,1314,1348,19
Task 1314,Job 1,9,5,2,9,1,11,18,7,2,2,2,1314,1348,10
Task 1315,Job 0,2,6,3,8,0,5,10,5,3,1,0,1315,1348,19
Task 1315,Job 1,7,4,1,6,0,8,13,5,1,3,1,1315,1348,12
Task 1316,Job 0,10,10,3,10,1,13,20,7,3,3,0,1316,1350,4
Task 1316,Job 1,15,8,1,7,0,16,22,6,1,1,2,1316,1350,8
Task 1317,Job 0,7,8,1,11,0,8,18,10,1,1,1,1317,1351,4
Task 1317,Job 1,12,9,3,12,1,15,24,9,3,4,2,1317,1351,3
Task 1318,Job 0,10,10,3,8,0,13,18,5,3,1,0,1318,1352,10
Task 1318,Job 1,15,5,1,7,0,16,22,6,1,1,0,1318,1352,14
Task 1319,Job 0,8,5,4,11,0,12,19,7,4,2,2,1319,1353,20
Task 1319,Job 1,13,9,1,11,0,14,24,10,1,2,0,1319,1353,10
Task 1320,Job 0,6,5,4,12,1,10,18,8,4,3,0,1320,1353,14
Task 1320,Job 1,11,8,3,12,1,14,23,9,3,4,1,1320,1353,3
Task 1321,Job 0,3,9,3,7,0,6,10,4,3,2,2,1321,1354,17
Task 1321,Job 1,8,9,2,9,0,10,17,7,2,3,2,1321,1354,3
Task 1322,Job 0,5,10,4,9,0,9,14,5,4,1,1,1322,1355,12
Task 1322,Job 1,10,10,2,10,1,12,20,8,2,2,2,1322,1355,15
Task 1323,Job 0,2,8,1,7,0,3,9,6,1,2,2,1323,1356,18
Task 1323,Job 1,7,7,2,9,0,9,16,7,2,1,0,1323,1356,7
Task 1324,Job 0,2,8,1,8,1,3,10,7,1,3,0,1324,1357,13
Task 1324,Job 1,7,8,1,11,0,8,18,10,1,4,0,1324,1357,14
Task 1325,Job 0,3,7,1,6,0,4,9,5,1,2,0,1325,1359,5
Task 1325,Job 1,8,6,1,10,0,9,18,9,1,2,2,1325,1359,7
Task 1326,Job 0,5,9,3,12,0,8,17,9,3,3,0,1326,1359,7
Task 1326,Job 1,10,9,2,9,0,12,19,7,2,4,1,1326,1359,20
Task 1327,Job 0,1,7,2,9,0,3,10,7,2,4,1,1327,1360,7
Task 1327,Job 1,6,7,1,11,0,7,17,10,1,3,2,1327,1360,3
Task 1328,Job 0,1,6,4,10,0,5,11,6,4,3,0,1328,1362,10
Task 1328,Job 1,6,4,4,12,1,10,18,8,4,2,1,1328,1362,10
Task 1329,Job 0,1,5,4,7,1,5,8,3,4,1,1,1329,1363,12
Task 1329,Job 1,6,9,2,8,0,8,14,6,2,2,0,1329,1363,5
Task 1330,Job 0,9,7,4,6,0,13,15,2,4,3,2,1330,1363,7
Task 1330,Job 1,14,8,3,7,0,17,21,4,3,2,0,1330,1363,9
Task 1331,Job 0,10,10,2,8,0,12,18,6,2,4,0,1331,1365,2
Task 1331,Job 1,15,5,4,6,0,19,21,2,4,3,0,1331,1365,9
Task 1332,Job 0,8,10,2,6,0,10,14,4,2,2,1,1332,1365,10
Task 1332,Job 1,13,10,4,12,1,17,25,8,4,1,2,1332,1365,16
Task 1333,Job 0,10,5,2,7,0,12,17,5,2,4,0,1333,1367,17
Task 1333,Job 1,15,5,1,7,0,16,22,6,1,3,0,1333,1367,14
Task 1334,Job 0,10,7,4,8,0,14,18,4,4,2,2,1334,1367,19
Task 1334,Job 1,15,9,1,12,0,16,27,11,1,1,1,1334,1367,17
Task 1335,Job 0,9,5,4,8,0,13,17,4,4,2,0,1335,1369,10
Task 1335,Job 1,14,5,4,9,1,18,23,5,4,2,2,1335,1369,15
Task 1336,Job 0,1,10,2,11,1,3,12,9,2,4,2,1336,1370,17
Task 1336,Job 1,6,8,4,6,0,10,12,2,4,2,0,1336,1370,3
Task 1337,Job 0,7,8,2,11,0,9,18,9,2,4,0,1337,1371,15
Task 1337,Job 1,12,4,3,8,0,15,20,5,3,1,1,1337,1371,5
Task 1338,Job 0,2,8,2,9,0,4,11,7,2,1,2,1338,1371,10
Task 1338,Job 1,7,10,1,7,0,8,14,6,1,4,1,1338,1371,4
Task 1339,Job 0,4,9,3,12,1,7,16,9,3,2,1,1339,1373,20
Task 1339,Job 1,9,9,2,11,1,11,20,9,2,3,0,1339,1373,2
Task 1340,Job 0,9,6,2,9,0,11,18,7,2,1,0,1340,1373,16
Task 1340,Job 1,14,5,1,10,0,15,24,9,1,1,0,1340,1373,19
Task 1341,Job 0,7,9,4,6,1,11,13,2,4,2,2,1341,1374,10
Task 1341,Job 1,12,6,3,10,1,15,22,7,3,2,1,1341,1374,17
Task 1342,Job 0,9,10,3,12,0,12,21,9,3,2,1,1342,1375,13
Task 1342,Job 1,14,8,4,10,1,18,24,6,4,4,0,1342,1375,13
Task 1343,Job 0,3,4,3,6,0,6,9,3,3,3,0,1343,1377,11
Task 1343,Job 1,8,8,2,10,1,10,18,8,2,1,1,1343,1377,5
Task 1344,Job 0,4,5,3,10,0,7,14,7,3,3,1,1344,1378,3
Task 1344,Job 1,9,8,2,8,0,11,17,6,2,4,2,1344,1378,2
Task 1345,Job 0,4,7,2,7,0,6,11,5,2,1,0,1345,1378,3
Task 1345,Job 1,9,6,4,10,0,13,19,6,4,3,2,1345,1378,17
Task 1346,Job 0,3,7,1,7,1,4,10,6,1,2,0,1346,1379,10
Task 1346,Job 1,8,6,1,12,0,9,20,11,1,2,0,1346,1379,3
Task 1347,Job 0,9,7,4,8,1,13,17,4,4,3,1,1347,1380,14
Task 1347,Job 1,14,9,3,7,0,17,21,4,3,1,1,1347,1380,3
Task 1348,Job 0,9,5,2,7,0,11,16,5,2,1,0,1348,1382,4
Task 1348,Job 1,14,7,4,10,1,18,24,6,4,1,1,1348,1382,17
Task 1349,Job 0,3,4,3,11,0,6,14,8,3,4,0,1349,1382,20
Task 1349,Job 1,8,6,1,7,0,9,15,6,1,2,0,1349,1382,2
Task 1350,Job 0,2,4,1,6,0,3,8,5,1,2,0,1350,1383,14
Task 1350,Job 1,7,6,4,6,0,11,13,2,4,4,1,1350,1383,3
Task 1351,Job 0,2,7,2,9,0,4,11,7,2,2,1,1351,1384,16
Task 1351,Job 1,7,5,1,7,0,8,14,6,1,2,0,1351,1384,5
Task 1352,Job 0,2,8,2,9,0,4,11,7,2,2,1,1352,1386,4
Task 1352,Job 1,7,6,2,6,1,9,13,4,2,4,1,1352,1386,15
Task 1353,Job 0,8,7,4,12,0,12,20,8,4,2,1,1353,1387,10
Task 1353,Job 1,13,9,2,7,0,15,20,5,2,4,1,1353,1387,3
Task 1354,Job 0,7,8,2,8,0,9,15,6,2,2,2,1354,1388,14
Task 1354,Job 1,12,9,2,12,0,14,24,10,2,4,1,1354,1388,7
Task 1355,Job 0,9,10,3,9,1,12,18,6,3,3,2,1355,1389,7
Task 1355,Job 1,14,9,4,12,0,18,26,8,4,4,1,1355,1389,5
Task 1356,Job 0,1,9,1,12,0,2,13,11,1,4,2,1356,1390,7
Task 1356,Job 1,6,7,3,10,0,9,16,7,3,3,2,1356,1390,20
Task 1357,Job 0,8,7,4,9,0,12,17,5,4,4,0,1357,1390,19
Task 1357,Job 1,13,5,1,10,0,14,23,9,1,1,1,1357,1390,19
Task 1358,Job 0,5,10,2,11,1,7,16,9,2,2,1,1358,1391,10
Task 1358,Job 1,10,4,4,12,0,14,22,8,4,4,2,1358,1391,14
Task 1359,Job 0,7,4,1,6,1,8,13,5,1,4,1,1359,1392,13
Task 1359,Job 1,12,4,1,12,1,13,24,11,1,2,1,1359,1392,9
Task 1360,Job 0,8,8,4,6,0,12,14,2,4,4,1,1360,1393,2
Task 1360,Job 1,13,10,3,11,0,16,24,8,3,1,1,1360,1393,17
Task 1361,Job 0,5,4,1,11,0,6,16,10,1,3,2,1361,1395,12
Task 1361,Job 1,10,9,3,8,0,13,18,5,3,2,0,1361,1395,19
Task 1362,Job 0,5,5,2,10,1,7,15,8,2,1,0,1362,1396,19
Task 1362,Job 1,10,4,4,10,1,14,20,6,4,2,2,1362,1396,11
Task 1363,Job 0,8,6,3,7,0,11,15,4,3,2,0,1363,1396,5
Task 1363,Job 1,13,4,3,9,1,16,22,6,3,1,1,1363,1396,17
Task 1364,Job 0,4,6,4,6,1,8,10,2,4,2,2,1364,1398,11
Task 1364,Job 1,9,4,1,9,1,10,18,8,1,3,2,1364,1398,14
Task 1365,Job 0,8,5,4,9,0,12,17,5,4,1,1,1365,1399,18
Task 1365,Job 1,13,7,2,8,0,15,21,6,2,4,0,1365,1399,18
Task 1366,Job 0,7,4,4,10,0,11,17,6,4,3,2,1366,1400,18
Task 1366,Job 1,12,9,1,6,1,13,18,5,1,1,1,1366,1400,16
Task 1367,Job 0,9,8,2,8,1,11,17,6,2,3,2,1367,1400,16
Task 1367,Job 1,14,8,1,11,1,15,25,10,1,1,1,1367,1400,14
Task 1368,Job 0,5,8,3,7,1,8,12,4,3,1,1,1368,1401,7
Task 1368,Job 1,10,4,3,8,1,13,18,5,3,4,1,1368,1401,15
Task 1369,Job 0,5,9,2,12,0,7,17,10,2,4,0,1369,1403,16
Task 1369,Job 1,10,8,2,12,0,12,22,10,2,3,0,1369,1403,7
Task 1370,Job 0,7,10,1,12,0,8,19,11,1,1,2,1370,1404,16
Task 1370,Job 1,12,7,1,12,0,13,24,11,1,3,0,1370,1404,18
Task 1371,Job 0,6,6,2,10,0,8,16,8,2,1,2,1371,1405,12
Task 1371,Job 1,11,4,4,11,0,15,22,7,4,3,2,1371,1405,14
Task 1372,Job 0,7,5,3,11,0,10,18,8,3,4,1,1372,1405,15
Task 1372,Job 1,12,5,4,11,0,16,23,7,4,4,0,1372,1405,14
Task 1373,Job 0,8,8,3,8,0,11,16,5,3,4,0,1373,1407,19
Task 1373,Job 1,13,7,1,12,1,14,25,11,1,1,1,1373,1407,3
Task 1374,Job 0,7,10,3,8,0,10,15,5,3,3,1,1374,1407,4
Task 1374,Job 1,12,6,2,9,1,14,21,7,2,2,1,1374,1407,3
Task 1375,Job 0,3,5,3,8,1,6,11,5,3,4,2,1375,1409,16
Task 1375,Job 1,8,5,1,11,0,9,19,10,1,3,0,1375,1409,14
Task 1376,Job 0,2,5,3,6,0,5,8,3,3,1,2,1376,1410,2
Task 1376,Job 1,7,8,3,8,1,10,15,5,3,4,2,1376,1410,14
Task 1377,Job 0,4,7,2,12,0,6,16,10,2,4,0,1377,1410,2
Task 1377,Job 1,9,9,3,11,0,12,20,8,3,2,1,1377,1410,5
Task 1378,Job 0,4,10,1,8,1,5,12,7,1,1,0,1378,1411,3
Task 1378,Job 1,9,5,3,11,1,12,20,8,3,2,1,1378,1411,2
Task 1379,Job 0,8,10,2,6,0,10,14,4,2,4,0,1379,1412,5
Task 1379,Job 1,13,8,3,8,0,16,21,5,3,1,2,1379,1412,19
Task 1380,Job 0,10,9,1,12,0,11,22,11,1,3,2,1380,1414,6
Task 1380,Job 1,15,6,2,10,0,17,25,8,2,4,2,1380,1414,15
Task 1381,Job 0,1,9,4,12,1,5,13,8,4,2,1,1381,1414,2
Task 1381,Job 1,6,6,1,6,0,7,12,5,1,1,1,1381,1414,11
Task 1382,Job 0,3,6,1,12,0,4,15,11,1,1,0,1382,1416,5
Task 1382,Job 1,8,5,2,7,0,10,15,5,2,1,0,1382,1416,4
Task 1383,Job 0,4,6,3,8,1,7,12,5,3,3,0,1383,1417,2
Task 1383,Job 1,9,6,3,12,0,12,21,9,3,4,1,1383,1417,17
Task 1384,Job 0,9,5,1,7,0,10,16,6,1,3,2,1384,1418,7
Task 1384,Job 1,14,7,4,7,0,18,21,3,4,4,2,1384,1418,17
Task 1385,Job 0,8,9,3,10,0,11,18,7,3,3,2,1385,1418,9
Task 1385,Job 1,13,7,1,7,1,14,20,6,1,4,0,1385,1418,8
Task 1386,Job 0,10,6,1,10,0,11,20,9,1,4,2,1386,1419,13
Task 1386,Job 1,15,6,2,6,1,17,21,4,2,2,2,1386,1419,2
Task 1387,Job 0,6,7,1,7,0,7,13,6,1,3,2,1387,1421,10
Task 1387,Job 1,11,6,3,9,0,14,20,6,3,4,1,1387,1421,19
Task 1388,Job 0,3,10,3,12,0,6,15,9,3,3,0,1388,1422,3
Task 1388,Job 1,8,9,2,12,0,10,20,10,2,3,1,1388,1422,18
Task 1389,Job 0,3,8,4,6,1,7,9,2,4,1,0,1389,1422,16
Task 1389,Job 1,8,7,4,12,0,12,20,8,4,3,1,1389,1422,9
Task 1390,Job 0,2,9,2,9,0,4,11,7,2,4,0,1390,1423,18
Task 1390,Job 1,7,9,4,7,0,11,14,3,4,2,1,1390,1423,16
Task 1391,Job 0,2,4,3,12,1,5,14,9,3,2,0,1391,1424,5
Task 1391,Job 1,7,6,1,6,0,8,13,5,1,2,0,1391,1424,8
Task 1392,Job 0,4,9,3,12,1,7,16,9,3,3,0,1392,1425,10
Task 1392,Job 1,9,4,4,12,0,13,21,8,4,2,1,1392,1425,7
Task 1393,Job 0,6,10,2,7,0,8,13,5,2,2,0,1393,1426,11
Task 1393,Job 1,11,6,2,9,0,13,20,7,2,2,1,1393,1426,4
Task 1394,Job 0,4,4,1,12,0,5,16,11,1,2,2,1394,1427,14
Task 1394,Job 1,9,5,3,11,0,12,20,8,3,3,0,1394,1427,16
Task 1395,Job 0,1,8,3,6,0,4,7,3,3,1,2,1395,1429,17
Task 1395,Job 1,6,8,2,12,1,8,18,10,2,1,1,1395,1429,13
Task 1396,Job 0,4,10,3,10,0,7,14,7,3,3,1,1396,1430,9
Task 1396,Job 1,9,6,2,7,0,11,16,5,2,4,2,1396,1430,11
Task 1397,Job 0,2,9,2,10,0,4,12,8,2,3,2,1397,1430,9
Task 1397,Job 1,7,4,1,6,1,8,13,5,1,2,1,1397,1430,2
Task 1398,Job 0,2,9,1,10,1,3,12,9,1,3,0,1398,1431,17
Task 1398,Job 1,7,8,2,10,1,9,17,8,2,4,2,1398,1431,12
Task 1399,Job 0,10,9,2,7,0,12,17,5,2,2,2,1399,1433,3
Task 1399,Job 1,15,6,3,7,1,18,22,4,3,3,2,1399,1433,16
Task 1400,Job 0,8,10,3,7,1,11,15,4,3,2,1,1400,1434,16
Task 1400,Job 1,13,4,3,6,0,16,19,3,3,2,1,1400,1434,17
Task 1401,Job 0,10,6,4,11,0,14,21,7,4,4,2,1401,1435,14
Task 1401,Job 1,15,9,4,8,0,19,23,4,4,1,0,1401,1435,2
Task 1402,Job 0,2,8,2,12,0,4,14,10,2,3,0,1402,1435,16
Task 1402,Job 1,7,7,3,12,0,10,19,9,3,1,0,1402,1435,17
Task 1403,Job 0,1,5,1,10,0,2,11,9,1,3,0,1403,1436,16
Task 1403,Job 1,6,4,3,12,0,9,18,9,3,4,0,1403,1436,17
Task 1404,Job 0,5,9,2,8,0,7,13,6,2,3,0,1404,1438,19
Task 1404,Job 1,10,7,3,8,0,13,18,5,3,3,2,1404,1438,2
Task 1405,Job 0,3,6,3,6,1,6,9,3,3,2,1,1405,1438,9
Task 1405,Job 1,8,9,2,8,0,10,16,6,2,1,1,1405,1438,2
Task 1406,Job 0,4,8,3,12,0,7,16,9,3,4,1,1406,1440,14
Task 1406,Job 1,9,7,3,8,0,12,17,5,3,2,1,1406,1440,20
Task 1407,Job 0,8,9,3,6,1,11,14,3,3,2,0,1407,1441,15
Task 1407,Job 1,13,5,3,11,0,16,24,8,3,1,1,1407,1441,19
Task 1408,Job 0,4,5,1,7,0,5,11,6,1,4,0,1408,1441,18
Task 1408,Job 1,9,4,1,11,0,10,20,10,1,2,1,1408,1441,4
Task 1409,Job 0,6,9,4,12,1,10,18,8,4,4,0,1409,1443,10
Task 1409,Job 1,11,9,3,12,0,14,23,9,3,4,0,1409,1443,7
Task 1410,Job 0,5,6,1,6,0,6,11,5,1,2,0,1410,1443,2
Task 1410,Job 1,10,8,3,8,0,13,18,5,3,1,2,1410,1443,10
Task 1411,Job 0,7,4,1,11,1,8,18,10,1,4,1,1411,1445,3
Task 1411,Job 1,12,5,4,12,0,16,24,8,4,1,1,1411,1445,12
Task 1412,Job 0,1,7,1,10,0,2,11,9,1,2,2,1412,1445,4
Task 1412,Job 1,6,5,2,8,1,8,14,6,2,3,1,1412,1445,13
Task 1413,Job 0,10,7,1,10,0,11,20,9,1,2,2,1413,1447,15
Task 1413,Job 1,15,8,1,7,0,16,22,6,1,2,1,1413,1447,4
Task 1414,Job 0,6,9,4,12,0,10,18,8,4,1,1,1414,1447,18
Task 1414,Job 1,11,10,2,11,0,13,22,9,2,3,2,1414,1447,17
Task 1415,Job 0,7,7,1,12,1,8,19,11,1,2,2,1415,1449,12
Task 1415,Job 1,12,7,4,7,0,16,19,3,4,2,0,1415,1449,7
Task 1416,Job 0,3,4,4,10,0,7,13,6,4,4,0,1416,1449,10
Task 1416,Job 1,8,9,4,9,1,12,17,5,4,2,1,1416,1449,9
Task 1417,Job 0,1,7,3,8,0,4,9,5,3,1,0,1417,1451,2
Task 1417,Job 1,6,7,4,6,0,10,12,2,4,3,2,1417,1451,18
Task 1418,Job 0,6,5,1,8,0,7,14,7,1,1,2,1418,1451,18
Task 1418,Job 1,11,9,4,7,1,15,18,3,4,1,2,1418,1451,11
Task 1419,Job 0,4,10,3,7,0,7,11,4,3,3,1,1419,1453,11
Task 1419,Job 1,9,7,4,10,1,13,19,6,4,4,2,1419,1453,15
Task 1420,Job 0,4,4,3,10,1,7,14,7,3,1,1,1420,1453,3
Task 1420,Job 1,9,8,2,7,0,11,16,5,2,4,0,1420,1453,19
Task 1421,Job 0,1,6,3,12,0,4,13,9,3,2,1,1421,1455,10
Task 1421,Job 1,6,6,1,9,0,7,15,8,1,2,0,1421,1455,9
Task 1422,Job 0,9,6,4,6,1,13,15,2,4,1,2,1422,1456,6
Task 1422,Job 1,14,5,1,7,1,15,21,6,1,4,0,1422,1456,2
Task 1423,Job 0,3,9,1,12,0,4,15,11,1,1,2,1423,1456,10
Task 1423,Job 1,8,7,1,10,0,9,18,9,1,1,0,1423,1456,19
Task 1424,Job 0,1,7,3,11,0,4,12,8,3,2,2,1424,1458,10
Task 1424,Job 1,6,9,1,10,1,7,16,9,1,3,2,1424,1458,8
Task 1425,Job 0,7,10,4,9,0,11,16,5,4,4,2,1425,1458,10
Task 1425,Job 1,12,8,4,12,0,16,24,8,4,3,1,1425,1458,11
Task 1426,Job 0,7,7,3,6,1,10,13,3,3,3,2,1426,1460,3
Task 1426,Job 1,12,9,2,11,0,14,23,9,2,4,1,1426,1460,12
Task 1427,Job 0,2,8,3,8,0,5,10,5,3,2,2,1427,1461,12
Task 1427,Job 1,7,5,4,8,0,11,15,4,4,2,1,1427,1461,9
Task 1428,Job 0,10,5,3,7,0,13,17,4,3,3,0,1428,1462,17
Task 1428,Job 1,15,4,2,7,0,17,22,5,2,1,0,1428,1462,15
Task 1429,Job 0,4,9,1,9,0,5,13,8,1,1,1,1429,1463,7
Task 1429,Job 1,9,9,4,6,0,13,15,2,4,1,2,1429,1463,11
Task 1430,Job 0,6,7,3,6,0,9,12,3,3,2,0,1430,1463,7
Task 1430,Job 1,11,9,2,6,1,13,17,4,2,2,2,1430,1463,3
Task 1431,Job 0,5,4,4,7,0,9,12,3,4,1,0,1431,1464,12
Task 1431,Job 1,10,9,1,11,0,11,21,10,1,3,0,1431,1464,13
Task 1432,Job 0,4,6,1,8,0,5,12,7,1,3,2,1432,1465,16
Task 1432,Job 1,9,7,4,6,1,13,15,2,4,4,0,1432,1465,19
Task 1433,Job 0,4,10,2,9,1,6,13,7,2,1,2,1433,1467,16
Task 1433,Job 1,9,10,2,12,0,11,21,10,2,3,0,1433,1467,2
Task 1434,Job 0,10,10,3,7,0,13,17,4,3,2,0,1434,1468,20
Task 1434,Job 1,15,5,2,12,0,17,27,10,2,2,0,1434,1468,13
Task 1435,Job 0,2,5,4,12,0,6,14,8,4,2,0,1435,1469,12
Task 1435,Job 1,7,5,1,6,0,8,13,5,1,3,2,1435,1469,5
Task 1436,Job 0,6,6,1,10,0,7,16,9,1,4,1,1436,1469,10
Task 1436,Job 1,11,6,2,9,1,13,20,7,2,2,0,1436,1469,17
Task 1437,Job 0,9,8,1,7,0,10,16,6,1,3,0,1437,1471,20
Task 1437,Job 1,14,4,1,11,1,15,25,10,1,4,2,1437,1471,10
Task 1438,Job 0,9,7,4,8,0,13,17,4,4,3,0,1438,1471,14
Task 1438,Job 1,14,4,4,9,0,18,23,5,4,2,1,1438,1471,2
Task 1439,Job 0,8,5,4,12,1,12,20,8,4,1,1,1439,1472,2
Task 1439,Job 1,13,10,1,10,0,14,23,9,1,3,1,1439,1472,13
Task 1440,Job 0,2,5,3,12,0,5,14,9,3,1,0,1440,1474,2
Task 1440,Job 1,7,7,1,6,1,8,13,5,1,2,0,1440,1474,8
Task 1441,Job 0,3,8,3,11,0,6,14,8,3,2,1,1441,1475,3
Task 1441,Job 1,8,8,4,7,0,12,15,3,4,2,0,1441,1475,8
Task 1442,Job 0,8,7,3,10,1,11,18,7,3,2,2,1442,1476,3
Task 1442,Job 1,13,8,2,12,0,15,25,10,2,4,1,1442,1476,12
Task 1443,Job 0,1,10,4,6,0,5,7,2,4,4,0,1443,1476,14
Task 1443,Job 1,6,5,2,8,0,8,14,6,2,2,0,1443,1476,20
Task 1444,Job 0,1,4,1,10,1,2,11,9,1,2,0,1444,1477,5
Task 1444,Job 1,6,8,4,11,0,10,17,7,4,3,2,1444,1477,11
Task 1445,Job 0,1,7,2,8,0,3,9,6,2,2,2,1445,1479,13
Task 1445,Job 1,6,6,4,6,0,10,12,2,4,3,1,1445,1479,7
Task 1446,Job 0,1,8,3,6,0,4,7,3,3,2,2,1446,1479,19
Task 1446,Job 1,6,9,4,10,1,10,16,6,4,1,0,1446,1479,8
Task 1447,Job 0,7,10,2,7,0,9,14,5,2,1,1,1447,1480,15
Task 1447,Job 1,12,5,2,7,0,14,19,5,2,2,2,1447,1480,8
Task 1448,Job 0,8,9,3,7,0,11,15,4,3,4,0,1448,1481,19
Task 1448,Job 1,13,8,2,12,0,15,25,10,2,2,0,1448,1481,13
Task 1449,Job 0,1,7,4,12,1,5,13,8,4,4,0,1449,1483,10
Task 1449,Job 1,6,8,2,10,0,8,16,8,2,3,1,1449,1483,2
Task 1450,Job 0,3,5,1,11,0,4,14,10,1,3,2,1450,1483,9
Task 1450,Job 1,8,6,2,11,0,10,19,9,2,2,1,1450,1483,5
Task 1451,Job 0,3,5,4,7,1,7,10,3,4,1,2,1451,1485,2
Task 1451,Job 1,8,8,2,6,1,10,14,4,2,3,0,1451,1485,19
Task 1452,Job 0,9,9,2,10,0,11,19,8,2,1,2,1452,1486,4
Task 1452,Job 1,14,9,4,8,0,18,22,4,4,3,1,1452,1486,9
Task 1453,Job 0,4,10,2,6,1,6,10,4,2,1,1,1453,1486,4
Task 1453,Job 1,9,7,4,12,1,13,21,8,4,2,1,1453,1486,6
Task 1454,Job 0,2,10,2,11,1,4,13,9,2,4,0,1454,1488,6
Task 1454,Job 1,7,5,4,11,0,11,18,7,4,2,1,1454,1488,2
Task 1455,Job 0,3,5,2,12,0,5,15,10,2,2,0,1455,1488,11
Task 1455,Job 1,8,10,2,8,0,10,16,6,2,1,1,1455,1488,5
Task 1456,Job 0,2,7,4,9,1,6,11,5,4,3,1,1456,1490,20
Task 1456,Job 1,7,10,4,11,0,11,18,7,4,2,2,1456,1490,17
Task 1457,Job 0,9,8,1,10,0,10,19,9,1,4,2,1457,1491,15
Task 1457,Job 1,14,7,1,10,0,15,24,9,1,3,2,1457,1491,12
Task 1458,Job 0,3,10,4,12,0,7,15,8,4,3,1,1458,1491,12
Task 1458,Job 1,8,4,2,7,1,10,15,5,2,4,2,1458,1491,6
Task 1459,Job 0,9,5,4,10,1,13,19,6,4,1,0,1459,1492,15
Task 1459,Job 1,14,4,1,11,1,15,25,10,1,1,1,1459,1492,3
Task 1460,Job 0,9,4,3,8,0,12,17,5,3,2,1,1460,1494,18
Task 1460,Job 1,14,4,2,10,0,16,24,8,2,3,1,1460,1494,10
Task 1461,Job 0,7,7,4,9,0,11,16,5,4,1,2,1461,1495,17
Task 1461,Job 1,12,7,3,12,0,15,24,9,3,2,1,1461,1495,17
Task 1462,Job 0,10,10,2,9,0,12,19,7,2,2,1,1462,1495,18
Task 1462,Job 1,15,10,2,10,0,17,25,8,2,4,1,1462,1495,6
Task 1463,Job 0,8,8,4,8,0,12,16,4,4,1,0,1463,1497,9
Task 1463,Job 1,13,4,2,10,1,15,23,8,2,2,1,1463,1497,16
Task 1464,Job 0,6,8,2,10,1,8,16,8,2,1,2,1464,1497,13
Task 1464,Job 1,11,7,1,9,1,12,20,8,1,3,2,1464,1497,19
Task 1465,Job 0,10,10,3,12,1,13,22,9,3,4,0,1465,1498,15
Task 1465,Job 1,15,4,3,8,0,18,23,5,3,3,0,1465,1498,14
Task 1466,Job 0,1,8,3,8,1,4,9,5,3,1,0,1466,1500,4
Task 1466,Job 1,6,4,1,7,0,7,13,6,1,1,0,1466,1500,10
Task 1467,Job 0,10,7,3,7,0,13,17,4,3,1,0,1467,1500,5
Task 1467,Job 1,15,7,1,7,1,16,22,6,1,1,0,1467,1500,15
Task 1468,Job 0,9,10,2,8,0,11,17,6,2,1,0,1468,1502,7
Task 1468,Job 1,14,7,1,12,0,15,26,11,1,3,1,1468,1502,19
Task 1469,Job 0,9,7,3,7,0,12,16,4,3,2,2,1469,1503,11
Task 1469,Job 1,14,8,4,6,0,18,20,2,4,3,2,1469,1503,17
Task 1470,Job 0,8,7,4,9,0,12,17,5,4,4,1,1470,1504,8
Task 1470,Job 1,13,5,3,11,1,16,24,8,3,1,2,1470,1504,9
Task 1471,Job 0,4,5,1,8,0,5,12,7,1,1,2,1471,1505,10
Task 1471,Job 1,9,7,2,11,0,11,20,9,2,4,0,1471,1505,8
Task 1472,Job 0,10,7,4,11,0,14,21,7,4,3,1,1472,1506,6
Task 1472,Job 1,15,10,3,9,0,18,24,6,3,1,1,1472,1506,9
Task 1473,Job 0,2,10,3,7,0,5,9,4,3,2,2,1473,1506,20
Task 1473,Job 1,7,4,2,9,0,9,16,7,2,2,1,1473,1506,20
Task 1474,Job 0,1,6,2,7,0,3,8,5,2,2,0,1474,1508,2
Task 1474,Job 1,6,7,2,8,1,8,14,6,2,3,2,1474,1508,17
Task 1475,Job 0,1,8,2,9,0,3,10,7,2,2,0,1475,1508,3
Task 1475,Job 1,6,8,3,9,0,9,15,6,3,3,0,1475,1508,4
Task 1476,Job 0,4,4,2,10,0,6,14,8,2,4,0,1476,1510,16
Task 1476,Job 1,9,8,2,7,0,11,16,5,2,3,0,1476,1510,2
Task 1477,Job 0,1,7,1,7,1,2,8,6,1,4,1,1477,1510,9
Task 1477,Job 1,6,6,2,8,0,8,14,6,2,2,2,1477,1510,16
Task 1478,Job 0,3,5,4,7,0,7,10,3,4,1,1,1478,1512,9
Task 1478,Job 1,8,5,1,8,1,9,16,7,1,3,2,1478,1512,10
Task 1479,Job 0,1,5,4,6,0,5,7,2,4,3,2,1479,1512,16
Task 1479,Job 1,6,4,4,12,0,10,18,8,4,4,0,1479,1512,17
Task 1480,Job 0,10,6,2,11,0,12,21,9,2,2,0,1480,1513,12
Task 1480,Job 1,15,9,1,6,0,16,21,5,1,2,0,1480,1513,8
Task 1481,Job 0,4,5,2,7,0,6,11,5,2,4,1,1481,1515,13
Task 1481,Job 1,9,6,1,7,0,10,16,6,1,4,0,1481,1515,9
Task 1482,Job 0,6,10,1,12,0,7,18,11,1,3,0,1482,1516,12
Task 1482,Job 1,11,6,3,9,0,14,20,6,3,2,1,1482,1516,2
Task 1483,Job 0,8,5,3,6,1,11,14,3,3,2,1,1483,1517,7
Task 1483,Job 1,13,6,2,9,0,15,22,7,2,2,0,1483,1517,11
Task 1484,Job 0,8,10,4,11,0,12,19,7,4,2,2,1484,1517,20
Task 1484,Job 1,13,10,4,7,1,17,20,3,4,2,0,1484,1517,10
Task 1485,Job 0,5,6,2,11,0,7,16,9,2,1,2,1485,1519,16
Task 1485,Job 1,10,10,3,9,1,13,19,6,3,2,1,1485,1519,8
Task 1486,Job 0,8,4,3,12,0,11,20,9,3,2,0,1486,1520,16
Task 1486,Job 1,13,9,3,7,0,16,20,4,3,4,2,1486,1520,11
Task 1487,Job 0,5,7,2,10,0,7,15,8,2,3,1,1487,1521,9
Task 1487,Job 1,10,7,4,12,0,14,22,8,4,3,2,1487,1521,17
Task 1488,Job 0,10,7,2,11,0,12,21,9,2,1,0,1488,1522,8
Task 1488,Job 1,15,4,1,10,0,16,25,9,1,4,2,1488,1522,19
Task 1489,Job 0,5,7,4,9,0,9,14,5,4,4,2,1489,1522,18
Task 1489,Job 1,10,9,4,9,1,14,19,5,4,1,0,1489,1522,15
Task 1490,Job 0,10,9,2,11,1,12,21,9,2,1,1,1490,1523,6
Task 1490,Job 1,15,10,2,12,1,17,27,10,2,2,0,1490,1523,15
Task 1491,Job 0,1,10,2,10,0,3,11,8,2,2,0,1491,1525,15
Task 1491,Job 1,6,7,2,9,1,8,15,7,2,1,1,1491,1525,15
Task 1492,Job 0,10,10,4,9,0,14,19,5,4,1,2,1492,1526,16
Task 1492,Job 1,15,10,2,9,0,17,24,7,2,3,0,1492,1526,11
Task 1493,Job 0,8,9,3,7,0,11,15,4,3,3,0,1493,1526,16
Task 1493,Job 1,13,8,1,12,0,14,25,11,1,3,1,1493,1526,10
Task 1494,Job 0,7,10,2,12,0,9,19,10,2,4,2,1494,1528,10
Task 1494,Job 1,12,4,4,11,0,16,23,7,4,4,2,1494,1528,20
Task 1495,Job 0,5,5,4,11,0,9,16,7,4,2,0,1495,1529,13
Task 1495,Job 1,10,10,1,6,1,11,16,5,1,2,2,1495,1529,9
Task 1496,Job 0,5,9,2,9,1,7,14,7,2,4,0,1496,1529,13
Task 1496,Job 1,10,4,3,11,0,13,21,8,3,1,2,1496,1529,5
Task 1497,Job 0,4,5,1,12,0,5,16,11,1,1,0,1497,1531,6
Task 1497,Job 1,9,9,2,8,0,11,17,6,2,2,2,1497,1531,10
Task 1498,Job 0,7,10,3,9,0,10,16,6,3,4,1,1498,1531,17
Task 1498,Job 1,12,6,4,11,0,16,23,7,4,2,1,1498,1531,17
Task 1499,Job 0,8,5,2,7,0,10,15,5,2,2,1,1499,1532,11
Task 1499,Job 1,13,8,3,11,1,16,24,8,3,2,2,1499,1532,13
Task 1500,Job 0,5,10,3,9,0,8,14,6,3,4,1,1500,1534,8
Task 1500,Job 1,10,7,4,11,0,14,21,7,4,2,1,1500,1534,12
Task 1501,Job 0,10,7,3,10,0,13,20,7,3,4,0,1501,1534,4
Task 1501,Job 1,15,4,3,7,0,18,22,4,3,1,0,1501,1534,19
Task 1502,Job 0,3,9,2,7,1,5,10,5,2,3,0,1502,1536,7
Task 1502,Job 1,8,4,3,6,0,11,14,3,3,4,2,1502,1536,12
Task 1503,Job 0,4,6,1,9,0,5,13,8,1,2,2,1503,1536,13
Task 1503,Job 1,9,6,2,7,0,11,16,5,2,3,0,1503,1536,20
Task 1504,Job 0,10,8,4,9,0,14,19,5,4,4,2,1504,1538,18
Task 1504,Job 1,15,7,1,9,0,16,24,8,1,3,2,1504,1538,6
Task 1505,Job 0,10,9,1,10,1,11,20,9,1,1,2,1505,1539,13
Task 1505,Job 1,15,10,2,11,0,17,26,9,2,4,1,1505,1539,19
Task 1506,Job 0,6,10,2,11,0,8,17,9,2,3,0,1506,1540,20
Task 1506,Job 1,11,6,1,10,0,12,21,9,1,1,0,1506,1540,15
Task 1507,Job 0,4,4,2,6,0,6,10,4,2,1,0,1507,1541,6
Task 1507,Job 1,9,4,2,10,0,11,19,8,2,3,0,1507,1541,6
Task 1508,Job 0,5,10,2,10,0,7,15,8,2,1,2,1508,1542,16
Task 1508,Job 1,10,7,1,9,0,11,19,8,1,4,0,1508,1542,6
Task 1509,Job 0,7,6,4,7,0,11,14,3,4,2,0,1509,1542,16
Task 1509,Job 1,12,7,1,8,0,13,20,7,1,4,2,1509,1542,16
Task 1510,Job 0,8,10,1,9,0,9,17,8,1,2,2,1510,1544,16
Task 1510,Job 1,13,4,1,11,1,14,24,10,1,3,0,1510,1544,11
Task 1511,Job 0,6,9,1,12,0,7,18,11,1,3,1,1511,1544,18
Task 1511,Job 1,11,6,1,9,0,12,20,8,1,3,1,1511,1544,2
Task 1512,Job 0,10,5,4,10,1,14,20,6,4,1,0,1512,1546,4
Task 1512,Job 1,15,4,4,6,0,19,21,2,4,2,0,1512,1546,18
Task 1513,Job 0,8,6,1,11,0,9,19,10,1,4,0,1513,1547,9
Task 1513,Job 1,13,5,3,9,0,16,22,6,3,4,1,1513,1547,5
Task 1514,Job 0,1,10,2,9,1,3,10,7,2,2,1,1514,1548,6
Task 1514,Job 1,6,5,4,12,0,10,18,8,4,3,0,1514,1548,14
Task 1515,Job 0,8,8,2,8,0,10,16,6,2,2,1,1515,1548,9
Task 1515,Job 1,13,7,4,12,0,17,25,8,4,2,2,1515,1548,12
Task 1516,Job 0,6,4,3,10,1,9,16,7,3,1,0,1516,1549,9
Task 1516,Job 1,11,9,4,10,1,15,21,6,4,4,1,1516,1549,12
Task 1517,Job 0,7,8,2,10,1,9,17,8,2,2,1,1517,1550,13
Task 1517,Job 1,12,6,4,6,0,16,18,2,4,4,1,1517,1550,19
Task 1518,Job 0,5,4,1,6,0,6,11,5,1,4,1,1518,1551,7
Task 1518,Job 1,10,4,3,10,0,13,20,7,3,4,1,1518,1551,11
Task 1519,Job 0,7,4,2,10,1,9,17,8,2,2,2,1519,1552,13
Task 1519,Job 1,12,9,2,6,0,14,18,4,2,3,0,1519,1552,2
Task 1520,Job 0,9,7,3,9,0,12,18,6,3,4,0,1520,1553,2
Task 1520,Job 1,14,7,1,10,0,15,24,9,1,2,2,1520,1553,11
Task 1521,Job 0,10,7,2,10,0,12,20,8,2,2,0,1521,1555,9
Task 1521,Job 1,15,5,4,10,0,19,25,6,4,2,1,1521,1555,4
Task 1522,Job 0,4,10,3,10,0,7,14,7,3,2,0,1522,1555,8
Task 1522,Job 1,9,10,1,12,1,10,21,11,1,4,2,1522,1555,16
Task 1523,Job 0,3,8,3,8,0,6,11,5,3,1,2,1523,1556,11
Task 1523,Job 1,8,8,3,10,1,11,18,7,3,4,2,1523,1556,19
Task 1524,Job 0,9,6,1,8,0,10,17,7,1,4,1,1524,1558,20
Task 1524,Job 1,14,7,2,9,0,16,23,7,2,3,2,1524,1558,14
Task 1525,Job 0,6,7,4,12,1,10,18,8,4,4,2,1525,1559,14
Task 1525,Job 1,11,8,1,12,0,12,23,11,1,1,1,1525,1559,10
Task 1526,Job 0,6,10,4,6,0,10,12,2,4,3,1,1526,1560,13
Task 1526,Job 1,11,7,4,10,0,15,21,6,4,3,1,1526,1560,3
Task 1527,Job 0,3,4,2,10,0,5,13,8,2,4,0,1527,1561,14
Task 1527,Job 1,8,9,2,7,0,10,15,5,2,2,2,1527,1561,8
Task 1528,Job 0,10,10,3,6,0,13,16,3,3,2,0,1528,1561,16
Task 1528,Job 1,15,10,2,7,0,17,22,5,2,2,1,1528,1561,5
Task 1529,Job 0,5,6,1,12,0,6,17,11,1,2,0,1529,1563,13
Task 1529,Job 1,10,7,1,6,0,11,16,5,1,2,1,1529,1563,6
Task 1530,Job 0,2,10,2,8,0,4,10,6,2,2,0,1530,1563,2
Task 1530,Job 1,7,5,4,10,1,11,17,6,4,3,2,1530,1563,16
Task 1531,Job 0,4,5,4,6,0,8,10,2,4,2,2,1531,1565,6
Task 1531,Job 1,9,10,2,9,0,11,18,7,2,3,0,1531,1565,2
Task 1532,Job 0,6,7,4,6,1,10,12,2,4,4,1,1532,1565,9
Task 1532,Job 1,11,10,4,10,0,15,21,6,4,1,2,1532,1565,10
Task 1533,Job 0,6,8,2,8,1,8,14,6,2,3,2,1533,1567,19
Task 1533,Job 1,11,5,2,8,0,13,19,6,2,3,2,1533,1567,4
Task 1534,Job 0,4,4,2,10,1,6,14,8,2,2,0,1534,1567,8
Task 1534,Job 1,9,7,2,10,0,11,19,8,2,3,1,1534,1567,11
Task 1535,Job 0,10,9,2,6,0,12,16,4,2,1,0,1535,1569,8
Task 1535,Job 1,15,10,4,9,1,19,24,5,4,3,1,1535,1569,7
Task 1536,Job 0,4,6,2,9,0,6,13,7,2,4,2,1536,1569,20
Task 1536,Job 1,9,8,2,10,0,11,19,8,2,3,1,1536,1569,13
Task 1537,Job 0,4,8,4,12,1,8,16,8,4,3,0,1537,1571,20
Task 1537,Job 1,9,4,4,10,0,13,19,6,4,1,0,1537,1571,14
Task 1538,Job 0,8,9,3,11,0,11,19,8,3,1,2,1538,1572,5
Task 1538,Job 1,13,6,1,12,0,14,25,11,1,4,1,1538,1572,7
Task 1539,Job 0,9,8,1,6,0,10,15,5,1,4,1,1539,1573,10
Task 1539,Job 1,14,6,3,11,0,17,25,8,3,3,0,1539,1573,5
Task 1540,Job 0,2,8,1,10,0,3,12,9,1,3,1,1540,1573,20
Task 1540,Job 1,7,4,2,9,0,9,16,7,2,1,1,1540,1573,11
Task 1541,Job 0,10,10,1,6,1,11,16,5,1,4,1,1541,1574,4
Task 1541,Job 1,15,9,4,12,0,19,27,8,4,2,0,1541,1574,5
Task 1542,Job 0,10,6,4,7,1,14,17,3,4,3,0,1542,1576,19
Task 1542,Job 1,15,6,3,12,0,18,27,9,3,4,1,1542,1576,6
Task 1543,Job 0,9,9,4,9,0,13,18,5,4,4,0,1543,1577,20
Task 1543,Job 1,14,7,4,6,0,18,20,2,4,3,0,1543,1577,20
Task 1544,Job 0,9,5,1,6,0,10,15,5,1,2,0,1544,1577,13
Task 1544,Job 1,14,4,3,12,1,17,26,9,3,1,2,1544,1577,11
Task 1545,Job 0,9,6,2,6,0,11,15,4,2,1,0,1545,1578,18
Task 1545,Job 1,14,10,1,7,0,15,21,6,1,4,2,1545,1578,11
Task 1546,Job 0,4,4,2,7,0,6,11,5,2,3,2,1546,1580,9
Task 1546,Job 1,9,8,3,10,1,12,19,7,3,1,0,1546,1580,14
Task 1547,Job 0,1,9,4,12,1,5,13,8,4,4,2,1547,1581,7
Task 1547,Job 1,6,9,1,8,1,7,14,7,1,2,1,1547,1581,7
Task 1548,Job 0,6,6,1,12,0,7,18,11,1,4,0,1548,1581,8
Task 1548,Job 1,11,6,2,12,0,13,23,10,2,3,0,1548,1581,20
Task 1549,Job 0,2,7,2,11,1,4,13,9,2,3,1,1549,1583,2
Task 1549,Job 1,7,4,2,8,0,9,15,6,2,4,0,1549,1583,17
Task 1550,Job 0,4,5,4,6,0,8,10,2,4,3,0,1550,1584,12
Task 1550,Job 1,9,9,4,11,0,13,20,7,4,2,0,1550,1584,5
Task 1551,Job 0,10,8,2,11,0,12,21,9,2,3,1,1551,1584,9
Task 1551,Job 1,15,5,2,6,0,17,21,4,2,1,2,1551,1584,9
Task 1552,Job 0,9,10,1,9,0,10,18,8,1,3,1,1552,1586,8
Task 1552,Job 1,14,8,2,6,0,16,20,4,2,4,0,1552,1586,7
Task 1553,Job 0,3,4,2,10,0,5,13,8,2,4,1,1553,1586,5
Task 1553,Job 1,8,8,4,11,0,12,19,7,4,2,0,1553,1586,3
Task 1554,Job 0,8,6,2,10,0,10,18,8,2,1,2,1554,1587,18
Task 1554,Job 1,13,9,4,8,0,17,21,4,4,3,1,1554,1587,5
Task 1555,Job 0,4,6,1,7,0,5,11,6,1,3,0,1555,1589,18
Task 1555,Job 1,9,4,3,11,0,12,20,8,3,2,2,1555,1589,20
Task 1556,Job 0,9,10,4,6,0,13,15,2,4,4,1,1556,1589,17
Task 1556,Job 1,14,8,1,7,0,15,21,6,1,4,1,1556,1589,8
Task 1557,Job 0,8,4,1,6,0,9,14,5,1,2,0,1557,1591,17
Task 1557,Job 1,13,5,3,11,0,16,24,8,3,3,0,1557,1591,7
Task 1558,Job 0,10,5,1,11,1,11,21,10,1,4,2,1558,1591,5
Task 1558,Job 1,15,9,4,11,1,19,26,7,4,3,1,1558,1591,9
Task 1559,Job 0,8,7,1,6,0,9,14,5,1,2,0,1559,1592,9
Task 1559,Job 1,13,7,3,12,0,16,25,9,3,2,1,1559,1592,11
Task 1560,Job 0,2,7,2,9,0,4,11,7,2,2,1,1560,1593,8
Task 1560,Job 1,7,8,2,12,1,9,19,10,2,1,1,1560,1593,15
Task 1561,Job 0,7,10,1,6,0,8,13,5,1,3,0,1561,1594,2
Task 1561,Job 1,12,7,1,9,0,13,21,8,1,1,1,1561,1594,16
Task 1562,Job 0,7,4,4,11,0,11,18,7,4,1,1,1562,1595,17
Task 1562,Job 1,12,10,1,10,1,13,22,9,1,3,0,1562,1595,12
Task 1563,Job 0,10,9,1,10,0,11,20,9,1,1,1,1563,1597,13
Task 1563,Job 1,15,7,1,7,1,16,22,6,1,4,1,1563,1597,20
Task 1564,Job 0,3,6,4,10,0,7,13,6,4,4,0,1564,1598,9
Task 1564,Job 1,8,10,4,11,1,12,19,7,4,2,1,1564,1598,3
Task 1565,Job 0,7,4,1,9,0,8,16,8,1,4,0,1565,1598,18
Task 1565,Job 1,12,6,1,6,1,13,18,5,1,2,0,1565,1598,6
Task 1566,Job 0,7,5,3,10,1,10,17,7,3,3,0,1566,1599,16
Task 1566,Job 1,12,7,2,6,0,14,18,4,2,1,2,1566,1599,9
Task 1567,Job 0,4,9,4,7,0,8,11,3,4,4,2,1567,1601,9
Task 1567,Job 1,9,9,3,10,0,12,19,7,3,3,1,1567,1601,20
Task 1568,Job 0,7,6,2,9,0,9,16,7,2,2,1,1568,1601,5
Task 1568,Job 1,12,9,3,11,0,15,23,8,3,1,0,1568,1601,4
Task 1569,Job 0,5,8,1,8,0,6,13,7,1,4,1,1569,1602,6
Task 1569,Job 1,10,5,2,11,0,12,21,9,2,1,0,1569,1602,20
Task 1570,Job 0,7,7,4,6,0,11,13,2,4,2,0,1570,1603,8
Task 1570,Job 1,12,10,3,12,0,15,24,9,3,1,0,1570,1603,7
Task 1571,Job 0,1,8,2,10,0,3,11,8,2,3,2,1571,1605,8
Task 1571,Job 1,6,4,2,7,0,8,13,5,2,4,1,1571,1605,16
Task 1572,Job 0,4,4,1,11,0,5,15,10,1,1,2,1572,1605,18
Task 1572,Job 1,9,5,4,11,1,13,20,7,4,4,2,1572,1605,12
Task 1573,Job 0,8,10,3,6,0,11,14,3,3,3,0,1573,1606,16
Task 1573,Job 1,13,9,2,7,1,15,20,5,2,1,1,1573,1606,3
Task 1574,Job 0,4,7,1,7,0,5,11,6,1,3,2,1574,1608,10
Task 1574,Job 1,9,9,2,6,0,11,15,4,2,1,2,1574,1608,9
Task 1575,Job 0,9,6,3,10,0,12,19,7,3,2,1,1575,1609,17
Task 1575,Job 1,14,7,4,12,1,18,26,8,4,3,1,1575,1609,11
Task 1576,Job 0,4,5,4,12,1,8,16,8,4,3,2,1576,1609,17
Task 1576,Job 1,9,9,2,7,0,11,16,5,2,4,0,1576,1609,2
Task 1577,Job 0,10,10,4,12,1,14,22,8,4,3,1,1577,1610,17
Task 1577,Job 1,15,9,3,9,0,18,24,6,3,2,2,1577,1610,8
Task 1578,Job 0,1,10,4,12,0,5,13,8,4,2,0,1578,1612,4
Task 1578,Job 1,6,8,3,9,0,9,15,6,3,4,1,1578,1612,8
Task 1579,Job 0,3,9,1,7,1,4,10,6,1,4,2,1579,1612,19
Task 1579,Job 1,8,5,3,6,0,11,14,3,3,1,1,1579,1612,2
Task 1580,Job 0,4,7,2,9,0,6,13,7,2,1,0,1580,1613,11
Task 1580,Job 1,9,7,3,6,0,12,15,3,3,1,0,1580,1613,15
Task 1581,Job 0,7,7,3,6,0,10,13,3,3,2,0,1581,1615,20
Task 1581,Job 1,12,4,1,9,0,13,21,8,1,2,1,1581,1615,14
Task 1582,Job 0,5,10,2,7,0,7,12,5,2,1,1,1582,1616,6
Task 1582,Job 1,10,7,3,10,1,13,20,7,3,3,2,1582,1616,6
Task 1583,Job 0,10,4,1,10,0,11,20,9,1,3,1,1583,1616,20
Task 1583,Job 1,15,6,3,11,0,18,26,8,3,4,1,1583,1616,13
Task 1584,Job 0,10,8,1,7,1,11,17,6,1,2,2,1584,1617,18
Task 1584,Job 1,15,7,3,10,1,18,25,7,3,4,0,1584,1617,20
Task 1585,Job 0,7,6,2,8,0,9,15,6,2,2,1,1585,1619,13
Task 1585,Job 1,12,4,3,6,0,15,18,3,3,3,1,1585,1619,5
Task 1586,Job 0,1,4,3,11,0,4,12,8,3,2,2,1586,1620,8
Task 1586,Job 1,6,7,2,7,0,8,13,5,2,2,1,1586,1620,3
Task 1587,Job 0,1,6,3,10,0,4,11,7,3,2,1,1587,1620,12
Task 1587,Job 1,6,6,4,12,1,10,18,8,4,3,2,1587,1620,8
Task 1588,Job 0,2,5,1,7,0,3,9,6,1,1,2,1588,1621,12
Task 1588,Job 1,7,4,2,10,1,9,17,8,2,3,1,1588,1621,8
Task 1589,Job 0,5,10,2,7,0,7,12,5,2,3,2,1589,1623,6
Task 1589,Job 1,10,5,3,9,1,13,19,6,3,1,2,1589,1623,19
Task 1590,Job 0,5,8,4,12,0,9,17,8,4,2,0,1590,1623,13
Task 1590,Job 1,10,8,1,8,1,11,18,7,1,1,2,1590,1623,20
Task 1591,Job 0,6,7,3,9,0,9,15,6,3,1,1,1591,1624,17
Task 1591,Job 1,11,10,2,7,0,13,18,5,2,4,0,1591,1624,6
Task 1592,Job 0,2,6,1,7,0,3,9,6,1,2,0,1592,1625,17
Task 1592,Job 1,7,5,2,12,0,9,19,10,2,3,2,1592,1625,5
Task 1593,Job 0,2,9,2,8,1,4,10,6,2,4,1,1593,1626,15
Task 1593,Job 1,7,4,3,11,0,10,18,8,3,1,2,1593,1626,6
Task 1594,Job 0,7,4,4,11,0,11,18,7,4,4,2,1594,1628,4
Task 1594,Job 1,12,7,2,7,0,14,19,5,2,4,2,1594,1628,18
Task 1595,Job 0,10,5,3,6,0,13,16,3,3,2,2,1595,1628,19
Task 1595,Job 1,15,5,4,6,1,19,21,2,4,1,1,1595,1628,9
Task 1596,Job 0,2,4,4,11,0,6,13,7,4,2,1,1596,1630,5
Task 1596,Job 1,7,8,1,7,0,8,14,6,1,2,0,1596,1630,10
Task 1597,Job 0,4,8,2,6,1,6,10,4,2,4,2,1597,1631,7
Task 1597,Job 1,9,9,1,8,0,10,17,7,1,2,0,1597,1631,8
Task 1598,Job 0,9,10,4,10,0,13,19,6,4,1,0,1598,1631,7
Task 1598,Job 1,14,10,1,10,1,15,24,9,1,2,2,1598,1631,19
Task 1599,Job 0,8,5,1,7,0,9,15,6,1,4,1,1599,1632,20
Task 1599,Job 1,13,4,3,11,0,16,24,8,3,3,1,1599,1632,10
Task 1600,Job 0,1,4,3,7,0,4,8,4,3,4,2,1600,1633,17
Task 1600,Job 1,6,8,1,11,0,7,17,10,1,2,0,1600,1633,13
Task 1601,Job 0,8,5,3,8,1,11,16,5,3,3,0,1601,1634,10
Task 1601,Job 1,13,6,4,8,0,17,21,4,4,4,0,1601,1634,18
Task 1602,Job 0,2,5,3,8,0,5,10,5,3,3,0,1602,1636,19
Task 1602,Job 1,7,6,1,11,0,8,18,10,1,2,2,1602,1636,20
Task 1603,Job 0,9,5,1,11,0,10,20,10,1,3,0,1603,1637,4
Task 1603,Job 1,14,10,2,6,1,16,20,4,2,3,0,1603,1637,20
Task 1604,Job 0,2,6,4,10,0,6,12,6,4,2,1,1604,1637,2
Task 1604,Job 1,7,6,4,10,0,11,17,6,4,1,0,1604,1637,17
Task 1605,Job 0,5,8,2,12,0,7,17,10,2,3,0,1605,1639,10
Task 1605,Job 1,10,5,4,7,1,14,17,3,4,3,1,1605,1639,18
Task 1606,Job 0,8,8,3,7,0,11,15,4,3,4,2,1606,1639,12
Task 1606,Job 1,13,9,1,9,1,14,22,8,1,3,2,1606,1639,13
Task 1607,Job 0,8,9,3,7,1,11,15,4,3,2,0,1607,1640,16
Task 1607,Job 1,13,4,1,6,0,14,19,5,1,3,1,1607,1640,12
Task 1608,Job 0,5,5,3,7,0,8,12,4,3,2,2,1608,1642,15
Task 1608,Job 1,10,5,2,6,1,12,16,4,2,2,0,1608,1642,20
Task 1609,Job 0,1,10,3,9,1,4,10,6,3,2,0,1609,1642,15
Task 1609,Job 1,6,6,3,11,0,9,17,8,3,2,0,1609,1642,12
Task 1610,Job 0,10,10,1,8,1,11,18,7,1,2,2,1610,1643,17
Task 1610,Job 1,15,10,2,7,0,17,22,5,2,1,0,1610,1643,18
Task 1611,Job 0,3,6,4,6,0,7,9,2,4,1,1,1611,1644,11
Task 1611,Job 1,8,9,3,11,0,11,19,8,3,3,0,1611,1644,11
Task 1612,Job 0,6,6,3,11,1,9,17,8,3,3,2,1612,1646,19
Task 1612,Job 1,11,8,1,6,0,12,17,5,1,3,2,1612,1646,4
Task 1613,Job 0,4,6,1,6,0,5,10,5,1,3,2,1613,1647,20
Task 1613,Job 1,9,4,2,12,0,11,21,10,2,2,2,1613,1647,9
Task 1614,Job 0,6,10,2,12,0,8,18,10,2,1,0,1614,1648,16
Task 1614,Job 1,11,7,3,10,0,14,21,7,3,1,1,1614,1648,4
Task 1615,Job 0,5,6,2,6,0,7,11,4,2,1,0,1615,1648,12
Task 1615,Job 1,10,10,2,6,0,12,16,4,2,3,2,1615,1648,11
Task 1616,Job 0,1,9,3,8,0,4,9,5,3,3,1,1616,1649,17
Task 1616,Job 1,6,6,3,12,1,9,18,9,3,1,0,1616,1649,5
Task 1617,Job 0,8,10,4,9,0,12,17,5,4,1,2,1617,1650,3
Task 1617,Job 1,13,4,4,10,0,17,23,6,4,2,0,1617,1650,11
Task 1618,Job 0,1,6,1,7,1,2,8,6,1,2,0,1618,1652,3
Task 1618,Job 1,6,10,1,12,0,7,18,11,1,1,0,1618,1652,20
Task 1619,Job 0,6,7,3,11,0,9,17,8,3,4,0,1619,1653,19
Task 1619,Job 1,11,4,2,7,0,13,18,5,2,1,0,1619,1653,15
Task 1620,Job 0,6,9,3,6,0,9,12,3,3,2,1,1620,1653,14
Task 1620,Job 1,11,4,1,9,1,12,20,8,1,1,0,1620,1653,7
Task 1621,Job 0,1,6,3,8,0,4,9,5,3,2,2,1621,1655,6
Task 1621,Job 1,6,6,2,10,0,8,16,8,2,4,2,1621,1655,19
Task 1622,Job 0,7,9,3,11,0,10,18,8,3,3,0,1622,1656,20
Task 1622,Job 1,12,7,1,8,0,13,20,7,1,2,1,1622,1656,16
Task 1623,Job 0,5,5,1,6,1,6,11,5,1,3,2,1623,1656,6
Task 1623,Job 1,10,9,4,10,0,14,20,6,4,3,0,1623,1656,17
Task 1624,Job 0,6,4,4,11,1,10,17,7,4,4,1,1624,1658,14
Task 1624,Job 1,11,5,4,10,0,15,21,6,4,2,2,1624,1658,12
Task 1625,Job 0,10,6,3,10,0,13,20,7,3,1,1,1625,1658,5
Task 1625,Job 1,15,4,4,12,1,19,27,8,4,2,0,1625,1658,5
Task 1626,Job 0,3,7,3,6,0,6,9,3,3,2,2,1626,1660,18
Task 1626,Job 1,8,9,2,11,1,10,19,9,2,3,2,1626,1660,2
Task 1627,Job 0,8,8,4,10,0,12,18,6,4,4,1,1627,1661,9
Task 1627,Job 1,13,5,1,12,0,14,25,11,1,1,2,1627,1661,3
Task 1628,Job 0,10,6,4,11,0,14,21,7,4,4,2,1628,1661,15
Task 1628,Job 1,15,7,3,7,0,18,22,4,3,2,2,1628,1661,11
Task 1629,Job 0,9,6,2,10,0,11,19,8,2,4,1,1629,1663,16
Task 1629,Job 1,14,9,3,6,0,17,20,3,3,3,0,1629,1663,5
Task 1630,Job 0,4,9,2,9,0,6,13,7,2,2,0,1630,1663,11
Task 1630,Job 1,9,7,4,12,0,13,21,8,4,3,2,1630,1663,17
Task 1631,Job 0,4,8,4,12,1,8,16,8,4,4,1,1631,1665,17
Task 1631,Job 1,9,5,1,12,1,10,21,11,1,2,0,1631,1665,14
Task 1632,Job 0,3,4,3,11,0,6,14,8,3,3,1,1632,1665,3
Task 1632,Job 1,8,6,1,10,0,9,18,9,1,4,0,1632,1665,18
Task 1633,Job 0,4,4,1,6,0,5,10,5,1,4,2,1633,1666,13
Task 1633,Job 1,9,9,2,12,1,11,21,10,2,1,2,1633,1666,17
Task 1634,Job 0,4,7,1,7,0,5,11,6,1,4,2,1634,1667,3
Task 1634,Job 1,9,5,3,8,0,12,17,5,3,4,0,1634,1667,13
Task 1635,Job 0,5,6,4,8,1,9,13,4,4,2,0,1635,1669,4
Task 1635,Job 1,10,10,1,6,0,11,16,5,1,2,2,1635,1669,6
Task 1636,Job 0,1,10,3,7,1,4,8,4,3,1,1,1636,1670,9
Task 1636,Job 1,6,10,1,9,0,7,15,8,1,2,1,1636,1670,17
Task 1637,Job 0,9,10,3,11,0,12,20,8,3,3,1,1637,1670,7
Task 1637,Job 1,14,9,3,9,0,17,23,6,3,1,0,1637,1670,14
Task 1638,Job 0,4,5,4,6,0,8,10,2,4,2,2,1638,1672,11
Task 1638,Job 1,9,6,3,6,0,12,15,3,3,3,2,1638,1672,19
Task 1639,Job 0,3,6,3,7,0,6,10,4,3,3,2,1639,1673,9
Task 1639,Job 1,8,6,4,6,0,12,14,2,4,1,1,1639,1673,3
Task 1640,Job 0,6,5,3,11,0,9,17,8,3,1,0,1640,1673,9
Task 1640,Job 1,11,10,4,8,1,15,19,4,4,2,0,1640,1673,19
Task 1641,Job 0,5,9,4,9,0,9,14,5,4,3,0,1641,1675,4
Task 1641,Job 1,10,6,2,6,0,12,16,4,2,3,0,1641,1675,2
Task 1642,Job 0,4,4,3,12,0,7,16,9,3,1,1,1642,1675,6
Task 1642,Job 1,9,8,4,9,0,13,18,5,4,3,0,1642,1675,9
Task 1643,Job 0,9,9,2,8,1,11,17,6,2,1,2,1643,1677,9
Task 1643,Job 1,14,10,2,10,0,16,24,8,2,4,0,1643,1677,17
Task 1644,Job 0,2,7,3,10,0,5,12,7,3,3,2,1644,1678,17
Task 1644,Job 1,7,7,4,9,1,11,16,5,4,1,1,1644,1678,14
Task 1645,Job 0,7,8,4,11,1,11,18,7,4,1,0,1645,1678,7
Task 1645,Job 1,12,8,1,8,0,13,20,7,1,2,2,1645,1678,10
Task 1646,Job 0,9,5,2,11,1,11,20,9,2,2,0,1646,1680,17
Task 1646,Job 1,14,9,4,12,1,18,26,8,4,3,2,1646,1680,15
Task 1647,Job 0,3,4,2,10,0,5,13,8,2,4,1,1647,1680,3
Task 1647,Job 1,8,10,1,11,0,9,19,10,1,1,0,1647,1680,11
Task 1648,Job 0,7,4,1,6,0,8,13,5,1,3,0,1648,1681,19
Task 1648,Job 1,12,4,3,11,0,15,23,8,3,4,1,1648,1681,20
Task 1649,Job 0,4,4,4,10,0,8,14,6,4,1,0,1649,1683,20
Task 1649,Job 1,9,5,1,7,1,10,16,6,1,4,1,1649,1683,8
Task 1650,Job 0,6,10,4,8,0,10,14,4,4,1,2,1650,1683,10
Task 1650,Job 1,11,10,3,6,1,14,17,3,3,1,0,1650,1683,9
Task 1651,Job 0,3,6,3,8,0,6,11,5,3,2,1,1651,1685,3
Task 1651,Job 1,8,7,3,11,0,11,19,8,3,3,1,1651,1685,20
Task 1652,Job 0,6,7,3,12,0,9,18,9,3,3,0,1652,1686,8
Task 1652,Job 1,11,6,4,11,0,15,22,7,4,4,2,1652,1686,18
Task 1653,Job 0,2,7,3,8,0,5,10,5,3,2,2,1653,1686,5
Task 1653,Job 1,7,8,2,12,0,9,19,10,2,2,0,1653,1686,19
Task 1654,Job 0,10,6,2,6,0,12,16,4,2,3,0,1654,1688,4
Task 1654,Job 1,15,10,1,12,1,16,27,11,1,2,1,1654,1688,19
Task 1655,Job 0,6,7,1,7,1,7,13,6,1,3,1,1655,1689,14
Task 1655,Job 1,11,7,1,7,1,12,18,6,1,2,1,1655,1689,14
Task 1656,Job 0,3,9,3,12,1,6,15,9,3,1,2,1656,1690,20
Task 1656,Job 1,8,9,2,6,0,10,14,4,2,1,0,1656,1690,11
Task 1657,Job 0,1,7,3,9,0,4,10,6,3,3,0,1657,1690,19
Task 1657,Job 1,6,10,4,11,0,10,17,7,4,4,1,1657,1690,17
Task 1658,Job 0,9,4,3,6,1,12,15,3,3,4,2,1658,1691,15
Task 1658,Job 1,14,9,1,6,0,15,20,5,1,1,1,1658,1691,9
Task 1659,Job 0,3,9,2,8,0,5,11,6,2,4,1,1659,1692,3
Task 1659,Job 1,8,5,2,12,0,10,20,10,2,2,1,1659,1692,15
Task 1660,Job 0,9,8,4,6,1,13,15,2,4,4,0,1660,1693,12
Task 1660,Job 1,14,4,4,11,0,18,25,7,4,2,1,1660,1693,5
Task 1661,Job 0,3,5,2,11,0,5,14,9,2,4,2,1661,1695,8
Task 1661,Job 1,8,8,1,10,0,9,18,9,1,2,0,1661,1695,16
Task 1662,Job 0,8,5,4,8,0,12,16,4,4,3,1,1662,1695,11
Task 1662,Job 1,13,6,3,8,0,16,21,5,3,3,0,1662,1695,8
Task 1663,Job 0,5,6,4,9,0,9,14,5,4,3,0,1663,1696,19
Task 1663,Job 1,10,6,3,9,0,13,19,6,3,4,2,1663,1696,18
Task 1664,Job 0,9,6,3,12,0,12,21,9,3,1,2,1664,1698,10
Task 1664,Job 1,14,4,3,6,1,17,20,3,3,3,2,1664,1698,13
Task 1665,Job 0,4,7,1,10,0,5,14,9,1,4,1,1665,1699,9
Task 1665,Job 1,9,5,2,8,0,11,17,6,2,4,0,1665,1699,8
Task 1666,Job 0,5,5,2,12,1,7,17,10,2,2,2,1666,1699,14
Task 1666,Job 1,10,6,4,7,0,14,17,3,4,2,1,1666,1699,11
Task 1667,Job 0,10,5,1,10,1,11,20,9,1,3,0,1667,1701,14
Task 1667,Job 1,15,9,3,9,0,18,24,6,3,3,2,1667,1701,20
Task 1668,Job 0,8,10,2,10,0,10,18,8,2,4,1,1668,1702,20
Task 1668,Job 1,13,8,4,9,1,17,22,5,4,1,2,1668,1702,11
Task 1669,Job 0,2,9,4,8,0,6,10,4,4,1,2,1669,1702,2
Task 1669,Job 1,7,10,1,9,0,8,16,8,1,2,0,1669,1702,6
Task 1670,Job 0,10,10,1,11,0,11,21,10,1,2,2,1670,1703,16
Task 1670,Job 1,15,5,3,6,0,18,21,3,3,1,1,1670,1703,10
Task 1671,Job 0,8,10,1,7,0,9,15,6,1,4,1,1671,1704,19
Task 1671,Job 1,13,8,1,9,0,14,22,8,1,1,2,1671,1704,7
Task 1672,Job 0,7,7,4,8,0,11,15,4,4,1,0,1672,1705,13
Task 1672,Job 1,12,7,2,6,0,14,18,4,2,4,2,1672,1705,5
Task 1673,Job 0,5,10,3,12,0,8,17,9,3,3,0,1673,1707,14
Task 1673,Job 1,10,8,4,10,0,14,20,6,4,2,2,1673,1707,20
Task 1674,Job 0,1,9,4,9,0,5,10,5,4,3,2,1674,1708,5
Task 1674,Job 1,6,4,2,11,0,8,17,9,2,4,1,1674,1708,11
Task 1675,Job 0,5,8,2,8,0,7,13,6,2,4,1,1675,1708,5
Task 1675,Job 1,10,6,3,12,0,13,22,9,3,1,2,1675,1708,2
Task 1676,Job 0,8,4,3,9,0,11,17,6,3,3,1,1676,1710,10
Task 1676,Job 1,13,9,4,6,0,17,19,2,4,2,0,1676,1710,12
Task 1677,Job 0,7,9,4,10,0,11,17,6,4,4,1,1677,1710,8
Task 1677,Job 1,12,8,4,6,0,16,18,2,4,2,0,1677,1710,20
Task 1678,Job 0,4,9,3,12,1,7,16,9,3,2,2,1678,1712,13
Task 1678,Job 1,9,6,4,7,0,13,16,3,4,4,1,1678,1712,12
Task 1679,Job 0,10,7,2,8,0,12,18,6,2,4,1,1679,1712,8
Task 1679,Job 1,15,10,2,9,0,17,24,7,2,2,2,1679,1712,14
Task 1680,Job 0,6,9,4,12,0,10,18,8,4,1,2,1680,1714,10
Task 1680,Job 1,11,10,2,8,0,13,19,6,2,1,1,1680,1714,19
Task 1681,Job 0,1,6,2,9,0,3,10,7,2,2,2,1681,1715,20
Task 1681,Job 1,6,10,2,8,0,8,14,6,2,1,1,1681,1715,3
Task 1682,Job 0,7,6,1,11,1,8,18,10,1,1,2,1682,1716,13
Task 1682,Job 1,12,9,2,11,0,14,23,9,2,2,0,1682,1716,8
Task 1683,Job 0,9,5,1,9,1,10,18,8,1,3,1,1683,1717,12
Task 1683,Job 1,14,9,1,7,0,15,21,6,1,1,0,1683,1717,18
Task 1684,Job 0,5,10,2,12,0,7,17,10,2,4,0,1684,1717,4
Task 1684,Job 1,10,6,2,9,0,12,19,7,2,2,1,1684,1717,6
Task 1685,Job 0,7,7,2,6,0,9,13,4,2,3,2,1685,1719,13
Task 1685,Job 1,12,7,4,8,0,16,20,4,4,3,1,1685,1719,4
Task 1686,Job 0,3,5,4,10,1,7,13,6,4,2,1,1686,1719,16
Task 1686,Job 1,8,6,2,8,0,10,16,6,2,1,1,1686,1719,7
Task 1687,Job 0,1,8,2,12,0,3,13,10,2,2,0,1687,1721,2
Task 1687,Job 1,6,9,3,11,1,9,17,8,3,4,0,1687,1721,5
Task 1688,Job 0,2,5,1,8,0,3,10,7,1,3,1,1688,1721,3
Task 1688,Job 1,7,8,2,6,0,9,13,4,2,4,2,1688,1721,2
Task 1689,Job 0,10,5,3,9,1,13,19,6,3,3,1,1689,1722,14
Task 1689,Job 1,15,8,3,6,0,18,21,3,3,4,1,1689,1722,6
Task 1690,Job 0,1,7,1,12,0,2,13,11,1,4,1,1690,1723,18
Task 1690,Job 1,6,6,1,12,1,7,18,11,1,1,1,1690,1723,6
Task 1691,Job 0,8,5,3,12,0,11,20,9,3,1,0,1691,1724,13
Task 1691,Job 1,13,9,1,8,0,14,21,7,1,1,1,1691,1724,11
Task 1692,Job 0,5,5,2,10,0,7,15,8,2,2,1,1692,1725,11
Task 1692,Job 1,10,8,3,10,0,13,20,7,3,3,1,1692,1725,4
Task 1693,Job 0,10,7,4,12,1,14,22,8,4,3,2,1693,1727,9
Task 1693,Job 1,15,7,2,8,0,17,23,6,2,1,0,1693,1727,19
Task 1694,Job 0,10,4,4,11,0,14,21,7,4,4,2,1694,1728,11
Task 1694,Job 1,15,4,1,9,0,16,24,8,1,2,1,1694,1728,11
Task 1695,Job 0,5,7,4,7,1,9,12,3,4,2,0,1695,1728,9
Task 1695,Job 1,10,9,1,8,1,11,18,7,1,2,2,1695,1728,13
Task 1696,Job 0,3,10,1,10,1,4,13,9,1,3,1,1696,1730,6
Task 1696,Job 1,8,8,1,6,0,9,14,5,1,3,2,1696,1730,12
Task 1697,Job 0,3,5,3,8,0,6,11,5,3,3,1,1697,1731,13
Task 1697,Job 1,8,10,4,7,1,12,15,3,4,4,0,1697,1731,5
Task 1698,Job 0,7,8,1,8,0,8,15,7,1,1,1,1698,1731,2
Task 1698,Job 1,12,10,3,10,1,15,22,7,3,4,0,1698,1731,11
Task 1699,Job 0,3,4,4,12,0,7,15,8,4,3,0,1699,1733,5
Task 1699,Job 1,8,9,4,11,0,12,19,7,4,1,0,1699,1733,5
Task 1700,Job 0,3,4,1,12,0,4,15,11,1,2,2,1700,1733,2
Task 1700,Job 1,8,5,2,9,0,10,17,7,2,3,1,1700,1733,13
Task 1701,Job 0,6,5,2,7,0,8,13,5,2,1,0,1701,1734,3
Task 1701,Job 1,11,6,4,12,1,15,23,8,4,4,2,1701,1734,3
Task 1702,Job 0,10,7,1,9,0,11,19,8,1,3,2,1702,1736,7
Task 1702,Job 1,15,6,2,11,0,17,26,9,2,2,0,1702,1736,20
Task 1703,Job 0,9,10,1,10,1,10,19,9,1,4,0,1703,1737,20
Task 1703,Job 1,14,10,2,6,0,16,20,4,2,3,1,1703,1737,2
Task 1704,Job 0,3,8,3,7,0,6,10,4,3,4,0,1704,1738,17
Task 1704,Job 1,8,4,1,12,0,9,20,11,1,3,0,1704,1738,4
Task 1705,Job 0,9,5,1,8,0,10,17,7,1,4,0,1705,1739,16
Task 1705,Job 1,14,7,3,8,0,17,22,5,3,3,0,1705,1739,17
Task 1706,Job 0,7,5,4,7,0,11,14,3,4,4,0,1706,1739,5
Task 1706,Job 1,12,6,4,7,0,16,19,3,4,1,0,1706,1739,16
Task 1707,Job 0,9,10,4,9,0,13,18,5,4,2,0,1707,1741,19
Task 1707,Job 1,14,4,4,11,0,18,25,7,4,3,1,1707,1741,9
Task 1708,Job 0,5,10,3,7,1,8,12,4,3,3,1,1708,1742,13
Task 1708,Job 1,10,8,4,8,1,14,18,4,4,1,1,1708,1742,17
Task 1709,Job 0,2,4,4,6,0,6,8,2,4,2,2,1709,1742,4
Task 1709,Job 1,7,6,1,6,1,8,13,5,1,4,0,1709,1742,12
Task 1710,Job 0,1,10,1,9,0,2,10,8,1,4,2,1710,1743,13
Task 1710,Job 1,6,10,4,7,0,10,13,3,4,1,0,1710,1743,20
Task 1711,Job 0,7,9,3,8,0,10,15,5,3,2,1,1711,1745,9
Task 1711,Job 1,12,7,2,6,0,14,18,4,2,2,1,1711,1745,10
Task 1712,Job 0,2,8,3,8,0,5,10,5,3,2,2,1712,1746,16
Task 1712,Job 1,7,10,2,9,0,9,16,7,2,4,0,1712,1746,12
Task 1713,Job 0,8,9,3,12,0,11,20,9,3,3,1,1713,1747,9
Task 1713,Job 1,13,5,2,11,0,15,24,9,2,3,1,1713,1747,20
Task 1714,Job 0,9,9,3,10,0,12,19,7,3,1,0,1714,1747,10
Task 1714,Job 1,14,7,1,8,0,15,22,7,1,3,1,1714,1747,5
Task 1715,Job 0,5,9,4,6,0,9,11,2,4,4,0,1715,1749,5
Task 1715,Job 1,10,10,1,10,0,11,20,9,1,1,1,1715,1749,17
Task 1716,Job 0,4,7,1,12,0,5,16,11,1,4,1,1716,1750,17
Task 1716,Job 1,9,10,2,11,0,11,20,9,2,2,1,1716,1750,20
Task 1717,Job 0,9,8,2,9,0,11,18,7,2,2,0,1717,1750,6
Task 1717,Job 1,14,9,1,7,0,15,21,6,1,3,2,1717,1750,16
Task 1718,Job 0,4,6,3,11,0,7,15,8,3,2,2,1718,1751,12
Task 1718,Job 1,9,4,3,11,0,12,20,8,3,3,2,1718,1751,10
Task 1719,Job 0,2,10,3,7,1,5,9,4,3,2,2,1719,1753,5
Task 1719,Job 1,7,9,3,12,0,10,19,9,3,1,1,1719,1753,3
Task 1720,Job 0,5,9,1,10,0,6,15,9,1,1,1,1720,1754,8
Task 1720,Job 1,10,9,2,6,1,12,16,4,2,2,1,1720,1754,12
Task 1721,Job 0,5,4,4,11,1,9,16,7,4,2,1,1721,1754,12
Task 1721,Job 1,10,9,1,6,0,11,16,5,1,2,0,1721,1754,20
Task 1722,Job 0,2,5,3,8,1,5,10,5,3,4,0,1722,1756,6
Task 1722,Job 1,7,5,3,11,0,10,18,8,3,3,0,1722,1756,5
Task 1723,Job 0,4,5,2,10,0,6,14,8,2,1,0,1723,1757,19
Task 1723,Job 1,9,4,2,9,1,11,18,7,2,2,0,1723,1757,15
Task 1724,Job 0,8,5,2,11,0,10,19,9,2,1,1,1724,1758,10
Task 1724,Job 1,13,8,2,7,1,15,20,5,2,4,0,1724,1758,18
Task 1725,Job 0,7,6,2,10,0,9,17,8,2,1,1,1725,1759,13
Task 1725,Job 1,12,8,3,8,0,15,20,5,3,1,2,1725,1759,12
Task 1726,Job 0,10,4,1,12,0,11,22,11,1,1,2,1726,1759,19
Task 1726,Job 1,15,5,4,8,0,19,23,4,4,1,1,1726,1759,13
Task 1727,Job 0,7,5,2,6,0,9,13,4,2,2,0,1727,1760,7
Task 1727,Job 1,12,4,1,12,0,13,24,11,1,4,1,1727,1760,11
Task 1728,Job 0,1,10,4,12,0,5,13,8,4,2,0,1728,1762,20
Task 1728,Job 1,6,4,4,11,1,10,17,7,4,4,2,1728,1762,6
Task 1729,Job 0,6,7,3,7,0,9,13,4,3,2,1,1729,1762,4
Task 1729,Job 1,11,7,3,10,1,14,21,7,3,2,2,1729,1762,11
Task 1730,Job 0,9,6,2,12,0,11,21,10,2,2,1,1730,1764,2
Task 1730,Job 1,14,4,1,9,0,15,23,8,1,2,2,1730,1764,11
Task 1731,Job 0,4,8,3,11,0,7,15,8,3,2,2,1731,1765,11
Task 1731,Job 1,9,8,2,11,1,11,20,9,2,1,1,1731,1765,2
Task 1732,Job 0,3,8,2,7,0,5,10,5,2,1,1,1732,1765,5
Task 1732,Job 1,8,7,1,10,0,9,18,9,1,2,2,1732,1765,9
Task 1733,Job 0,7,10,1,6,0,8,13,5,1,2,2,1733,1766,2
Task 1733,Job 1,12,9,3,9,0,15,21,6,3,1,1,1733,1766,10
Task 1734,Job 0,8,9,1,8,0,9,16,7,1,2,1,1734,1768,18
Task 1734,Job 1,13,9,1,6,0,14,19,5,1,2,0,1734,1768,13
Task 1735,Job 0,7,4,4,8,1,11,15,4,4,4,0,1735,1768,13
Task 1735,Job 1,12,10,3,12,0,15,24,9,3,2,0,1735,1768,15
Task 1736,Job 0,4,4,3,6,0,7,10,3,3,1,1,1736,1770,15
Task 1736,Job 1,9,8,3,6,0,12,15,3,3,3,0,1736,1770,9
Task 1737,Job 0,9,10,1,12,0,10,21,11,1,4,1,1737,1770,6
Task 1737,Job 1,14,9,1,9,0,15,23,8,1,2,0,1737,1770,3
Task 1738,Job 0,4,9,4,12,0,8,16,8,4,4,1,1738,1771,3
Task 1738,Job 1,9,8,4,12,0,13,21,8,4,4,0,1738,1771,9
Task 1739,Job 0,1,5,1,12,0,2,13,11,1,2,1,1739,1772,2
Task 1739,Job 1,6,8,3,12,0,9,18,9,3,2,0,1739,1772,2
Task 1740,Job 0,5,5,4,9,0,9,14,5,4,1,1,1740,1773,10
Task 1740,Job 1,10,5,4,11,1,14,21,7,4,1,2,1740,1773,2
Task 1741,Job 0,4,9,1,10,0,5,14,9,1,4,2,1741,1775,4
Task 1741,Job 1,9,8,1,9,0,10,18,8,1,1,0,1741,1775,5
Task 1742,Job 0,7,6,4,12,0,11,19,8,4,1,1,1742,1776,6
Task 1742,Job 1,12,8,1,8,0,13,20,7,1,4,0,1742,1776,16
Task 1743,Job 0,9,7,2,12,0,11,21,10,2,4,2,1743,1776,15
Task 1743,Job 1,14,7,4,7,0,18,21,3,4,1,0,1743,1776,7
Task 1744,Job 0,4,10,1,9,1,5,13,8,1,1,1,1744,1778,10
Task 1744,Job 1,9,10,3,9,0,12,18,6,3,4,2,1744,1778,11
Task 1745,Job 0,4,4,3,10,0,7,14,7,3,3,1,1745,1779,18
Task 1745,Job 1,9,6,3,12,0,12,21,9,3,4,1,1745,1779,5
Task 1746,Job 0,6,6,1,11,1,7,17,10,1,2,1,1746,1779,15
Task 1746,Job 1,11,6,1,10,0,12,21,9,1,1,0,1746,1779,12
Task 1747,Job 0,5,9,2,11,0,7,16,9,2,1,2,1747,1781,20
Task 1747,Job 1,10,10,1,8,0,11,18,7,1,4,1,1747,1781,10
Task 1748,Job 0,3,9,2,7,0,5,10,5,2,3,0,1748,1782,20
Task 1748,Job 1,8,9,4,8,1,12,16,4,4,1,1,1748,1782,20
Task 1749,Job 0,8,4,3,7,0,11,15,4,3,1,1,1749,1783,4
Task 1749,Job 1,13,7,2,10,0,15,23,8,2,4,1,1749,1783,8
Task 1750,Job 0,9,10,4,10,0,13,19,6,4,4,0,1750,1784,19
Task 1750,Job 1,14,4,1,7,0,15,21,6,1,2,2,1750,1784,19
Task 1751,Job 0,10,9,4,7,0,14,17,3,4,3,1,1751,1785,12
Task 1751,Job 1,15,8,2,10,1,17,25,8,2,2,0,1751,1785,4
Task 1752,Job 0,6,10,2,12,0,8,18,10,2,4,2,1752,1786,7
Task 1752,Job 1,11,4,4,8,0,15,19,4,4,1,0,1752,1786,5
Task 1753,Job 0,4,8,4,10,0,8,14,6,4,2,1,1753,1787,7
Task 1753,Job 1,9,6,4,9,0,13,18,5,4,4,1,1753,1787,16
Task 1754,Job 0,8,7,3,9,0,11,17,6,3,2,0,1754,1787,18
Task 1754,Job 1,13,6,3,9,0,16,22,6,3,2,2,1754,1787,17
Task 1755,Job 0,7,4,3,12,0,10,19,9,3,1,1,1755,1789,6
Task 1755,Job 1,12,5,1,9,0,13,21,8,1,3,0,1755,1789,17
Task 1756,Job 0,1,9,1,11,0,2,12,10,1,3,1,1756,1790,2
Task 1756,Job 1,6,8,1,6,0,7,12,5,1,3,2,1756,1790,6
Task 1757,Job 0,2,7,4,9,0,6,11,5,4,4,1,1757,1791,12
Task 1757,Job 1,7,10,3,7,0,10,14,4,3,2,1,1757,1791,13
Task 1758,Job 0,1,4,3,9,0,4,10,6,3,2,2,1758,1792,15
Task 1758,Job 1,6,4,3,6,0,9,12,3,3,3,1,1758,1792,14
Task 1759,Job 0,2,5,2,10,0,4,12,8,2,4,2,1759,1793,6
Task 1759,Job 1,7,8,4,11,0,11,18,7,4,1,0,1759,1793,17
Task 1760,Job 0,8,7,4,9,0,12,17,5,4,1,0,1760,1794,5
Task 1760,Job 1,13,8,2,8,0,15,21,6,2,2,2,1760,1794,13
Task 1761,Job 0,2,7,1,8,0,3,10,7,1,1,1,1761,1794,19
Task 1761,Job 1,7,9,4,12,1,11,19,8,4,1,1,1761,1794,2
Task 1762,Job 0,5,6,2,10,0,7,15,8,2,3,0,1762,1795,20
Task 1762,Job 1,10,6,1,7,0,11,17,6,1,2,1,1762,1795,6
Task 1763,Job 0,4,4,2,9,0,6,13,7,2,2,1,1763,1797,13
Task 1763,Job 1,9,7,2,12,0,11,21,10,2,2,2,1763,1797,7
Task 1764,Job 0,3,9,3,6,0,6,9,3,3,3,0,1764,1797,11
Task 1764,Job 1,8,8,4,9,0,12,17,5,4,3,0,1764,1797,15
Task 1765,Job 0,5,8,3,10,0,8,15,7,3,3,2,1765,1799,7
Task 1765,Job 1,10,4,4,11,0,14,21,7,4,1,1,1765,1799,3
Task 1766,Job 0,9,5,2,6,0,11,15,4,2,3,0,1766,1799,12
Task 1766,Job 1,14,6,4,8,1,18,22,4,4,2,2,1766,1799,3
Task 1767,Job 0,8,4,3,12,0,11,20,9,3,1,1,1767,1800,5
Task 1767,Job 1,13,8,1,9,0,14,22,8,1,4,1,1767,1800,15
Task 1768,Job 0,3,6,3,7,0,6,10,4,3,3,2,1768,1802,19
Task 1768,Job 1,8,6,4,6,0,12,14,2,4,4,2,1768,1802,11
Task 1769,Job 0,5,4,2,6,1,7,11,4,2,3,1,1769,1803,9
Task 1769,Job 1,10,10,3,7,0,13,17,4,3,2,1,1769,1803,5
Task 1770,Job 0,9,5,1,12,0,10,21,11,1,3,1,1770,1803,6
Task 1770,Job 1,14,10,3,12,0,17,26,9,3,3,1,1770,1803,9
Task 1771,Job 0,10,6,2,9,0,12,19,7,2,3,0,1771,1804,6
Task 1771,Job 1,15,5,4,10,0,19,25,6,4,4,2,1771,1804,15
Task 1772,Job 0,9,4,1,7,0,10,16,6,1,1,2,1772,1805,5
Task 1772,Job 1,14,5,4,11,0,18,25,7,4,3,1,1772,1805,15
Task 1773,Job 0,3,5,2,7,0,5,10,5,2,1,1,1773,1807,11
Task 1773,Job 1,8,6,3,12,1,11,20,9,3,3,1,1773,1807,3
Task 1774,Job 0,3,8,4,10,1,7,13,6,4,4,0,1774,1807,4
Task 1774,Job 1,8,10,4,11,0,12,19,7,4,1,0,1774,1807,20
Task 1775,Job 0,8,8,3,12,0,11,20,9,3,1,2,1775,1809,18
Task 1775,Job 1,13,6,2,12,0,15,25,10,2,1,0,1775,1809,3
Task 1776,Job 0,5,7,1,11,1,6,16,10,1,2,0,1776,1810,8
Task 1776,Job 1,10,8,4,11,0,14,21,7,4,1,0,1776,1810,10
Task 1777,Job 0,5,4,3,9,1,8,14,6,3,2,2,1777,1810,10
Task 1777,Job 1,10,10,3,6,0,13,16,3,3,2,1,1777,1810,4
Task 1778,Job 0,5,4,1,7,0,6,12,6,1,2,2,1778,1812,12
Task 1778,Job 1,10,5,3,12,0,13,22,9,3,1,0,1778,1812,17
Task 1779,Job 0,6,7,4,8,0,10,14,4,4,2,2,1779,1813,13
Task 1779,Job 1,11,6,1,10,1,12,21,9,1,2,0,1779,1813,15
Task 1780,Job 0,7,6,4,6,0,11,13,2,4,1,2,1780,1813,12
Task 1780,Job 1,12,4,4,12,0,16,24,8,4,4,0,1780,1813,5
Task 1781,Job 0,8,8,2,11,0,10,19,9,2,1,0,1781,1814,11
Task 1781,Job 1,13,9,3,11,1,16,24,8,3,1,0,1781,1814,5
Task 1782,Job 0,2,5,1,7,0,3,9,6,1,3,0,1782,1816,12
Task 1782,Job 1,7,8,3,9,0,10,16,6,3,4,1,1782,1816,14
Task 1783,Job 0,6,6,1,6,0,7,12,5,1,2,1,1783,1816,19
Task 1783,Job 1,11,4,2,6,1,13,17,4,2,1,2,1783,1816,17
Task 1784,Job 0,8,6,4,6,0,12,14,2,4,3,0,1784,1818,8
Task 1784,Job 1,13,7,3,9,1,16,22,6,3,4,0,1784,1818,19
Task 1785,Job 0,2,5,1,11,1,3,13,10,1,2,2,1785,1819,15
Task 1785,Job 1,7,7,3,7,0,10,14,4,3,1,1,1785,1819,12
Task 1786,Job 0,8,9,2,8,0,10,16,6,2,4,1,1786,1820,3
Task 1786,Job 1,13,6,4,7,0,17,20,3,4,4,2,1786,1820,4
Task 1787,Job 0,10,7,4,6,1,14,16,2,4,4,0,1787,1821,12
Task 1787,Job 1,15,4,2,9,0,17,24,7,2,4,1,1787,1821,7
Task 1788,Job 0,1,7,3,10,0,4,11,7,3,1,2,1788,1822,14
Task 1788,Job 1,6,5,3,8,0,9,14,5,3,4,1,1788,1822,18
Task 1789,Job 0,4,7,4,8,0,8,12,4,4,3,0,1789,1823,9
Task 1789,Job 1,9,10,4,8,0,13,17,4,4,4,2,1789,1823,16
Task 1790,Job 0,7,7,3,9,0,10,16,6,3,2,1,1790,1823,5
Task 1790,Job 1,12,5,2,10,0,14,22,8,2,3,1,1790,1823,14
Task 1791,Job 0,7,4,4,12,0,11,19,8,4,2,2,1791,1824,6
Task 1791,Job 1,12,7,1,7,0,13,19,6,1,4,0,1791,1824,10
Task 1792,Job 0,3,6,4,10,1,7,13,6,4,3,2,1792,1826,9
Task 1792,Job 1,8,6,4,6,0,12,14,2,4,1,0,1792,1826,19
Task 1793,Job 0,9,4,4,11,0,13,20,7,4,2,1,1793,1826,20
Task 1793,Job 1,14,7,4,7,0,18,21,3,4,2,1,1793,1826,7
Task 1794,Job 0,7,5,2,7,0,9,14,5,2,2,2,1794,1827,7
Task 1794,Job 1,12,4,3,8,1,15,20,5,3,4,0,1794,1827,10
Task 1795,Job 0,7,8,4,8,1,11,15,4,4,1,2,1795,1828,8
Task 1795,Job 1,12,4,1,10,0,13,22,9,1,3,0,1795,1828,15
Task 1796,Job 0,5,7,1,11,0,6,16,10,1,2,0,1796,1829,15
Task 1796,Job 1,10,8,1,9,1,11,19,8,1,2,2,1796,1829,2
Task 1797,Job 0,6,9,4,8,0,10,14,4,4,4,2,1797,1831,19
Task 1797,Job 1,11,5,4,6,1,15,17,2,4,3,0,1797,1831,17
Task 1798,Job 0,8,9,2,11,0,10,19,9,2,1,2,1798,1832,17
Task 1798,Job 1,13,9,4,10,0,17,23,6,4,1,0,1798,1832,13
Task 1799,Job 0,6,6,1,7,0,7,13,6,1,1,2,1799,1832,5
Task 1799,Job 1,11,8,1,6,0,12,17,5,1,3,0,1799,1832,4
Task 1800,Job 0,2,9,4,7,0,6,9,3,4,2,2,1800,1833,6
Task 1800,Job 1,7,5,1,8,0,8,15,7,1,4,0,1800,1833,8
Task 1801,Job 0,7,9,1,12,0,8,19,11,1,2,1,1801,1835,12
Task 1801,Job 1,12,10,4,7,0,16,19,3,4,1,2,1801,1835,5
Task 1802,Job 0,8,7,3,10,0,11,18,7,3,1,0,1802,1836,4
Task 1802,Job 1,13,10,1,11,1,14,24,10,1,2,2,1802,1836,10
Task 1803,Job 0,10,10,2,11,0,12,21,9,2,3,1,1803,1836,7
Task 1803,Job 1,15,8,1,7,0,16,22,6,1,4,1,1803,1836,16
Task 1804,Job 0,9,9,4,9,0,13,18,5,4,4,2,1804,1838,8
Task 1804,Job 1,14,10,2,10,0,16,24,8,2,2,1,1804,1838,3
Task 1805,Job 0,5,8,1,11,0,6,16,10,1,3,0,1805,1838,7
Task 1805,Job 1,10,9,3,10,0,13,20,7,3,1,2,1805,1838,17
Task 1806,Job 0,4,7,4,10,0,8,14,6,4,1,2,1806,1839,5
Task 1806,Job 1,9,5,4,12,0,13,21,8,4,4,0,1806,1839,19
Task 1807,Job 0,10,7,3,12,0,13,22,9,3,4,1,1807,1840,14
Task 1807,Job 1,15,7,3,6,0,18,21,3,3,1,0,1807,1840,11
Task 1808,Job 0,6,9,1,10,0,7,16,9,1,4,1,1808,1842,14
Task 1808,Job 1,11,6,1,12,0,12,23,11,1,2,0,1808,1842,20
Task 1809,Job 0,9,5,3,12,0,12,21,9,3,4,2,1809,1843,20
Task 1809,Job 1,14,8,2,7,0,16,21,5,2,1,2,1809,1843,19
Task 1810,Job 0,8,8,4,9,0,12,17,5,4,4,2,1810,1844,4
Task 1810,Job 1,13,4,4,8,1,17,21,4,4,2,1,1810,1844,7
Task 1811,Job 0,5,9,1,7,1,6,12,6,1,4,1,1811,1845,5
Task 1811,Job 1,10,7,2,8,1,12,18,6,2,3,2,1811,1845,9
Task 1812,Job 0,2,6,2,6,0,4,8,4,2,3,0,1812,1845,12
Task 1812,Job 1,7,7,3,11,0,10,18,8,3,4,1,1812,1845,9
Task 1813,Job 0,3,4,3,12,1,6,15,9,3,3,0,1813,1847,15
Task 1813,Job 1,8,7,4,7,0,12,15,3,4,1,2,1813,1847,18
Task 1814,Job 0,3,8,2,12,0,5,15,10,2,2,2,1814,1848,2
Task 1814,Job 1,8,5,2,12,0,10,20,10,2,2,0,1814,1848,7
Task 1815,Job 0,7,5,4,6,0,11,13,2,4,4,1,1815,1848,18
Task 1815,Job 1,12,6,4,6,0,16,18,2,4,3,2,1815,1848,6
Task 1816,Job 0,6,7,2,7,0,8,13,5,2,3,0,1816,1849,6
Task 1816,Job 1,11,7,1,12,0,12,23,11,1,2,1,1816,1849,16
Task 1817,Job 0,2,8,2,8,0,4,10,6,2,2,2,1817,1851,7
Task 1817,Job 1,7,7,3,7,0,10,14,4,3,4,2,1817,1851,6
Task 1818,Job 0,6,4,1,6,0,7,12,5,1,4,0,1818,1852,7
Task 1818,Job 1,11,8,1,8,0,12,19,7,1,1,0,1818,1852,12
Task 1819,Job 0,4,10,2,10,0,6,14,8,2,1,2,1819,1852,3
Task 1819,Job 1,9,5,2,8,0,11,17,6,2,4,2,1819,1852,20
Task 1820,Job 0,8,4,4,8,0,12,16,4,4,4,2,1820,1853,12
Task 1820,Job 1,13,9,4,7,1,17,20,3,4,2,1,1820,1853,10
Task 1821,Job 0,10,5,2,12,0,12,22,10,2,4,0,1821,1855,11
Task 1821,Job 1,15,10,2,8,1,17,23,6,2,2,2,1821,1855,16
Task 1822,Job 0,2,7,1,8,0,3,10,7,1,3,2,1822,1855,16
Task 1822,Job 1,7,9,1,11,0,8,18,10,1,1,0,1822,1855,11
Task 1823,Job 0,7,4,3,11,0,10,18,8,3,1,2,1823,1856,6
Task 1823,Job 1,12,9,2,10,0,14,22,8,2,4,2,1823,1856,7
Task 1824,Job 0,7,5,3,12,0,10,19,9,3,4,2,1824,1857,15
Task 1824,Job 1,12,7,4,10,0,16,22,6,4,4,2,1824,1857,7
Task 1825,Job 0,4,10,4,6,0,8,10,2,4,2,2,1825,1858,5
Task 1825,Job 1,9,5,3,6,0,12,15,3,3,4,2,1825,1858,9
Task 1826,Job 0,9,6,1,11,1,10,20,10,1,1,0,1826,1860,6
Task 1826,Job 1,14,7,1,10,0,15,24,9,1,4,0,1826,1860,9
Task 1827,Job 0,4,4,3,10,0,7,14,7,3,3,2,1827,1860,3
Task 1827,Job 1,9,4,4,12,0,13,21,8,4,3,1,1827,1860,15
Task 1828,Job 0,1,4,1,6,0,2,7,5,1,3,2,1828,1861,16
Task 1828,Job 1,6,6,2,10,1,8,16,8,2,3,2,1828,1861,18
Task 1829,Job 0,2,7,4,12,1,6,14,8,4,3,0,1829,1863,18
Task 1829,Job 1,7,10,3,11,0,10,18,8,3,1,1,1829,1863,8
Task 1830,Job 0,4,9,4,11,0,8,15,7,4,3,2,1830,1864,20
Task 1830,Job 1,9,5,1,8,0,10,17,7,1,2,2,1830,1864,15
Task 1831,Job 0,2,8,4,6,0,6,8,2,4,3,1,1831,1865,16
Task 1831,Job 1,7,10,4,10,0,11,17,6,4,4,0,1831,1865,15
Task 1832,Job 0,6,6,4,11,0,10,17,7,4,2,2,1832,1865,7
Task 1832,Job 1,11,5,1,11,0,12,22,10,1,3,0,1832,1865,16
Task 1833,Job 0,9,7,3,12,0,12,21,9,3,3,2,1833,1866,5
Task 1833,Job 1,14,10,3,6,0,17,20,3,3,3,1,1833,1866,14
Task 1834,Job 0,2,7,3,9,0,5,11,6,3,3,0,1834,1867,13
Task 1834,Job 1,7,10,4,10,0,11,17,6,4,1,2,1834,1867,9
Task 1835,Job 0,8,10,1,11,0,9,19,10,1,3,0,1835,1869,14
Task 1835,Job 1,13,5,2,11,0,15,24,9,2,2,2,1835,1869,5
Task 1836,Job 0,4,4,3,11,0,7,15,8,3,2,1,1836,1870,17
Task 1836,Job 1,9,8,1,8,1,10,17,7,1,1,0,1836,1870,8
Task 1837,Job 0,3,9,2,9,1,5,12,7,2,4,0,1837,1871,2
Task 1837,Job 1,8,7,3,6,0,11,14,3,3,1,2,1837,1871,8
Task 1838,Job 0,6,6,3,9,0,9,15,6,3,4,2,1838,1871,14
Task 1838,Job 1,11,8,1,12,0,12,23,11,1,2,0,1838,1871,8
Task 1839,Job 0,10,5,3,7,0,13,17,4,3,2,1,1839,1873,8
Task 1839,Job 1,15,5,2,7,0,17,22,5,2,4,1,1839,1873,2
Task 1840,Job 0,3,8,4,10,0,7,13,6,4,3,2,1840,1874,15
Task 1840,Job 1,8,7,4,8,0,12,16,4,4,2,0,1840,1874,18
Task 1841,Job 0,1,6,2,6,0,3,7,4,2,4,1,1841,1875,17
Task 1841,Job 1,6,7,4,12,0,10,18,8,4,3,1,1841,1875,7
Task 1842,Job 0,5,4,3,10,1,8,15,7,3,1,2,1842,1876,15
Task 1842,Job 1,10,10,1,10,0,11,20,9,1,1,1,1842,1876,8
Task 1843,Job 0,4,6,2,7,1,6,11,5,2,2,2,1843,1877,20
Task 1843,Job 1,9,4,2,8,0,11,17,6,2,3,0,1843,1877,5
Task 1844,Job 0,4,6,2,11,1,6,15,9,2,1,2,1844,1877,3
Task 1844,Job 1,9,6,4,12,1,13,21,8,4,1,0,1844,1877,18
Task 1845,Job 0,3,4,1,6,0,4,9,5,1,4,1,1845,1879,15
Task 1845,Job 1,8,5,2,9,0,10,17,7,2,2,1,1845,1879,2
Task 1846,Job 0,10,5,2,8,0,12,18,6,2,1,1,1846,1879,10
Task 1846,Job 1,15,5,3,11,1,18,26,8,3,2,1,1846,1879,9
Task 1847,Job 0,6,8,4,12,0,10,18,8,4,4,1,1847,1881,12
Task 1847,Job 1,11,4,1,6,0,12,17,5,1,2,2,1847,1881,6
Task 1848,Job 0,3,6,1,6,1,4,9,5,1,3,0,1848,1881,10
Task 1848,Job 1,8,10,1,10,0,9,18,9,1,3,2,1848,1881,7
Task 1849,Job 0,1,5,1,10,0,2,11,9,1,2,0,1849,1883,10
Task 1849,Job 1,6,10,1,12,0,7,18,11,1,1,1,1849,1883,5
Task 1850,Job 0,5,6,4,11,0,9,16,7,4,1,2,1850,1883,11
Task 1850,Job 1,10,4,3,9,0,13,19,6,3,4,0,1850,1883,15
Task 1851,Job 0,2,5,4,8,0,6,10,4,4,3,2,1851,1884,14
Task 1851,Job 1,7,10,2,8,1,9,15,6,2,4,1,1851,1884,18
Task 1852,Job 0,4,5,1,10,0,5,14,9,1,1,1,1852,1885,14
Task 1852,Job 1,9,7,4,7,0,13,16,3,4,1,2,1852,1885,4
Task 1853,Job 0,1,5,1,6,1,2,7,5,1,4,0,1853,1887,12
Task 1853,Job 1,6,10,4,8,0,10,14,4,4,3,0,1853,1887,15
Task 1854,Job 0,7,9,4,8,0,11,15,4,4,4,2,1854,1888,18
Task 1854,Job 1,12,8,1,9,0,13,21,8,1,4,2,1854,1888,14
Task 1855,Job 0,4,8,3,6,0,7,10,3,3,2,2,1855,1889,11
Task 1855,Job 1,9,10,2,12,0,11,21,10,2,3,0,1855,1889,19
Task 1856,Job 0,5,6,1,10,0,6,15,9,1,3,0,1856,1890,10
Task 1856,Job 1,10,10,1,12,1,11,22,11,1,1,2,1856,1890,13
Task 1857,Job 0,10,6,4,7,0,14,17,3,4,3,1,1857,1890,8
Task 1857,Job 1,15,5,4,12,0,19,27,8,4,4,2,1857,1890,9
Task 1858,Job 0,8,9,3,6,0,11,14,3,3,3,1,1858,1892,11
Task 1858,Job 1,13,5,2,12,0,15,25,10,2,2,0,1858,1892,9
Task 1859,Job 0,2,6,1,6,0,3,8,5,1,2,1,1859,1893,13
Task 1859,Job 1,7,9,2,9,0,9,16,7,2,3,2,1859,1893,17
Task 1860,Job 0,5,5,3,9,0,8,14,6,3,1,2,1860,1894,5
Task 1860,Job 1,10,5,3,9,1,13,19,6,3,1,0,1860,1894,7
Task 1861,Job 0,7,8,3,11,0,10,18,8,3,2,1,1861,1895,5
Task 1861,Job 1,12,5,4,11,1,16,23,7,4,4,2,1861,1895,10
Task 1862,Job 0,1,10,4,8,0,5,9,4,4,2,1,1862,1895,20
Task 1862,Job 1,6,4,1,12,0,7,18,11,1,3,2,1862,1895,16
Task 1863,Job 0,9,6,4,10,0,13,19,6,4,4,0,1863,1897,17
Task 1863,Job 1,14,6,3,8,0,17,22,5,3,1,1,1863,1897,14
Task 1864,Job 0,2,7,1,9,0,3,11,8,1,3,1,1864,1897,17
Task 1864,Job 1,7,5,2,7,1,9,14,5,2,4,0,1864,1897,10
Task 1865,Job 0,5,6,2,11,1,7,16,9,2,4,2,1865,1899,17
Task 1865,Job 1,10,6,2,10,0,12,20,8,2,2,2,1865,1899,11
Task 1866,Job 0,9,9,3,11,1,12,20,8,3,2,0,1866,1900,9
Task 1866,Job 1,14,9,3,9,0,17,23,6,3,2,0,1866,1900,17
Task 1867,Job 0,4,7,3,9,0,7,13,6,3,4,2,1867,1900,7
Task 1867,Job 1,9,7,3,7,0,12,16,4,3,3,0,1867,1900,8
Task 1868,Job 0,3,4,1,6,0,4,9,5,1,3,1,1868,1902,3
Task 1868,Job 1,8,5,1,8,0,9,16,7,1,3,1,1868,1902,5
Task 1869,Job 0,9,8,3,9,0,12,18,6,3,2,2,1869,1902,16
Task 1869,Job 1,14,5,1,11,0,15,25,10,1,4,1,1869,1902,12
Task 1870,Job 0,10,5,1,9,1,11,19,8,1,3,0,1870,1903,15
Task 1870,Job 1,15,7,4,6,0,19,21,2,4,2,2,1870,1903,16
Task 1871,Job 0,6,10,1,6,1,7,12,5,1,4,0,1871,1905,8
Task 1871,Job 1,11,7,3,9,0,14,20,6,3,1,2,1871,1905,12
Task 1872,Job 0,4,6,2,9,0,6,13,7,2,2,1,1872,1905,13
Task 1872,Job 1,9,5,2,12,0,11,21,10,2,2,0,1872,1905,6
Task 1873,Job 0,7,7,4,6,0,11,13,2,4,4,1,1873,1907,8
Task 1873,Job 1,12,7,2,11,1,14,23,9,2,2,1,1873,1907,10
Task 1874,Job 0,10,5,1,11,0,11,21,10,1,2,0,1874,1908,5
Task 1874,Job 1,15,8,3,7,1,18,22,4,3,4,2,1874,1908,2
Task 1875,Job 0,2,5,2,12,0,4,14,10,2,1,2,1875,1908,18
Task 1875,Job 1,7,5,1,6,0,8,13,5,1,2,2,1875,1908,4
Task 1876,Job 0,5,8,4,6,0,9,11,2,4,1,1,1876,1909,11
Task 1876,Job 1,10,5,3,7,1,13,17,4,3,3,2,1876,1909,9
Task 1877,Job 0,7,8,4,10,0,11,17,6,4,3,1,1877,1911,14
Task 1877,Job 1,12,6,1,6,0,13,18,5,1,4,2,1877,1911,20
Task 1878,Job 0,1,10,3,6,0,4,7,3,3,2,1,1878,1911,16
Task 1878,Job 1,6,4,2,9,0,8,15,7,2,3,0,1878,1911,13
Task 1879,Job 0,6,7,3,11,0,9,17,8,3,2,0,1879,1912,10
Task 1879,Job 1,11,4,2,7,0,13,18,5,2,3,1,1879,1912,17
Task 1880,Job 0,1,5,4,12,0,5,13,8,4,3,1,1880,1913,14
Task 1880,Job 1,6,8,4,11,1,10,17,7,4,1,1,1880,1913,15
Task 1881,Job 0,9,10,1,11,1,10,20,10,1,4,2,1881,1914,3
Task 1881,Job 1,14,7,1,10,0,15,24,9,1,4,1,1881,1914,20
Task 1882,Job 0,1,4,4,8,0,5,9,4,4,3,0,1882,1916,3
Task 1882,Job 1,6,4,2,11,0,8,17,9,2,4,0,1882,1916,19
Task 1883,Job 0,5,7,4,10,0,9,15,6,4,1,0,1883,1916,13
Task 1883,Job 1,10,9,3,11,1,13,21,8,3,2,2,1883,1916,14
Task 1884,Job 0,9,5,3,10,0,12,19,7,3,2,2,1884,1918,13
Task 1884,Job 1,14,10,4,6,0,18,20,2,4,4,2,1884,1918,18
Task 1885,Job 0,5,5,3,8,0,8,13,5,3,2,0,1885,1919,18
Task 1885,Job 1,10,7,1,11,0,11,21,10,1,3,1,1885,1919,18
Task 1886,Job 0,9,9,1,6,0,10,15,5,1,1,2,1886,1919,8
Task 1886,Job 1,14,8,3,8,0,17,22,5,3,2,2,1886,1919,13
Task 1887,Job 0,2,5,4,7,0,6,9,3,4,4,2,1887,1920,3
Task 1887,Job 1,7,4,3,8,1,10,15,5,3,2,2,1887,1920,16
Task 1888,Job 0,4,8,2,8,0,6,12,6,2,1,0,1888,1921,13
Task 1888,Job 1,9,8,2,10,0,11,19,8,2,4,2,1888,1921,16
Task 1889,Job 0,4,9,1,9,0,5,13,8,1,2,0,1889,1922,9
Task 1889,Job 1,9,9,2,11,0,11,20,9,2,3,0,1889,1922,12
Task 1890,Job 0,10,10,1,10,0,11,20,9,1,4,1,1890,1923,15
Task 1890,Job 1,15,8,1,7,1,16,22,6,1,1,0,1890,1923,13
Task 1891,Job 0,10,6,2,11,0,12,21,9,2,1,1,1891,1924,11
Task 1891,Job 1,15,9,3,8,0,18,23,5,3,2,2,1891,1924,12
Task 1892,Job 0,5,5,3,6,0,8,11,3,3,2,1,1892,1925,10
Task 1892,Job 1,10,7,1,11,1,11,21,10,1,3,1,1892,1925,4
Task 1893,Job 0,4,4,4,6,0,8,10,2,4,3,1,1893,1926,20
Task 1893,Job 1,9,10,1,10,1,10,19,9,1,1,0,1893,1926,9
Task 1894,Job 0,5,4,2,11,0,7,16,9,2,2,1,1894,1928,17
Task 1894,Job 1,10,4,3,10,0,13,20,7,3,1,0,1894,1928,13
Task 1895,Job 0,5,7,3,6,0,8,11,3,3,1,2,1895,1928,6
Task 1895,Job 1,10,10,2,12,0,12,22,10,2,1,2,1895,1928,5
Task 1896,Job 0,3,5,2,6,0,5,9,4,2,3,0,1896,1930,7
Task 1896,Job 1,8,10,4,11,1,12,19,7,4,1,2,1896,1930,11
Task 1897,Job 0,3,4,2,10,1,5,13,8,2,2,1,1897,1931,14
Task 1897,Job 1,8,4,3,6,0,11,14,3,3,4,2,1897,1931,8
Task 1898,Job 0,4,4,2,6,0,6,10,4,2,1,0,1898,1932,13
Task 1898,Job 1,9,7,1,11,1,10,20,10,1,3,1,1898,1932,2
Task 1899,Job 0,8,5,4,9,0,12,17,5,4,1,2,1899,1932,5
Task 1899,Job 1,13,5,3,10,0,16,23,7,3,2,1,1899,1932,6
Task 1900,Job 0,10,9,2,11,1,12,21,9,2,1,0,1900,1933,14
Task 1900,Job 1,15,7,4,8,1,19,23,4,4,1,2,1900,1933,12
Task 1901,Job 0,4,4,3,10,0,7,14,7,3,4,2,1901,1934,3
Task 1901,Job 1,9,9,1,8,0,10,17,7,1,3,0,1901,1934,2
Task 1902,Job 0,3,5,4,11,0,7,14,7,4,1,2,1902,1936,2
Task 1902,Job 1,8,5,2,8,1,10,16,6,2,3,1,1902,1936,12
Task 1903,Job 0,3,5,1,12,0,4,15,11,1,4,2,1903,1936,14
Task 1903,Job 1,8,4,4,6,0,12,14,2,4,1,0,1903,1936,6
Task 1904,Job 0,4,5,2,10,0,6,14,8,2,3,1,1904,1937,10
Task 1904,Job 1,9,7,4,12,1,13,21,8,4,2,2,1904,1937,10
Task 1905,Job 0,7,7,4,7,0,11,14,3,4,4,2,1905,1939,12
Task 1905,Job 1,12,7,4,9,0,16,21,5,4,2,2,1905,1939,8
Task 1906,Job 0,7,4,1,10,0,8,17,9,1,3,0,1906,1939,17
Task 1906,Job 1,12,6,3,9,1,15,21,6,3,1,0,1906,1939,15
Task 1907,Job 0,10,8,3,6,0,13,16,3,3,3,1,1907,1941,9
Task 1907,Job 1,15,9,2,8,0,17,23,6,2,2,2,1907,1941,17
Task 1908,Job 0,2,10,2,8,1,4,10,6,2,3,1,1908,1942,9
Task 1908,Job 1,7,6,3,6,0,10,13,3,3,2,2,1908,1942,17
Task 1909,Job 0,6,6,4,9,0,10,15,5,4,3,0,1909,1942,11
Task 1909,Job 1,11,7,2,12,0,13,23,10,2,1,0,1909,1942,2
Task 1910,Job 0,4,5,3,11,0,7,15,8,3,2,2,1910,1943,3
Task 1910,Job 1,9,6,1,10,0,10,19,9,1,3,2,1910,1943,5
Task 1911,Job 0,2,8,2,10,0,4,12,8,2,3,0,1911,1945,9
Task 1911,Job 1,7,5,1,7,1,8,14,6,1,4,1,1911,1945,9
Task 1912,Job 0,4,8,4,9,0,8,13,5,4,2,2,1912,1945,19
Task 1912,Job 1,9,10,2,10,0,11,19,8,2,3,0,1912,1945,9
Task 1913,Job 0,7,6,4,12,1,11,19,8,4,4,2,1913,1946,14
Task 1913,Job 1,12,5,2,12,0,14,24,10,2,1,0,1913,1946,19
Task 1914,Job 0,6,10,4,10,1,10,16,6,4,1,0,1914,1947,4
Task 1914,Job 1,11,8,4,12,0,15,23,8,4,2,2,1914,1947,14
Task 1915,Job 0,7,4,2,11,0,9,18,9,2,1,1,1915,1949,3
Task 1915,Job 1,12,6,1,9,0,13,21,8,1,1,2,1915,1949,11
Task 1916,Job 0,7,8,1,9,0,8,16,8,1,2,1,1916,1950,18
Task 1916,Job 1,12,9,3,10,0,15,22,7,3,4,2,1916,1950,2
Task 1917,Job 0,2,10,1,6,0,3,8,5,1,1,2,1917,1950,16
Task 1917,Job 1,7,9,3,12,1,10,19,9,3,3,2,1917,1950,8
Task 1918,Job 0,2,4,3,11,0,5,13,8,3,3,2,1918,1951,14
Task 1918,Job 1,7,6,3,6,0,10,13,3,3,1,2,1918,1951,7
Task 1919,Job 0,6,8,1,9,0,7,15,8,1,1,2,1919,1953,4
Task 1919,Job 1,11,8,3,10,0,14,21,7,3,4,2,1919,1953,14
Task 1920,Job 0,5,6,1,10,0,6,15,9,1,1,1,1920,1954,20
Task 1920,Job 1,10,10,4,6,0,14,16,2,4,4,0,1920,1954,2
Task 1921,Job 0,9,7,1,6,0,10,15,5,1,2,1,1921,1955,10
Task 1921,Job 1,14,8,4,7,0,18,21,3,4,3,1,1921,1955,8
Task 1922,Job 0,8,6,3,10,0,11,18,7,3,2,0,1922,1955,7
Task 1922,Job 1,13,7,1,10,0,14,23,9,1,2,1,1922,1955,19
Task 1923,Job 0,9,4,2,11,0,11,20,9,2,3,1,1923,1956,2
Task 1923,Job 1,14,5,2,12,1,16,26,10,2,3,0,1923,1956,13
Task 1924,Job 0,10,4,2,11,0,12,21,9,2,1,2,1924,1957,15
Task 1924,Job 1,15,4,2,6,0,17,21,4,2,3,1,1924,1957,11
Task 1925,Job 0,3,10,2,9,0,5,12,7,2,2,2,1925,1959,3
Task 1925,Job 1,8,6,4,12,0,12,20,8,4,3,1,1925,1959,15
Task 1926,Job 0,9,9,4,8,0,13,17,4,4,1,2,1926,1960,4
Task 1926,Job 1,14,5,2,12,0,16,26,10,2,4,2,1926,1960,8
Task 1927,Job 0,8,8,2,11,1,10,19,9,2,3,2,1927,1960,10
Task 1927,Job 1,13,10,2,9,0,15,22,7,2,3,0,1927,1960,5
Task 1928,Job 0,8,6,3,10,1,11,18,7,3,2,2,1928,1961,5
Task 1928,Job 1,13,9,4,12,0,17,25,8,4,4,0,1928,1961,5
Task 1929,Job 0,5,5,4,11,0,9,16,7,4,4,1,1929,1963,7
Task 1929,Job 1,10,4,1,6,0,11,16,5,1,3,0,1929,1963,13
Task 1930,Job 0,1,10,1,11,0,2,12,10,1,3,0,1930,1963,5
Task 1930,Job 1,6,10,3,10,1,9,16,7,3,2,2,1930,1963,7
Task 1931,Job 0,9,8,1,11,0,10,20,10,1,4,0,1931,1965,16
Task 1931,Job 1,14,9,4,8,0,18,22,4,4,2,2,1931,1965,15
Task 1932,Job 0,7,9,2,9,1,9,16,7,2,4,0,1932,1966,8
Task 1932,Job 1,12,6,2,12,1,14,24,10,2,4,2,1932,1966,4
Task 1933,Job 0,9,6,1,7,0,10,16,6,1,1,2,1933,1966,8
Task 1933,Job 1,14,6,1,12,0,15,26,11,1,4,0,1933,1966,9
Task 1934,Job 0,9,10,4,8,1,13,17,4,4,3,0,1934,1967,5
Task 1934,Job 1,14,7,2,10,1,16,24,8,2,4,2,1934,1967,3
Task 1935,Job 0,4,5,3,6,1,7,10,3,3,3,1,1935,1968,14
Task 1935,Job 1,9,6,4,7,0,13,16,3,4,1,0,1935,1968,15
Task 1936,Job 0,5,8,2,8,1,7,13,6,2,2,1,1936,1969,19
Task 1936,Job 1,10,5,3,7,0,13,17,4,3,3,2,1936,1969,15
Task 1937,Job 0,8,9,3,7,0,11,15,4,3,4,0,1937,1971,10
Task 1937,Job 1,13,4,2,9,0,15,22,7,2,4,0,1937,1971,5
Task 1938,Job 0,8,5,3,12,1,11,20,9,3,1,2,1938,1971,16
Task 1938,Job 1,13,9,1,12,0,14,25,11,1,2,1,1938,1971,5
Task 1939,Job 0,8,8,1,10,0,9,18,9,1,4,0,1939,1972,7
Task 1939,Job 1,13,9,2,9,0,15,22,7,2,2,1,1939,1972,13
Task 1940,Job 0,1,5,4,12,0,5,13,8,4,1,1,1940,1973,15
Task 1940,Job 1,6,7,4,9,0,10,15,5,4,2,2,1940,1973,19
Task 1941,Job 0,2,5,2,7,0,4,9,5,2,1,0,1941,1974,4
Task 1941,Job 1,7,4,3,12,0,10,19,9,3,4,2,1941,1974,14
Task 1942,Job 0,4,4,4,7,0,8,11,3,4,3,1,1942,1976,8
Task 1942,Job 1,9,4,1,8,1,10,17,7,1,1,2,1942,1976,12
Task 1943,Job 0,6,5,1,11,0,7,17,10,1,3,2,1943,1976,5
Task 1943,Job 1,11,4,2,10,0,13,21,8,2,4,0,1943,1976,19
Task 1944,Job 0,10,8,2,11,0,12,21,9,2,4,0,1944,1977,10
Task 1944,Job 1,15,10,3,9,0,18,24,6,3,2,1,1944,1977,8
Task 1945,Job 0,9,8,4,10,0,13,19,6,4,1,1,1945,1979,13
Task 1945,Job 1,14,10,3,12,0,17,26,9,3,1,1,1945,1979,14
Task 1946,Job 0,3,7,3,12,0,6,15,9,3,3,1,1946,1979,16
Task 1946,Job 1,8,5,2,8,1,10,16,6,2,1,0,1946,1979,19
Task 1947,Job 0,7,8,3,8,1,10,15,5,3,4,0,1947,1981,19
Task 1947,Job 1,12,8,2,11,0,14,23,9,2,2,1,1947,1981,15
Task 1948,Job 0,7,5,3,9,0,10,16,6,3,4,1,1948,1982,13
Task 1948,Job 1,12,7,1,7,0,13,19,6,1,2,0,1948,1982,16
Task 1949,Job 0,1,9,4,12,1,5,13,8,4,4,2,1949,1983,3
Task 1949,Job 1,6,7,4,12,0,10,18,8,4,1,1,1949,1983,10
Task 1950,Job 0,8,7,4,12,0,12,20,8,4,3,1,1950,1984,6
Task 1950,Job 1,13,4,4,10,0,17,23,6,4,1,0,1950,1984,18
Task 1951,Job 0,1,7,4,8,0,5,9,4,4,2,1,1951,1984,9
Task 1951,Job 1,6,4,4,6,0,10,12,2,4,2,0,1951,1984,9
Task 1952,Job 0,5,8,1,8,0,6,13,7,1,1,2,1952,1986,4
Task 1952,Job 1,10,7,4,7,1,14,17,3,4,3,0,1952,1986,3
Task 1953,Job 0,6,6,3,11,0,9,17,8,3,4,1,1953,1987,2
Task 1953,Job 1,11,9,4,10,0,15,21,6,4,1,1,1953,1987,14
Task 1954,Job 0,3,7,1,12,1,4,15,11,1,2,0,1954,1988,14
Task 1954,Job 1,8,8,3,8,0,11,16,5,3,1,0,1954,1988,13
Task 1955,Job 0,9,10,2,9,0,11,18,7,2,2,1,1955,1988,4
Task 1955,Job 1,14,10,3,11,0,17,25,8,3,4,0,1955,1988,4
Task 1956,Job 0,3,7,1,11,1,4,14,10,1,4,2,1956,1989,15
Task 1956,Job 1,8,9,4,7,0,12,15,3,4,3,1,1956,1989,6
Task 1957,Job 0,7,4,2,6,1,9,13,4,2,2,1,1957,1991,20
Task 1957,Job 1,12,8,3,12,0,15,24,9,3,4,2,1957,1991,5
Task 1958,Job 0,1,4,1,10,0,2,11,9,1,4,0,1958,1992,2
Task 1958,Job 1,6,9,4,11,0,10,17,7,4,3,2,1958,1992,20
Task 1959,Job 0,2,8,1,10,0,3,12,9,1,1,2,1959,1993,16
Task 1959,Job 1,7,7,4,8,1,11,15,4,4,1,1,1959,1993,13
Task 1960,Job 0,3,7,4,12,0,7,15,8,4,2,1,1960,1993,18
Task 1960,Job 1,8,4,4,8,1,12,16,4,4,2,1,1960,1993,3
Task 1961,Job 0,9,10,1,11,0,10,20,10,1,3,1,1961,1994,6
Task 1961,Job 1,14,4,2,9,0,16,23,7,2,3,0,1961,1994,11
Task 1962,Job 0,2,6,2,10,0,4,12,8,2,3,2,1962,1995,19
Task 1962,Job 1,7,7,3,6,0,10,13,3,3,2,2,1962,1995,4
Task 1963,Job 0,1,8,4,8,1,5,9,4,4,3,0,1963,1997,12
Task 1963,Job 1,6,10,3,10,0,9,16,7,3,3,0,1963,1997,8
Task 1964,Job 0,8,7,1,10,1,9,18,9,1,2,1,1964,1997,2
Task 1964,Job 1,13,4,1,8,1,14,21,7,1,3,1,1964,1997,8
Task 1965,Job 0,4,10,1,7,0,5,11,6,1,1,1,1965,1999,12
Task 1965,Job 1,9,8,4,7,0,13,16,3,4,2,1,1965,1999,16
Task 1966,Job 0,4,9,4,6,0,8,10,2,4,2,1,1966,2000,12
Task 1966,Job 1,9,5,2,9,0,11,18,7,2,1,1,1966,2000,6
Task 1967,Job 0,1,7,1,9,1,2,10,8,1,3,2,1967,2000,13
Task 1967,Job 1,6,10,1,11,1,7,17,10,1,2,2,1967,2000,20
Task 1968,Job 0,5,5,1,10,0,6,15,9,1,3,2,1968,2002,17
Task 1968,Job 1,10,5,2,6,0,12,16,4,2,2,1,1968,2002,20
Task 1969,Job 0,7,9,2,11,1,9,18,9,2,3,0,1969,2003,10
Task 1969,Job 1,12,10,2,12,0,14,24,10,2,2,0,1969,2003,10
Task 1970,Job 0,6,10,2,9,0,8,15,7,2,3,2,1970,2004,4
Task 1970,Job 1,11,9,3,6,0,14,17,3,3,2,0,1970,2004,17
Task 1971,Job 0,2,10,2,8,0,4,10,6,2,4,0,1971,2005,12
Task 1971,Job 1,7,5,1,6,1,8,13,5,1,2,1,1971,2005,5
Task 1972,Job 0,6,10,4,11,0,10,17,7,4,3,0,1972,2005,17
Task 1972,Job 1,11,6,1,9,0,12,20,8,1,2,2,1972,2005,3
Task 1973,Job 0,7,10,4,11,1,11,18,7,4,2,1,1973,2007,12
Task 1973,Job 1,12,9,4,10,1,16,22,6,4,3,1,1973,2007,15
Task 1974,Job 0,5,9,3,8,0,8,13,5,3,4,0,1974,2007,20
Task 1974,Job 1,10,10,1,9,0,11,19,8,1,1,2,1974,2007,17
Task 1975,Job 0,1,6,3,6,0,4,7,3,3,2,2,1975,2009,18
Task 1975,Job 1,6,5,4,9,0,10,15,5,4,3,1,1975,2009,3
Task 1976,Job 0,3,6,2,11,0,5,14,9,2,2,0,1976,2010,13
Task 1976,Job 1,8,4,2,8,0,10,16,6,2,1,2,1976,2010,4
Task 1977,Job 0,6,4,4,10,0,10,16,6,4,4,1,1977,2010,6
Task 1977,Job 1,11,4,4,7,0,15,18,3,4,4,1,1977,2010,4
Task 1978,Job 0,10,7,3,7,0,13,17,4,3,4,2,1978,2011,14
Task 1978,Job 1,15,9,2,9,0,17,24,7,2,2,1,1978,2011,9
Task 1979,Job 0,7,7,4,8,0,11,15,4,4,4,0,1979,2012,12
Task 1979,Job 1,12,5,2,10,1,14,22,8,2,2,0,1979,2012,9
Task 1980,Job 0,1,10,1,12,0,2,13,11,1,1,2,1980,2014,16
Task 1980,Job 1,6,8,4,9,0,10,15,5,4,4,0,1980,2014,13
Task 1981,Job 0,6,5,3,12,1,9,18,9,3,2,1,1981,2014,20
Task 1981,Job 1,11,6,4,12,0,15,23,8,4,4,2,1981,2014,17
Task 1982,Job 0,6,10,1,10,0,7,16,9,1,3,0,1982,2015,3
Task 1982,Job 1,11,10,2,10,0,13,21,8,2,4,0,1982,2015,7
Task 1983,Job 0,2,9,1,6,1,3,8,5,1,3,2,1983,2016,14
Task 1983,Job 1,7,7,1,6,1,8,13,5,1,1,1,1983,2016,17
Task 1984,Job 0,6,5,2,12,1,8,18,10,2,2,2,1984,2018,18
Task 1984,Job 1,11,6,2,7,0,13,18,5,2,4,0,1984,2018,10
Task 1985,Job 0,3,8,4,10,1,7,13,6,4,3,2,1985,2019,5
Task 1985,Job 1,8,7,3,6,0,11,14,3,3,4,1,1985,2019,16
Task 1986,Job 0,4,4,2,11,0,6,15,9,2,1,2,1986,2020,12
Task 1986,Job 1,9,6,2,11,0,11,20,9,2,2,2,1986,2020,12
Task 1987,Job 0,2,10,3,7,0,5,9,4,3,4,1,1987,2020,15
Task 1987,Job 1,7,7,4,12,0,11,19,8,4,2,2,1987,2020,14
Task 1988,Job 0,9,8,1,6,0,10,15,5,1,4,1,1988,2022,12
Task 1988,Job 1,14,4,3,8,0,17,22,5,3,4,0,1988,2022,9
Task 1989,Job 0,8,8,4,9,1,12,17,5,4,4,0,1989,2022,18
Task 1989,Job 1,13,4,3,9,1,16,22,6,3,2,0,1989,2022,19
Task 1990,Job 0,10,4,4,7,1,14,17,3,4,2,2,1990,2024,15
Task 1990,Job 1,15,7,3,6,0,18,21,3,3,2,0,1990,2024,10
Task 1991,Job 0,8,9,4,9,1,12,17,5,4,4,1,1991,2024,3
Task 1991,Job 1,13,7,3,11,0,16,24,8,3,4,2,1991,2024,18
Task 1992,Job 0,4,5,3,10,0,7,14,7,3,2,1,1992,2025,6
Task 1992,Job 1,9,5,1,7,0,10,16,6,1,3,2,1992,2025,17
Task 1993,Job 0,7,4,1,11,0,8,18,10,1,4,1,1993,2027,16
Task 1993,Job 1,12,7,2,8,0,14,20,6,2,4,1,1993,2027,9
Task 1994,Job 0,9,7,4,8,0,13,17,4,4,2,0,1994,2028,17
Task 1994,Job 1,14,8,4,10,0,18,24,6,4,3,1,1994,2028,11
Task 1995,Job 0,2,9,1,10,0,3,12,9,1,1,1,1995,2029,9
Task 1995,Job 1,7,9,1,11,0,8,18,10,1,3,1,1995,2029,19
Task 1996,Job 0,2,8,4,7,0,6,9,3,4,2,1,1996,2029,5
Task 1996,Job 1,7,8,3,8,1,10,15,5,3,4,0,1996,2029,3
Task 1997,Job 0,1,6,4,10,1,5,11,6,4,2,1,1997,2031,5
Task 1997,Job 1,6,5,3,10,0,9,16,7,3,1,0,1997,2031,18
Task 1998,Job 0,6,7,2,11,0,8,17,9,2,2,1,1998,2031,4
Task 1998,Job 1,11,9,4,6,1,15,17,2,4,3,2,1998,2031,18
Task 1999,Job 0,4,6,2,8,1,6,12,6,2,2,0,1999,2032,11
Task 1999,Job 1,9,7,1,8,1,10,17,7,1,4,2,1999,2032,5
Task 2000,Job 0,5,4,1,11,0,6,16,10,1,4,0,2000,2034,3
Task 2000,Job 1,10,6,2,6,0,12,16,4,2,3,2,2000,2034,12
Task 2001,Job 0,9,8,4,10,1,13,19,6,4,3,1,2001,2034,2
Task 2001,Job 1,14,6,1,10,0,15,24,9,1,4,2,2001,2034,8
Task 2002,Job 0,4,8,3,9,0,7,13,6,3,2,0,2002,2035,17
Task 2002,Job 1,9,8,2,8,1,11,17,6,2,4,1,2002,2035,14
Task 2003,Job 0,2,6,3,8,0,5,10,5,3,2,1,2003,2037,5
Task 2003,Job 1,7,7,4,10,0,11,17,6,4,1,1,2003,2037,10
Task 2004,Job 0,8,9,1,9,1,9,17,8,1,1,0,2004,2037,14
Task 2004,Job 1,13,6,1,11,0,14,24,10,1,3,1,2004,2037,5
Task 2005,Job 0,5,5,1,6,0,6,11,5,1,2,0,2005,2039,7
Task 2005,Job 1,10,5,3,11,0,13,21,8,3,2,1,2005,2039,6
Task 2006,Job 0,3,6,2,10,0,5,13,8,2,1,0,2006,2040,8
Task 2006,Job 1,8,5,4,6,0,12,14,2,4,4,2,2006,2040,18
Task 2007,Job 0,9,8,1,11,1,10,20,10,1,1,2,2007,2041,3
Task 2007,Job 1,14,6,4,12,0,18,26,8,4,2,2,2007,2041,12
Task 2008,Job 0,8,5,2,11,0,10,19,9,2,2,2,2008,2041,15
Task 2008,Job 1,13,10,1,12,0,14,25,11,1,3,1,2008,2041,11
Task 2009,Job 0,2,5,3,6,1,5,8,3,3,2,2,2009,2042,20
Task 2009,Job 1,7,9,3,9,0,10,16,6,3,2,1,2009,2042,6
Task 2010,Job 0,10,8,1,8,0,11,18,7,1,2,1,2010,2043,17
Task 2010,Job 1,15,5,2,12,0,17,27,10,2,4,2,2010,2043,8
Task 2011,Job 0,3,9,2,8,0,5,11,6,2,3,1,2011,2045,19
Task 2011,Job 1,8,5,1,6,0,9,14,5,1,2,2,2011,2045,11
Task 2012,Job 0,3,9,3,12,0,6,15,9,3,3,1,2012,2045,7
Task 2012,Job 1,8,4,1,10,0,9,18,9,1,3,2,2012,2045,10
Task 2013,Job 0,2,6,1,6,0,3,8,5,1,4,2,2013,2046,3
Task 2013,Job 1,7,8,1,7,0,8,14,6,1,2,1,2013,2046,4
Task 2014,Job 0,3,8,2,10,1,5,13,8,2,2,1,2014,2047,15
Task 2014,Job 1,8,7,4,6,0,12,14,2,4,3,1,2014,2047,15
Task 2015,Job 0,8,7,1,12,1,9,20,11,1,2,1,2015,2048,16
Task 2015,Job 1,13,7,2,6,0,15,19,4,2,1,1,2015,2048,2
Task 2016,Job 0,4,4,4,12,0,8,16,8,4,4,2,2016,2050,12
Task 2016,Job 1,9,6,1,11,0,10,20,10,1,4,0,2016,2050,9
Task 2017,Job 0,4,7,4,6,0,8,10,2,4,4,1,2017,2051,4
Task 2017,Job 1,9,7,4,9,0,13,18,5,4,4,1,2017,2051,3
Task 2018,Job 0,3,4,2,8,0,5,11,6,2,4,0,2018,2051,2
Task 2018,Job 1,8,10,3,6,0,11,14,3,3,1,1,2018,2051,14
Task 2019,Job 0,1,10,4,6,1,5,7,2,4,1,0,2019,2053,13
Task 2019,Job 1,6,9,4,12,1,10,18,8,4,2,1,2019,2053,17
Task 2020,Job 0,5,10,2,8,1,7,13,6,2,1,2,2020,2053,14
Task 2020,Job 1,10,6,1,10,1,11,20,9,1,3,0,2020,2053,3
Task 2021,Job 0,9,8,1,6,0,10,15,5,1,4,2,2021,2054,19
Task 2021,Job 1,14,6,4,6,1,18,20,2,4,3,0,2021,2054,11
Task 2022,Job 0,2,5,2,6,0,4,8,4,2,2,1,2022,2055,8
Task 2022,Job 1,7,7,2,7,0,9,14,5,2,3,1,2022,2055,14
Task 2023,Job 0,10,6,2,6,1,12,16,4,2,1,1,2023,2056,20
Task 2023,Job 1,15,10,1,6,0,16,21,5,1,4,1,2023,2056,16
Task 2024,Job 0,5,4,4,10,0,9,15,6,4,4,0,2024,2057,9
Task 2024,Job 1,10,7,2,12,1,12,22,10,2,3,1,2024,2057,7
Task 2025,Job 0,1,9,2,10,0,3,11,8,2,4,1,2025,2059,17
Task 2025,Job 1,6,5,3,10,0,9,16,7,3,3,2,2025,2059,2
Task 2026,Job 0,1,5,2,11,0,3,12,9,2,2,0,2026,2060,11
Task 2026,Job 1,6,4,2,8,1,8,14,6,2,2,0,2026,2060,16
Task 2027,Job 0,3,10,4,10,1,7,13,6,4,1,0,2027,2060,2
Task 2027,Job 1,8,4,1,7,0,9,15,6,1,3,2,2027,2060,11
Task 2028,Job 0,3,9,1,7,1,4,10,6,1,3,1,2028,2061,20
Task 2028,Job 1,8,10,3,8,1,11,16,5,3,4,2,2028,2061,5
Task 2029,Job 0,5,8,2,12,0,7,17,10,2,2,0,2029,2062,18
Task 2029,Job 1,10,10,4,11,0,14,21,7,4,1,1,2029,2062,5
Task 2030,Job 0,10,5,4,11,0,14,21,7,4,3,0,2030,2064,10
Task 2030,Job 1,15,6,1,6,1,16,21,5,1,1,1,2030,2064,18
Task 2031,Job 0,10,7,2,8,0,12,18,6,2,4,1,2031,2065,3
Task 2031,Job 1,15,4,1,7,0,16,22,6,1,4,1,2031,2065,2
Task 2032,Job 0,3,4,4,9,0,7,12,5,4,4,0,2032,2066,13
Task 2032,Job 1,8,7,2,12,0,10,20,10,2,3,2,2032,2066,13
Task 2033,Job 0,3,7,2,9,1,5,12,7,2,3,0,2033,2066,17
Task 2033,Job 1,8,4,4,8,0,12,16,4,4,3,1,2033,2066,16
Task 2034,Job 0,6,5,3,6,1,9,12,3,3,2,1,2034,2067,3
Task 2034,Job 1,11,10,1,8,0,12,19,7,1,2,2,2034,2067,14
Task 2035,Job 0,9,10,1,6,1,10,15,5,1,3,1,2035,2069,4
Task 2035,Job 1,14,8,4,10,0,18,24,6,4,1,2,2035,2069,15
Task 2036,Job 0,4,4,2,11,0,6,15,9,2,1,0,2036,2070,10
Task 2036,Job 1,9,5,1,10,0,10,19,9,1,3,2,2036,2070,20
Task 2037,Job 0,9,10,1,10,0,10,19,9,1,1,2,2037,2071,17
Task 2037,Job 1,14,10,1,8,1,15,22,7,1,2,1,2037,2071,16
Task 2038,Job 0,4,9,2,9,1,6,13,7,2,1,1,2038,2072,10
Task 2038,Job 1,9,5,4,6,0,13,15,2,4,1,1,2038,2072,11
Task 2039,Job 0,9,7,4,10,1,13,19,6,4,3,0,2039,2072,5
Task 2039,Job 1,14,4,3,12,0,17,26,9,3,4,1,2039,2072,5
Task 2040,Job 0,7,8,1,9,0,8,16,8,1,1,2,2040,2073,8
Task 2040,Job 1,12,8,1,10,0,13,22,9,1,3,1,2040,2073,9
Task 2041,Job 0,4,8,4,10,0,8,14,6,4,4,1,2041,2074,8
Task 2041,Job 1,9,10,4,10,0,13,19,6,4,1,0,2041,2074,4
Task 2042,Job 0,10,5,4,11,0,14,21,7,4,1,2,2042,2075,14
Task 2042,Job 1,15,10,2,10,0,17,25,8,2,2,2,2042,2075,10
Task 2043,Job 0,4,10,3,9,0,7,13,6,3,4,0,2043,2076,3
Task 2043,Job 1,9,6,1,10,0,10,19,9,1,4,1,2043,2076,2
Task 2044,Job 0,1,10,1,9,0,2,10,8,1,2,2,2044,2078,14
Task 2044,Job 1,6,4,4,6,0,10,12,2,4,2,1,2044,2078,18
Task 2045,Job 0,8,4,2,9,0,10,17,7,2,4,1,2045,2079,15
Task 2045,Job 1,13,10,4,6,0,17,19,2,4,3,2,2045,2079,14
Task 2046,Job 0,6,7,2,12,0,8,18,10,2,3,2,2046,2080,17
Task 2046,Job 1,11,10,3,7,0,14,18,4,3,4,0,2046,2080,15
Task 2047,Job 0,2,9,4,11,0,6,13,7,4,3,1,2047,2080,4
Task 2047,Job 1,7,6,1,10,1,8,17,9,1,1,2,2047,2080,5
Task 2048,Job 0,8,5,4,8,0,12,16,4,4,3,0,2048,2081,9
Task 2048,Job 1,13,4,2,9,0,15,22,7,2,4,0,2048,2081,12
Task 2049,Job 0,1,7,1,12,1,2,13,11,1,2,2,2049,2083,19
Task 2049,Job 1,6,10,2,10,0,8,16,8,2,3,2,2049,2083,3
Task 2050,Job 0,4,8,2,9,0,6,13,7,2,4,2,2050,2084,6
Task 2050,Job 1,9,7,1,6,0,10,15,5,1,2,1,2050,2084,3
Task 2051,Job 0,1,6,3,8,0,4,9,5,3,4,2,2051,2085,13
Task 2051,Job 1,6,9,2,10,0,8,16,8,2,4,1,2051,2085,10
Task 2052,Job 0,1,6,4,9,1,5,10,5,4,1,2,2052,2085,4
Task 2052,Job 1,6,9,1,11,0,7,17,10,1,1,1,2052,2085,19
Task 2053,Job 0,1,5,1,9,0,2,10,8,1,4,2,2053,2087,5
Task 2053,Job 1,6,9,3,6,0,9,12,3,3,4,1,2053,2087,18
Task 2054,Job 0,1,6,3,10,0,4,11,7,3,4,2,2054,2088,19
Task 2054,Job 1,6,7,4,11,0,10,17,7,4,4,0,2054,2088,2
Task 2055,Job 0,4,9,2,7,0,6,11,5,2,3,1,2055,2088,18
Task 2055,Job 1,9,8,4,11,1,13,20,7,4,2,0,2055,2088,18
Task 2056,Job 0,9,4,3,9,0,12,18,6,3,3,2,2056,2090,12
Task 2056,Job 1,14,6,1,9,0,15,23,8,1,3,2,2056,2090,2
Task 2057,Job 0,2,6,3,10,0,5,12,7,3,4,0,2057,2090,16
Task 2057,Job 1,7,9,4,6,1,11,13,2,4,3,1,2057,2090,18
Task 2058,Job 0,10,7,4,6,0,14,16,2,4,1,2,2058,2092,20
Task 2058,Job 1,15,4,3,6,0,18,21,3,3,1,1,2058,2092,14
Task 2059,Job 0,6,8,2,8,0,8,14,6,2,1,2,2059,2093,20
Task 2059,Job 1,11,4,2,8,0,13,19,6,2,3,2,2059,2093,20
Task 2060,Job 0,4,4,4,10,0,8,14,6,4,2,0,2060,2093,16
Task 2060,Job 1,9,4,3,7,1,12,16,4,3,1,0,2060,2093,9
Task 2061,Job 0,7,7,2,11,0,9,18,9,2,3,2,2061,2095,2
Task 2061,Job 1,12,4,2,7,0,14,19,5,2,1,2,2061,2095,7
Task 2062,Job 0,6,5,4,8,0,10,14,4,4,2,2,2062,2095,2
Task 2062,Job 1,11,10,3,12,1,14,23,9,3,4,1,2062,2095,3
Task 2063,Job 0,9,7,3,12,0,12,21,9,3,3,2,2063,2097,14
Task 2063,Job 1,14,10,4,6,1,18,20,2,4,3,1,2063,2097,5
Task 2064,Job 0,10,8,2,7,1,12,17,5,2,3,2,2064,2098,6
Task 2064,Job 1,15,6,2,11,0,17,26,9,2,3,1,2064,2098,9
Task 2065,Job 0,5,10,4,7,0,9,12,3,4,2,2,2065,2099,13
Task 2065,Job 1,10,5,2,11,1,12,21,9,2,2,0,2065,2099,15
Task 2066,Job 0,1,4,3,6,0,4,7,3,3,4,1,2066,2099,12
Task 2066,Job 1,6,6,4,7,1,10,13,3,4,3,1,2066,2099,2
Task 2067,Job 0,10,7,3,6,0,13,16,3,3,3,0,2067,2100,8
Task 2067,Job 1,15,10,2,9,0,17,24,7,2,2,0,2067,2100,8
Task 2068,Job 0,1,7,1,9,0,2,10,8,1,3,1,2068,2102,13
Task 2068,Job 1,6,7,4,11,0,10,17,7,4,3,0,2068,2102,6
Task 2069,Job 0,9,4,2,7,0,11,16,5,2,3,1,2069,2102,17
Task 2069,Job 1,14,6,1,9,1,15,23,8,1,2,1,2069,2102,2
Task 2070,Job 0,9,10,1,7,0,10,16,6,1,1,1,2070,2104,4
Task 2070,Job 1,14,4,3,10,0,17,24,7,3,3,2,2070,2104,15
Task 2071,Job 0,5,6,2,8,0,7,13,6,2,3,0,2071,2104,19
Task 2071,Job 1,10,8,1,10,0,11,20,9,1,4,2,2071,2104,6
Task 2072,Job 0,9,9,3,11,1,12,20,8,3,3,0,2072,2106,15
Task 2072,Job 1,14,7,1,10,0,15,24,9,1,4,1,2072,2106,9
Task 2073,Job 0,3,8,1,8,1,4,11,7,1,1,2,2073,2107,17
Task 2073,Job 1,8,7,3,9,0,11,17,6,3,2,2,2073,2107,12
Task 2074,Job 0,3,10,4,12,1,7,15,8,4,2,1,2074,2108,5
Task 2074,Job 1,8,10,4,10,0,12,18,6,4,3,2,2074,2108,13
Task 2075,Job 0,10,9,4,8,0,14,18,4,4,1,0,2075,2108,6
Task 2075,Job 1,15,8,2,8,0,17,23,6,2,2,0,2075,2108,12
Task 2076,Job 0,2,5,1,12,0,3,14,11,1,4,2,2076,2110,5
Task 2076,Job 1,7,10,2,8,1,9,15,6,2,1,2,2076,2110,4
Task 2077,Job 0,4,9,4,9,0,8,13,5,4,3,1,2077,2110,16
Task 2077,Job 1,9,8,2,9,0,11,18,7,2,4,2,2077,2110,12
Task 2078,Job 0,4,5,3,10,0,7,14,7,3,4,2,2078,2112,10
Task 2078,Job 1,9,6,3,6,0,12,15,3,3,4,0,2078,2112,2
Task 2079,Job 0,7,9,2,11,0,9,18,9,2,1,1,2079,2113,14
Task 2079,Job 1,12,4,2,10,0,14,22,8,2,3,1,2079,2113,2
Task 2080,Job 0,9,5,4,11,0,13,20,7,4,4,1,2080,2113,19
Task 2080,Job 1,14,9,3,12,1,17,26,9,3,3,0,2080,2113,4
Task 2081,Job 0,7,6,1,6,0,8,13,5,1,3,0,2081,2114,8
Task 2081,Job 1,12,4,4,9,0,16,21,5,4,4,2,2081,2114,15
Task 2082,Job 0,8,8,2,8,0,10,16,6,2,2,1,2082,2115,6
Task 2082,Job 1,13,7,4,11,0,17,24,7,4,1,2,2082,2115,8
Task 2083,Job 0,2,4,1,7,0,3,9,6,1,3,2,2083,2116,16
Task 2083,Job 1,7,9,1,7,0,8,14,6,1,2,0,2083,2116,3
Task 2084,Job 0,6,7,1,8,0,7,14,7,1,3,0,2084,2117,12
Task 2084,Job 1,11,5,2,8,0,13,19,6,2,2,0,2084,2117,2
Task 2085,Job 0,1,8,4,7,0,5,8,3,4,4,2,2085,2118,14
Task 2085,Job 1,6,4,3,10,1,9,16,7,3,4,1,2085,2118,18
Task 2086,Job 0,2,6,4,7,0,6,9,3,4,4,1,2086,2120,19
Task 2086,Job 1,7,4,3,8,1,10,15,5,3,3,0,2086,2120,3
Task 2087,Job 0,4,10,4,9,0,8,13,5,4,3,2,2087,2120,11
Task 2087,Job 1,9,6,4,12,0,13,21,8,4,2,0,2087,2120,12
Task 2088,Job 0,6,4,4,12,1,10,18,8,4,4,0,2088,2121,16
Task 2088,Job 1,11,5,4,11,1,15,22,7,4,2,0,2088,2121,8
Task 2089,Job 0,9,4,4,12,0,13,21,8,4,3,0,2089,2122,4
Task 2089,Job 1,14,4,1,11,0,15,25,10,1,3,2,2089,2122,2
Task 2090,Job 0,4,5,1,6,1,5,10,5,1,2,0,2090,2123,3
Task 2090,Job 1,9,8,4,9,0,13,18,5,4,3,1,2090,2123,17
Task 2091,Job 0,8,7,2,9,0,10,17,7,2,1,2,2091,2125,17
Task 2091,Job 1,13,10,2,8,0,15,21,6,2,3,2,2091,2125,13
Task 2092,Job 0,5,8,2,11,0,7,16,9,2,1,2,2092,2125,4
Task 2092,Job 1,10,10,2,6,1,12,16,4,2,4,2,2092,2125,7
Task 2093,Job 0,3,7,4,10,0,7,13,6,4,4,1,2093,2127,4
Task 2093,Job 1,8,8,4,8,0,12,16,4,4,4,1,2093,2127,14
Task 2094,Job 0,6,8,2,10,1,8,16,8,2,4,2,2094,2128,20
Task 2094,Job 1,11,8,3,11,1,14,22,8,3,2,2,2094,2128,17
Task 2095,Job 0,7,8,3,6,0,10,13,3,3,3,2,2095,2129,11
Task 2095,Job 1,12,10,1,6,0,13,18,5,1,4,2,2095,2129,15
Task 2096,Job 0,1,10,3,10,1,4,11,7,3,2,1,2096,2129,9
Task 2096,Job 1,6,7,4,12,0,10,18,8,4,4,0,2096,2129,8
Task 2097,Job 0,5,9,4,10,1,9,15,6,4,4,2,2097,2131,7
Task 2097,Job 1,10,9,3,6,0,13,16,3,3,1,1,2097,2131,8
Task 2098,Job 0,10,9,2,7,0,12,17,5,2,4,2,2098,2132,12
Task 2098,Job 1,15,7,3,12,0,18,27,9,3,4,0,2098,2132,18
Task 2099,Job 0,10,5,4,8,1,14,18,4,4,2,1,2099,2132,18
Task 2099,Job 1,15,8,1,6,0,16,21,5,1,4,0,2099,2132,18
Task 2100,Job 0,5,7,1,11,0,6,16,10,1,3,1,2100,2134,9
Task 2100,Job 1,10,7,4,8,0,14,18,4,4,3,0,2100,2134,10
Task 2101,Job 0,6,4,2,12,0,8,18,10,2,3,2,2101,2135,10
Task 2101,Job 1,11,5,4,6,1,15,17,2,4,3,1,2101,2135,2
Task 2102,Job 0,5,6,2,12,0,7,17,10,2,4,2,2102,2135,7
Task 2102,Job 1,10,7,3,8,1,13,18,5,3,2,0,2102,2135,10
Task 2103,Job 0,7,6,4,7,0,11,14,3,4,2,1,2103,2136,8
Task 2103,Job 1,12,10,4,8,0,16,20,4,4,1,0,2103,2136,12
Task 2104,Job 0,5,10,1,6,1,6,11,5,1,1,0,2104,2137,20
Task 2104,Job 1,10,7,4,11,0,14,21,7,4,3,0,2104,2137,19
Task 2105,Job 0,2,4,2,11,0,4,13,9,2,3,1,2105,2138,18
Task 2105,Job 1,7,9,3,7,0,10,14,4,3,1,1,2105,2138,20
Task 2106,Job 0,5,8,4,7,0,9,12,3,4,4,0,2106,2139,5
Task 2106,Job 1,10,6,1,6,0,11,16,5,1,3,0,2106,2139,6
Task 2107,Job 0,10,10,3,12,0,13,22,9,3,3,0,2107,2141,19
Task 2107,Job 1,15,8,2,11,1,17,26,9,2,2,2,2107,2141,20
Task 2108,Job 0,1,9,3,9,0,4,10,6,3,3,2,2108,2142,6
Task 2108,Job 1,6,8,1,10,0,7,16,9,1,3,1,2108,2142,20
Task 2109,Job 0,2,8,4,12,1,6,14,8,4,4,1,2109,2143,3
Task 2109,Job 1,7,10,3,11,0,10,18,8,3,4,2,2109,2143,3
Task 2110,Job 0,9,6,4,8,1,13,17,4,4,4,1,2110,2143,2
Task 2110,Job 1,14,10,3,7,0,17,21,4,3,3,0,2110,2143,6
Task 2111,Job 0,7,9,4,12,0,11,19,8,4,1,1,2111,2145,4
Task 2111,Job 1,12,6,2,9,0,14,21,7,2,1,2,2111,2145,18
Task 2112,Job 0,10,8,2,9,0,12,19,7,2,2,2,2112,2145,8
Task 2112,Job 1,15,6,1,11,0,16,26,10,1,4,1,2112,2145,2
Task 2113,Job 0,8,9,3,9,1,11,17,6,3,2,2,2113,2146,16
Task 2113,Job 1,13,10,3,7,0,16,20,4,3,1,2,2113,2146,12
Task 2114,Job 0,1,4,1,6,1,2,7,5,1,3,0,2114,2147,5
Task 2114,Job 1,6,4,2,6,1,8,12,4,2,4,2,2114,2147,19
Task 2115,Job 0,1,6,2,6,0,3,7,4,2,3,0,2115,2148,9
Task 2115,Job 1,6,4,1,11,0,7,17,10,1,1,1,2115,2148,16
Task 2116,Job 0,1,8,3,6,0,4,7,3,3,2,1,2116,2149,15
Task 2116,Job 1,6,7,4,12,1,10,18,8,4,4,0,2116,2149,9
Task 2117,Job 0,6,7,1,11,0,7,17,10,1,3,1,2117,2151,10
Task 2117,Job 1,11,8,1,7,0,12,18,6,1,1,2,2117,2151,8
Task 2118,Job 0,1,5,1,7,0,2,8,6,1,1,0,2118,2152,11
Task 2118,Job 1,6,8,1,7,0,7,13,6,1,2,1,2118,2152,11
Task 2119,Job 0,2,6,1,8,0,3,10,7,1,2,0,2119,2153,16
Task 2119,Job 1,7,7,4,11,0,11,18,7,4,2,1,2119,2153,18
Task 2120,Job 0,6,6,4,9,1,10,15,5,4,1,0,2120,2154,8
Task 2120,Job 1,11,10,3,8,0,14,19,5,3,2,0,2120,2154,13
Task 2121,Job 0,4,10,3,12,0,7,16,9,3,1,1,2121,2155,9
Task 2121,Job 1,9,9,1,11,0,10,20,10,1,3,2,2121,2155,16
Task 2122,Job 0,1,5,3,8,1,4,9,5,3,3,1,2122,2156,2
Task 2122,Job 1,6,5,4,7,0,10,13,3,4,3,0,2122,2156,5
Task 2123,Job 0,10,10,3,9,1,13,19,6,3,2,2,2123,2157,19
Task 2123,Job 1,15,7,2,7,0,17,22,5,2,3,2,2123,2157,20
Task 2124,Job 0,1,5,3,12,0,4,13,9,3,2,1,2124,2158,18
Task 2124,Job 1,6,10,2,12,0,8,18,10,2,4,1,2124,2158,17
Task 2125,Job 0,7,5,4,8,0,11,15,4,4,3,1,2125,2159,9
Task 2125,Job 1,12,6,2,10,1,14,22,8,2,1,1,2125,2159,3
Task 2126,Job 0,1,9,2,12,0,3,13,10,2,2,1,2126,2159,4
Task 2126,Job 1,6,8,3,8,0,9,14,5,3,3,0,2126,2159,12
Task 2127,Job 0,1,6,4,6,0,5,7,2,4,1,0,2127,2160,9
Task 2127,Job 1,6,4,3,6,1,9,12,3,3,4,0,2127,2160,15
Task 2128,Job 0,5,10,1,11,0,6,16,10,1,2,2,2128,2162,4
Task 2128,Job 1,10,5,2,9,0,12,19,7,2,4,1,2128,2162,14
Task 2129,Job 0,7,4,4,11,0,11,18,7,4,2,1,2129,2163,10
Task 2129,Job 1,12,10,3,8,0,15,20,5,3,1,1,2129,2163,9
Task 2130,Job 0,7,10,3,6,0,10,13,3,3,3,0,2130,2164,17
Task 2130,Job 1,12,7,2,8,0,14,20,6,2,4,0,2130,2164,2
Task 2131,Job 0,9,5,1,9,1,10,18,8,1,2,0,2131,2164,16
Task 2131,Job 1,14,8,2,7,1,16,21,5,2,1,2,2131,2164,17
Task 2132,Job 0,7,4,1,11,1,8,18,10,1,2,2,2132,2166,7
Task 2132,Job 1,12,8,1,7,1,13,19,6,1,1,2,2132,2166,11
Task 2133,Job 0,1,10,1,8,0,2,9,7,1,3,1,2133,2166,4
Task 2133,Job 1,6,10,2,11,0,8,17,9,2,3,1,2133,2166,14
Task 2134,Job 0,8,5,3,10,0,11,18,7,3,3,0,2134,2168,17
Task 2134,Job 1,13,8,1,10,0,14,23,9,1,2,0,2134,2168,4
Task 2135,Job 0,8,8,4,11,1,12,19,7,4,3,2,2135,2169,5
Task 2135,Job 1,13,8,1,12,1,14,25,11,1,1,0,2135,2169,18
Task 2136,Job 0,1,5,3,11,0,4,12,8,3,3,0,2136,2170,7
Task 2136,Job 1,6,8,4,8,1,10,14,4,4,1,2,2136,2170,10
Task 2137,Job 0,5,10,3,8,0,8,13,5,3,1,2,2137,2170,15
Task 2137,Job 1,10,5,4,10,0,14,20,6,4,1,1,2137,2170,6
Task 2138,Job 0,8,5,2,12,0,10,20,10,2,3,2,2138,2171,8
Task 2138,Job 1,13,4,1,7,0,14,20,6,1,4,0,2138,2171,10
Task 2139,Job 0,8,5,2,11,0,10,19,9,2,1,1,2139,2173,17
Task 2139,Job 1,13,5,3,11,0,16,24,8,3,3,2,2139,2173,11
Task 2140,Job 0,10,10,2,7,0,12,17,5,2,4,1,2140,2173,5
Task 2140,Job 1,15,4,1,6,0,16,21,5,1,4,2,2140,2173,15
Task 2141,Job 0,6,4,1,12,0,7,18,11,1,2,0,2141,2174,7
Task 2141,Job 1,11,7,3,10,0,14,21,7,3,3,2,2141,2174,14
Task 2142,Job 0,10,6,4,11,0,14,21,7,4,3,2,2142,2176,14
Task 2142,Job 1,15,8,4,6,0,19,21,2,4,2,0,2142,2176,17
Task 2143,Job 0,5,6,2,6,0,7,11,4,2,1,1,2143,2177,14
Task 2143,Job 1,10,7,4,7,0,14,17,3,4,4,1,2143,2177,2
Task 2144,Job 0,1,6,4,10,0,5,11,6,4,2,0,2144,2178,19
Task 2144,Job 1,6,8,1,12,0,7,18,11,1,4,2,2144,2178,13
Task 2145,Job 0,2,10,1,11,0,3,13,10,1,4,0,2145,2179,12
Task 2145,Job 1,7,4,1,11,1,8,18,10,1,3,2,2145,2179,12
Task 2146,Job 0,4,7,4,8,1,8,12,4,4,2,0,2146,2180,6
Task 2146,Job 1,9,10,3,8,0,12,17,5,3,4,2,2146,2180,5
Task 2147,Job 0,5,5,3,12,0,8,17,9,3,4,0,2147,2180,13
Task 2147,Job 1,10,8,2,12,1,12,22,10,2,3,2,2147,2180,14
Task 2148,Job 0,4,8,1,9,0,5,13,8,1,2,2,2148,2181,13
Task 2148,Job 1,9,9,2,6,0,11,15,4,2,2,2,2148,2181,15
Task 2149,Job 0,1,6,3,12,1,4,13,9,3,4,1,2149,2183,3
Task 2149,Job 1,6,10,3,10,0,9,16,7,3,3,1,2149,2183,8
Task 2150,Job 0,2,10,1,11,1,3,13,10,1,2,2,2150,2183,19
Task 2150,Job 1,7,4,1,11,0,8,18,10,1,2,2,2150,2183,15
Task 2151,Job 0,10,10,1,12,0,11,22,11,1,1,1,2151,2185,4
Task 2151,Job 1,15,8,4,10,1,19,25,6,4,4,1,2151,2185,16
Task 2152,Job 0,3,6,1,8,0,4,11,7,1,2,0,2152,2186,2
Task 2152,Job 1,8,6,1,6,0,9,14,5,1,1,1,2152,2186,18
Task 2153,Job 0,9,9,1,6,1,10,15,5,1,4,0,2153,2186,16
Task 2153,Job 1,14,8,3,7,0,17,21,4,3,2,2,2153,2186,5
Task 2154,Job 0,5,8,3,11,0,8,16,8,3,4,0,2154,2187,2
Task 2154,Job 1,10,9,4,6,0,14,16,2,4,3,2,2154,2187,20
Task 2155,Job 0,5,5,4,12,0,9,17,8,4,4,1,2155,2189,20
Task 2155,Job 1,10,4,2,10,0,12,20,8,2,2,0,2155,2189,12
Task 2156,Job 0,2,10,3,9,0,5,11,6,3,3,1,2156,2189,16
Task 2156,Job 1,7,9,1,12,0,8,19,11,1,3,2,2156,2189,14
Task 2157,Job 0,9,7,4,12,0,13,21,8,4,3,0,2157,2190,9
Task 2157,Job 1,14,7,2,8,0,16,22,6,2,3,0,2157,2190,11
Task 2158,Job 0,1,4,2,12,0,3,13,10,2,1,2,2158,2192,19
Task 2158,Job 1,6,5,3,8,1,9,14,5,3,4,0,2158,2192,17
Task 2159,Job 0,9,5,1,9,0,10,18,8,1,4,0,2159,2192,11
Task 2159,Job 1,14,7,3,9,0,17,23,6,3,3,2,2159,2192,8
Task 2160,Job 0,5,6,1,10,0,6,15,9,1,4,0,2160,2193,3
Task 2160,Job 1,10,8,4,8,0,14,18,4,4,4,0,2160,2193,4
Task 2161,Job 0,9,8,3,11,0,12,20,8,3,4,1,2161,2194,4
Task 2161,Job 1,14,9,2,9,1,16,23,7,2,3,0,2161,2194,3
Task 2162,Job 0,10,9,4,9,0,14,19,5,4,3,2,2162,2196,19
Task 2162,Job 1,15,9,3,6,0,18,21,3,3,3,0,2162,2196,2
Task 2163,Job 0,6,5,3,10,0,9,16,7,3,4,1,2163,2196,8
Task 2163,Job 1,11,4,2,8,0,13,19,6,2,4,1,2163,2196,11
Task 2164,Job 0,3,5,1,9,1,4,12,8,1,1,0,2164,2198,2
Task 2164,Job 1,8,8,1,10,0,9,18,9,1,4,1,2164,2198,12
Task 2165,Job 0,10,5,1,7,1,11,17,6,1,4,1,2165,2198,9
Task 2165,Job 1,15,8,3,6,0,18,21,3,3,1,0,2165,2198,2
Task 2166,Job 0,9,6,3,11,0,12,20,8,3,4,2,2166,2200,6
Task 2166,Job 1,14,5,1,9,1,15,23,8,1,3,0,2166,2200,6
Task 2167,Job 0,8,5,1,11,1,9,19,10,1,2,0,2167,2200,18
Task 2167,Job 1,13,10,2,7,1,15,20,5,2,4,0,2167,2200,13
Task 2168,Job 0,10,9,1,12,0,11,22,11,1,2,2,2168,2201,20
Task 2168,Job 1,15,9,2,11,0,17,26,9,2,3,2,2168,2201,16
Task 2169,Job 0,8,5,2,9,0,10,17,7,2,2,0,2169,2202,4
Task 2169,Job 1,13,5,3,9,0,16,22,6,3,3,2,2169,2202,14
Task 2170,Job 0,10,10,1,7,0,11,17,6,1,4,0,2170,2203,6
Task 2170,Job 1,15,8,3,6,1,18,21,3,3,2,2,2170,2203,8
Task 2171,Job 0,5,9,3,10,0,8,15,7,3,4,1,2171,2205,7
Task 2171,Job 1,10,4,3,10,0,13,20,7,3,2,2,2171,2205,19
Task 2172,Job 0,2,6,1,11,0,3,13,10,1,4,2,2172,2205,11
Task 2172,Job 1,7,5,3,10,1,10,17,7,3,3,0,2172,2205,17
Task 2173,Job 0,8,10,1,6,0,9,14,5,1,1,1,2173,2207,14
Task 2173,Job 1,13,9,3,7,1,16,20,4,3,4,0,2173,2207,3
Task 2174,Job 0,9,10,2,8,0,11,17,6,2,2,2,2174,2207,17
Task 2174,Job 1,14,9,2,8,0,16,22,6,2,1,0,2174,2207,14
Task 2175,Job 0,4,5,1,7,1,5,11,6,1,2,0,2175,2209,14
Task 2175,Job 1,9,4,1,6,1,10,15,5,1,4,2,2175,2209,10
Task 2176,Job 0,6,10,3,7,0,9,13,4,3,4,2,2176,2209,3
Task 2176,Job 1,11,6,1,12,0,12,23,11,1,3,1,2176,2209,9
Task 2177,Job 0,5,9,4,9,0,9,14,5,4,4,0,2177,2210,14
Task 2177,Job 1,10,5,4,9,0,14,19,5,4,1,1,2177,2210,12
Task 2178,Job 0,7,5,3,9,0,10,16,6,3,3,1,2178,2211,5
Task 2178,Job 1,12,6,2,10,0,14,22,8,2,2,0,2178,2211,17
Task 2179,Job 0,1,7,4,9,1,5,10,5,4,1,1,2179,2213,8
Task 2179,Job 1,6,6,3,10,0,9,16,7,3,4,0,2179,2213,12
Task 2180,Job 0,4,5,1,11,0,5,15,10,1,3,1,2180,2213,6
Task 2180,Job 1,9,10,4,10,0,13,19,6,4,4,1,2180,2213,19
Task 2181,Job 0,2,4,3,11,0,5,13,8,3,2,0,2181,2214,11
Task 2181,Job 1,7,6,2,10,0,9,17,8,2,1,0,2181,2214,17
Task 2182,Job 0,9,7,2,12,0,11,21,10,2,1,0,2182,2216,16
Task 2182,Job 1,14,6,3,12,1,17,26,9,3,2,2,2182,2216,17
Task 2183,Job 0,2,6,1,7,1,3,9,6,1,1,0,2183,2217,13
Task 2183,Job 1,7,5,2,9,0,9,16,7,2,1,1,2183,2217,5
Task 2184,Job 0,9,8,4,7,0,13,16,3,4,2,1,2184,2218,2
Task 2184,Job 1,14,10,1,7,0,15,21,6,1,4,0,2184,2218,9
Task 2185,Job 0,7,4,2,7,1,9,14,5,2,1,2,2185,2218,18
Task 2185,Job 1,12,8,4,8,0,16,20,4,4,1,2,2185,2218,7
Task 2186,Job 0,5,9,4,9,0,9,14,5,4,1,2,2186,2220,13
Task 2186,Job 1,10,9,3,12,1,13,22,9,3,1,1,2186,2220,15
Task 2187,Job 0,4,6,2,9,0,6,13,7,2,3,2,2187,2221,15
Task 2187,Job 1,9,5,2,12,0,11,21,10,2,2,1,2187,2221,19
Task 2188,Job 0,2,4,3,6,0,5,8,3,3,3,0,2188,2222,15
Task 2188,Job 1,7,7,1,7,0,8,14,6,1,3,1,2188,2222,17
Task 2189,Job 0,6,4,1,6,0,7,12,5,1,1,1,2189,2223,4
Task 2189,Job 1,11,5,1,11,0,12,22,10,1,4,1,2189,2223,20
Task 2190,Job 0,6,8,2,9,0,8,15,7,2,1,1,2190,2224,11
Task 2190,Job 1,11,4,2,11,0,13,22,9,2,2,0,2190,2224,2
Task 2191,Job 0,5,10,4,9,0,9,14,5,4,4,2,2191,2225,2
Task 2191,Job 1,10,7,2,9,0,12,19,7,2,1,2,2191,2225,12
Task 2192,Job 0,1,6,4,11,0,5,12,7,4,4,0,2192,2225,4
Task 2192,Job 1,6,7,4,6,0,10,12,2,4,2,1,2192,2225,11
Task 2193,Job 0,6,4,1,8,0,7,14,7,1,2,0,2193,2227,13
Task 2193,Job 1,11,5,1,12,0,12,23,11,1,1,1,2193,2227,20
Task 2194,Job 0,5,6,1,11,1,6,16,10,1,1,2,2194,2228,13
Task 2194,Job 1,10,6,2,9,0,12,19,7,2,4,2,2194,2228,12
Task 2195,Job 0,7,8,2,7,1,9,14,5,2,1,1,2195,2229,15
Task 2195,Job 1,12,7,2,11,0,14,23,9,2,4,2,2195,2229,16
Task 2196,Job 0,4,4,3,9,1,7,13,6,3,2,0,2196,2229,4
Task 2196,Job 1,9,6,4,6,0,13,15,2,4,2,2,2196,2229,10
Task 2197,Job 0,1,7,3,8,0,4,9,5,3,3,0,2197,2231,15
Task 2197,Job 1,6,8,2,7,0,8,13,5,2,4,1,2197,2231,2
Task 2198,Job 0,8,9,1,8,1,9,16,7,1,4,0,2198,2231,7
Task 2198,Job 1,13,9,2,10,0,15,23,8,2,2,1,2198,2231,2
Task 2199,Job 0,10,6,1,8,0,11,18,7,1,2,2,2199,2232,5
Task 2199,Job 1,15,6,2,9,0,17,24,7,2,3,0,2199,2232,7
Task 2200,Job 0,3,4,4,9,0,7,12,5,4,3,1,2200,2233,3
Task 2200,Job 1,8,10,3,10,0,11,18,7,3,1,1,2200,2233,5
Task 2201,Job 0,7,10,1,10,1,8,17,9,1,1,2,2201,2235,9
Task 2201,Job 1,12,5,4,12,1,16,24,8,4,1,0,2201,2235,20
Task 2202,Job 0,9,8,1,6,0,10,15,5,1,1,1,2202,2236,8
Task 2202,Job 1,14,9,4,7,0,18,21,3,4,4,1,2202,2236,18
Task 2203,Job 0,6,10,4,7,0,10,13,3,4,2,1,2203,2237,2
Task 2203,Job 1,11,8,1,9,0,12,20,8,1,4,2,2203,2237,9
Task 2204,Job 0,3,10,2,8,0,5,11,6,2,2,0,2204,2237,15
Task 2204,Job 1,8,10,2,8,0,10,16,6,2,1,0,2204,2237,5
Task 2205,Job 0,3,5,2,6,0,5,9,4,2,2,2,2205,2238,16
Task 2205,Job 1,8,7,2,8,0,10,16,6,2,3,2,2205,2238,15
Task 2206,Job 0,7,4,3,9,0,10,16,6,3,1,2,2206,2240,4
Task 2206,Job 1,12,6,4,8,0,16,20,4,4,3,0,2206,2240,5
Task 2207,Job 0,6,6,2,8,0,8,14,6,2,2,0,2207,2241,20
Task 2207,Job 1,11,4,4,6,0,15,17,2,4,1,2,2207,2241,3
Task 2208,Job 0,8,9,1,10,0,9,18,9,1,3,0,2208,2242,18
Task 2208,Job 1,13,6,1,7,1,14,20,6,1,1,2,2208,2242,6
Task 2209,Job 0,4,10,2,10,0,6,14,8,2,4,0,2209,2243,17
Task 2209,Job 1,9,8,3,7,0,12,16,4,3,4,0,2209,2243,6
Task 2210,Job 0,2,9,1,8,0,3,10,7,1,1,0,2210,2244,9
Task 2210,Job 1,7,7,2,12,0,9,19,10,2,3,1,2210,2244,6
Task 2211,Job 0,5,10,4,9,0,9,14,5,4,3,1,2211,2245,6
Task 2211,Job 1,10,5,2,9,1,12,19,7,2,1,1,2211,2245,20
Task 2212,Job 0,5,5,4,9,0,9,14,5,4,2,0,2212,2246,15
Task 2212,Job 1,10,9,3,8,1,13,18,5,3,3,1,2212,2246,4
Task 2213,Job 0,5,6,1,7,1,6,12,6,1,4,2,2213,2246,7
Task 2213,Job 1,10,5,1,11,0,11,21,10,1,3,2,2213,2246,5
Task 2214,Job 0,6,4,1,8,1,7,14,7,1,4,1,2214,2247,19
Task 2214,Job 1,11,10,3,10,1,14,21,7,3,3,2,2214,2247,16
Task 2215,Job 0,8,8,2,12,1,10,20,10,2,4,1,2215,2248,5
Task 2215,Job 1,13,10,3,12,1,16,25,9,3,3,2,2215,2248,2
Task 2216,Job 0,1,4,4,6,1,5,7,2,4,2,2,2216,2249,14
Task 2216,Job 1,6,7,4,7,1,10,13,3,4,1,0,2216,2249,13
Task 2217,Job 0,4,8,4,11,0,8,15,7,4,4,1,2217,2250,19
Task 2217,Job 1,9,6,4,8,0,13,17,4,4,1,0,2217,2250,8
Task 2218,Job 0,5,4,4,9,1,9,14,5,4,1,0,2218,2252,7
Task 2218,Job 1,10,4,3,11,0,13,21,8,3,4,2,2218,2252,2
Task 2219,Job 0,1,8,3,6,0,4,7,3,3,2,2,2219,2253,20
Task 2219,Job 1,6,7,3,10,1,9,16,7,3,4,2,2219,2253,9
Task 2220,Job 0,4,5,1,10,0,5,14,9,1,2,2,2220,2254,16
Task 2220,Job 1,9,9,2,8,0,11,17,6,2,3,2,2220,2254,6
Task 2221,Job 0,10,10,4,11,0,14,21,7,4,4,2,2221,2254,5
Task 2221,Job 1,15,8,3,12,0,18,27,9,3,2,1,2221,2254,3
Task 2222,Job 0,9,10,4,6,1,13,15,2,4,3,0,2222,2256,5
Task 2222,Job 1,14,6,1,7,0,15,21,6,1,1,2,2222,2256,13
Task 2223,Job 0,7,10,1,10,0,8,17,9,1,1,2,2223,2256,5
Task 2223,Job 1,12,9,1,8,1,13,20,7,1,1,1,2223,2256,17
Task 2224,Job 0,1,8,1,11,0,2,12,10,1,3,0,2224,2257,15
Task 2224,Job 1,6,7,4,6,0,10,12,2,4,2,0,2224,2257,16
Task 2225,Job 0,9,7,4,6,0,13,15,2,4,2,0,2225,2258,5
Task 2225,Job 1,14,4,1,12,0,15,26,11,1,1,2,2225,2258,14
Task 2226,Job 0,2,10,4,8,0,6,10,4,4,2,1,2226,2259,7
Task 2226,Job 1,7,9,2,9,1,9,16,7,2,4,2,2226,2259,4
Task 2227,Job 0,10,4,2,10,0,12,20,8,2,2,1,2227,2260,2
Task 2227,Job 1,15,4,1,11,0,16,26,10,1,1,2,2227,2260,4
Task 2228,Job 0,10,5,3,8,0,13,18,5,3,3,0,2228,2261,17
Task 2228,Job 1,15,4,2,8,0,17,23,6,2,1,0,2228,2261,8
Task 2229,Job 0,4,8,3,10,0,7,14,7,3,4,0,2229,2262,5
Task 2229,Job 1,9,6,3,9,0,12,18,6,3,2,1,2229,2262,14
Task 2230,Job 0,8,10,1,11,0,9,19,10,1,2,1,2230,2263,10
Task 2230,Job 1,13,10,2,6,0,15,19,4,2,2,2,2230,2263,5
Task 2231,Job 0,8,7,3,11,0,11,19,8,3,3,0,2231,2264,9
Task 2231,Job 1,13,6,1,10,0,14,23,9,1,1,1,2231,2264,15
Task 2232,Job 0,6,9,4,9,0,10,15,5,4,2,2,2232,2266,15
Task 2232,Job 1,11,7,4,10,0,15,21,6,4,1,1,2232,2266,10
Task 2233,Job 0,2,8,1,8,1,3,10,7,1,3,0,2233,2267,19
Task 2233,Job 1,7,10,2,8,0,9,15,6,2,2,1,2233,2267,4
Task 2234,Job 0,6,8,2,12,0,8,18,10,2,4,0,2234,2268,6
Task 2234,Job 1,11,8,2,11,0,13,22,9,2,2,0,2234,2268,3
Task 2235,Job 0,1,6,3,12,0,4,13,9,3,1,0,2235,2268,19
Task 2235,Job 1,6,7,4,7,0,10,13,3,4,4,2,2235,2268,5
Task 2236,Job 0,2,4,4,6,0,6,8,2,4,3,2,2236,2269,19
Task 2236,Job 1,7,10,4,8,0,11,15,4,4,2,1,2236,2269,7
Task 2237,Job 0,2,6,3,10,0,5,12,7,3,1,1,2237,2271,7
Task 2237,Job 1,7,5,2,9,0,9,16,7,2,3,0,2237,2271,20
Task 2238,Job 0,1,6,2,12,1,3,13,10,2,3,1,2238,2271,2
Task 2238,Job 1,6,4,1,11,0,7,17,10,1,1,0,2238,2271,18
Task 2239,Job 0,10,6,3,11,0,13,21,8,3,4,2,2239,2273,7
Task 2239,Job 1,15,10,3,8,0,18,23,5,3,1,1,2239,2273,2
Task 2240,Job 0,6,6,4,12,1,10,18,8,4,4,2,2240,2273,8
Task 2240,Job 1,11,7,3,12,1,14,23,9,3,2,2,2240,2273,15
Task 2241,Job 0,8,5,1,12,0,9,20,11,1,1,0,2241,2275,12
Task 2241,Job 1,13,9,3,10,0,16,23,7,3,3,2,2241,2275,4
Task 2242,Job 0,1,8,1,10,1,2,11,9,1,1,0,2242,2275,20
Task 2242,Job 1,6,6,3,6,0,9,12,3,3,3,2,2242,2275,3
Task 2243,Job 0,10,7,3,7,1,13,17,4,3,1,0,2243,2276,18
Task 2243,Job 1,15,10,4,12,0,19,27,8,4,3,2,2243,2276,18
Task 2244,Job 0,6,5,2,10,0,8,16,8,2,1,1,2244,2278,3
Task 2244,Job 1,11,10,4,6,0,15,17,2,4,2,0,2244,2278,9
Task 2245,Job 0,4,7,3,11,0,7,15,8,3,4,0,2245,2278,18
Task 2245,Job 1,9,8,3,6,0,12,15,3,3,2,2,2245,2278,18
Task 2246,Job 0,2,6,1,6,0,3,8,5,1,4,1,2246,2279,2
Task 2246,Job 1,7,7,1,8,1,8,15,7,1,4,2,2246,2279,3
Task 2247,Job 0,5,8,4,7,0,9,12,3,4,3,2,2247,2280,8
Task 2247,Job 1,10,4,4,8,0,14,18,4,4,4,1,2247,2280,13
Task 2248,Job 0,5,10,1,10,1,6,15,9,1,4,1,2248,2282,4
Task 2248,Job 1,10,6,3,9,0,13,19,6,3,4,1,2248,2282,18
Task 2249,Job 0,9,10,2,8,1,11,17,6,2,2,0,2249,2283,8
Task 2249,Job 1,14,9,1,10,0,15,24,9,1,4,2,2249,2283,7
Task 2250,Job 0,1,10,4,7,0,5,8,3,4,1,1,2250,2284,2
Task 2250,Job 1,6,10,4,6,0,10,12,2,4,1,2,2250,2284,4
Task 2251,Job 0,5,7,2,12,0,7,17,10,2,3,2,2251,2284,7
Task 2251,Job 1,10,5,1,12,0,11,22,11,1,2,2,2251,2284,19
Task 2252,Job 0,7,9,4,9,1,11,16,5,4,4,0,2252,2286,11
Task 2252,Job 1,12,9,4,8,0,16,20,4,4,4,0,2252,2286,13
Task 2253,Job 0,4,5,2,11,0,6,15,9,2,3,1,2253,2287,9
Task 2253,Job 1,9,9,1,7,1,10,16,6,1,3,0,2253,2287,13
Task 2254,Job 0,7,10,2,10,0,9,17,8,2,3,1,2254,2287,16
Task 2254,Job 1,12,5,1,12,0,13,24,11,1,4,1,2254,2287,7
Task 2255,Job 0,6,10,1,10,0,7,16,9,1,2,0,2255,2289,6
Task 2255,Job 1,11,10,1,8,0,12,19,7,1,2,2,2255,2289,9
Task 2256,Job 0,5,5,1,6,0,6,11,5,1,1,0,2256,2290,7
Task 2256,Job 1,10,6,1,10,0,11,20,9,1,3,0,2256,2290,13
Task 2257,Job 0,5,5,2,7,0,7,12,5,2,3,0,2257,2291,20
Task 2257,Job 1,10,7,3,9,1,13,19,6,3,2,0,2257,2291,14
Task 2258,Job 0,9,7,3,8,0,12,17,5,3,4,2,2258,2291,6
Task 2258,Job 1,14,9,4,11,0,18,25,7,4,4,2,2258,2291,17
Task 2259,Job 0,2,8,4,10,0,6,12,6,4,4,2,2259,2293,3
Task 2259,Job 1,7,5,4,10,0,11,17,6,4,4,2,2259,2293,16
Task 2260,Job 0,6,9,2,12,1,8,18,10,2,3,2,2260,2293,4
Task 2260,Job 1,11,10,2,7,0,13,18,5,2,4,1,2260,2293,12
Task 2261,Job 0,3,10,2,10,1,5,13,8,2,4,2,2261,2294,4
Task 2261,Job 1,8,6,1,7,0,9,15,6,1,3,2,2261,2294,10
Task 2262,Job 0,8,10,4,8,0,12,16,4,4,2,2,2262,2296,18
Task 2262,Job 1,13,4,2,6,1,15,19,4,2,3,0,2262,2296,19
Task 2263,Job 0,3,6,3,7,0,6,10,4,3,3,2,2263,2297,3
Task 2263,Job 1,8,7,2,7,1,10,15,5,2,4,2,2263,2297,10
Task 2264,Job 0,5,7,1,9,0,6,14,8,1,2,1,2264,2297,8
Task 2264,Job 1,10,8,1,9,1,11,19,8,1,1,1,2264,2297,12
Task 2265,Job 0,2,4,4,7,0,6,9,3,4,3,0,2265,2299,7
Task 2265,Job 1,7,10,2,10,0,9,17,8,2,3,0,2265,2299,15
Task 2266,Job 0,9,10,3,7,0,12,16,4,3,3,1,2266,2300,2
Task 2266,Job 1,14,8,3,6,0,17,20,3,3,2,0,2266,2300,13
Task 2267,Job 0,7,9,4,7,0,11,14,3,4,1,1,2267,2301,4
Task 2267,Job 1,12,10,3,9,0,15,21,6,3,4,1,2267,2301,14
Task 2268,Job 0,4,6,4,9,1,8,13,5,4,3,0,2268,2301,18
Task 2268,Job 1,9,5,2,11,0,11,20,9,2,1,0,2268,2301,11
Task 2269,Job 0,7,6,2,12,0,9,19,10,2,4,1,2269,2303,7
Task 2269,Job 1,12,9,1,8,0,13,20,7,1,4,0,2269,2303,4
Task 2270,Job 0,10,4,1,8,0,11,18,7,1,2,0,2270,2304,6
Task 2270,Job 1,15,10,4,7,0,19,22,3,4,2,1,2270,2304,15
Task 2271,Job 0,4,9,1,7,0,5,11,6,1,2,1,2271,2304,13
Task 2271,Job 1,9,8,4,10,1,13,19,6,4,3,2,2271,2304,7
Task 2272,Job 0,3,4,2,8,1,5,11,6,2,2,0,2272,2306,19
Task 2272,Job 1,8,6,1,8,0,9,16,7,1,3,0,2272,2306,17
Task 2273,Job 0,9,7,2,7,0,11,16,5,2,3,2,2273,2307,10
Task 2273,Job 1,14,6,1,6,0,15,20,5,1,3,2,2273,2307,6
Task 2274,Job 0,5,10,4,7,0,9,12,3,4,2,0,2274,2307,18
Task 2274,Job 1,10,9,1,12,0,11,22,11,1,4,2,2274,2307,7
Task 2275,Job 0,5,5,1,6,0,6,11,5,1,1,0,2275,2308,11
Task 2275,Job 1,10,5,2,7,0,12,17,5,2,3,2,2275,2308,15
Task 2276,Job 0,7,9,4,12,0,11,19,8,4,3,1,2276,2309,15
Task 2276,Job 1,12,9,3,8,1,15,20,5,3,4,1,2276,2309,2
Task 2277,Job 0,9,5,3,9,0,12,18,6,3,1,1,2277,2311,3
Task 2277,Job 1,14,4,1,12,1,15,26,11,1,3,2,2277,2311,8
Task 2278,Job 0,1,8,1,12,0,2,13,11,1,4,1,2278,2311,13
Task 2278,Job 1,6,8,3,9,1,9,15,6,3,4,0,2278,2311,4
Task 2279,Job 0,2,8,3,7,1,5,9,4,3,3,2,2279,2312,19
Task 2279,Job 1,7,5,1,6,1,8,13,5,1,3,1,2279,2312,11
Task 2280,Job 0,6,9,3,6,0,9,12,3,3,4,1,2280,2314,20
Task 2280,Job 1,11,4,3,8,0,14,19,5,3,4,1,2280,2314,7
Task 2281,Job 0,10,4,2,8,1,12,18,6,2,2,0,2281,2314,10
Task 2281,Job 1,15,8,1,10,1,16,25,9,1,2,1,2281,2314,14
Task 2282,Job 0,10,8,4,6,0,14,16,2,4,4,1,2282,2315,10
Task 2282,Job 1,15,7,1,12,0,16,27,11,1,4,0,2282,2315,18
Task 2283,Job 0,4,6,3,11,0,7,15,8,3,4,2,2283,2317,6
Task 2283,Job 1,9,9,1,11,0,10,20,10,1,3,1,2283,2317,5
Task 2284,Job 0,1,6,1,7,1,2,8,6,1,3,1,2284,2317,12
Task 2284,Job 1,6,9,2,6,0,8,12,4,2,2,2,2284,2317,5
Task 2285,Job 0,6,7,3,7,1,9,13,4,3,4,2,2285,2319,18
Task 2285,Job 1,11,9,1,10,0,12,21,9,1,1,1,2285,2319,6
Task 2286,Job 0,9,9,4,10,1,13,19,6,4,2,2,2286,2320,13
Task 2286,Job 1,14,5,4,11,0,18,25,7,4,2,2,2286,2320,20
Task 2287,Job 0,2,8,4,11,0,6,13,7,4,2,1,2287,2321,10
Task 2287,Job 1,7,6,1,12,0,8,19,11,1,3,1,2287,2321,13
Task 2288,Job 0,2,8,2,10,0,4,12,8,2,1,2,2288,2321,19
Task 2288,Job 1,7,9,3,12,0,10,19,9,3,1,2,2288,2321,14
Task 2289,Job 0,1,6,4,10,0,5,11,6,4,2,1,2289,2323,9
Task 2289,Job 1,6,10,2,11,1,8,17,9,2,3,0,2289,2323,12
Task 2290,Job 0,10,6,4,12,0,14,22,8,4,3,0,2290,2324,3
Task 2290,Job 1,15,9,4,10,0,19,25,6,4,1,1,2290,2324,17
Task 2291,Job 0,2,9,2,10,1,4,12,8,2,3,0,2291,2324,10
Task 2291,Job 1,7,9,2,9,1,9,16,7,2,1,2,2291,2324,13
Task 2292,Job 0,9,10,3,9,1,12,18,6,3,3,1,2292,2325,16
Task 2292,Job 1,14,6,2,12,0,16,26,10,2,4,2,2292,2325,16
Task 2293,Job 0,4,6,3,6,0,7,10,3,3,2,0,2293,2326,17
Task 2293,Job 1,9,9,3,8,1,12,17,5,3,4,1,2293,2326,10
Task 2294,Job 0,2,5,1,6,0,3,8,5,1,4,1,2294,2327,3
Task 2294,Job 1,7,9,1,12,0,8,19,11,1,2,1,2294,2327,9
Task 2295,Job 0,1,4,1,10,0,2,11,9,1,2,0,2295,2329,20
Task 2295,Job 1,6,8,1,11,0,7,17,10,1,4,2,2295,2329,18
Task 2296,Job 0,10,8,3,8,0,13,18,5,3,3,0,2296,2329,18
Task 2296,Job 1,15,8,3,8,0,18,23,5,3,2,1,2296,2329,13
Task 2297,Job 0,3,4,1,7,1,4,10,6,1,1,0,2297,2330,8
Task 2297,Job 1,8,8,3,10,0,11,18,7,3,4,1,2297,2330,5
Task 2298,Job 0,2,6,1,9,0,3,11,8,1,1,2,2298,2332,15
Task 2298,Job 1,7,6,3,8,0,10,15,5,3,2,2,2298,2332,2
Task 2299,Job 0,7,5,2,12,0,9,19,10,2,3,2,2299,2332,19
Task 2299,Job 1,12,8,2,11,0,14,23,9,2,1,0,2299,2332,10
Task 2300,Job 0,8,6,3,11,0,11,19,8,3,3,1,2300,2334,16
Task 2300,Job 1,13,8,4,9,0,17,22,5,4,3,0,2300,2334,6
Task 2301,Job 0,8,10,3,10,0,11,18,7,3,1,2,2301,2334,11
Task 2301,Job 1,13,4,2,10,0,15,23,8,2,4,0,2301,2334,4
Task 2302,Job 0,9,5,4,12,0,13,21,8,4,1,1,2302,2335,15
Task 2302,Job 1,14,7,4,6,0,18,20,2,4,1,1,2302,2335,16
Task 2303,Job 0,9,5,2,7,0,11,16,5,2,1,1,2303,2337,10
Task 2303,Job 1,14,10,1,9,1,15,23,8,1,1,1,2303,2337,5
Task 2304,Job 0,2,6,3,7,0,5,9,4,3,3,0,2304,2337,19
Task 2304,Job 1,7,7,3,7,0,10,14,4,3,1,0,2304,2337,20
Task 2305,Job 0,7,4,4,6,0,11,13,2,4,3,0,2305,2338,19
Task 2305,Job 1,12,5,1,6,0,13,18,5,1,4,0,2305,2338,2
Task 2306,Job 0,2,9,4,8,0,6,10,4,4,2,0,2306,2339,13
Task 2306,Job 1,7,5,2,9,0,9,16,7,2,3,2,2306,2339,16
Task 2307,Job 0,5,9,3,12,1,8,17,9,3,1,1,2307,2341,20
Task 2307,Job 1,10,4,2,7,0,12,17,5,2,3,2,2307,2341,4
Task 2308,Job 0,6,10,3,10,0,9,16,7,3,4,0,2308,2342,12
Task 2308,Job 1,11,7,2,9,1,13,20,7,2,3,0,2308,2342,7
Task 2309,Job 0,1,8,1,8,0,2,9,7,1,2,0,2309,2342,18
Task 2309,Job 1,6,6,3,12,1,9,18,9,3,3,1,2309,2342,17
Task 2310,Job 0,2,6,4,12,1,6,14,8,4,1,0,2310,2344,8
Task 2310,Job 1,7,6,2,8,0,9,15,6,2,4,1,2310,2344,20
Task 2311,Job 0,3,9,3,12,0,6,15,9,3,3,1,2311,2345,9
Task 2311,Job 1,8,6,3,8,1,11,16,5,3,3,1,2311,2345,9
Task 2312,Job 0,10,7,2,10,1,12,20,8,2,1,0,2312,2346,15
Task 2312,Job 1,15,10,3,9,0,18,24,6,3,4,1,2312,2346,4
Task 2313,Job 0,4,10,1,6,0,5,10,5,1,3,1,2313,2347,14
Task 2313,Job 1,9,6,3,10,1,12,19,7,3,4,2,2313,2347,12
Task 2314,Job 0,3,4,2,8,1,5,11,6,2,3,1,2314,2347,8
Task 2314,Job 1,8,6,1,8,1,9,16,7,1,3,2,2314,2347,18
Task 2315,Job 0,10,8,1,10,0,11,20,9,1,2,0,2315,2349,20
Task 2315,Job 1,15,10,2,8,0,17,23,6,2,2,0,2315,2349,19
Task 2316,Job 0,4,9,2,12,0,6,16,10,2,2,0,2316,2350,9
Task 2316,Job 1,9,9,1,12,1,10,21,11,1,1,1,2316,2350,3
Task 2317,Job 0,8,10,4,9,1,12,17,5,4,1,2,2317,2350,10
Task 2317,Job 1,13,6,2,9,0,15,22,7,2,2,0,2317,2350,19
Task 2318,Job 0,5,7,2,8,0,7,13,6,2,1,0,2318,2352,5
Task 2318,Job 1,10,8,3,10,0,13,20,7,3,4,0,2318,2352,9
Task 2319,Job 0,8,10,1,7,1,9,15,6,1,1,0,2319,2352,2
Task 2319,Job 1,13,9,3,6,1,16,19,3,3,1,1,2319,2352,15
Task 2320,Job 0,8,10,3,8,0,11,16,5,3,3,1,2320,2354,5
Task 2320,Job 1,13,10,2,12,0,15,25,10,2,3,0,2320,2354,2
Task 2321,Job 0,8,7,2,8,1,10,16,6,2,2,0,2321,2354,20
Task 2321,Job 1,13,7,4,8,1,17,21,4,4,1,2,2321,2354,14
Task 2322,Job 0,3,10,3,10,0,6,13,7,3,3,0,2322,2356,6
Task 2322,Job 1,8,9,4,6,0,12,14,2,4,1,0,2322,2356,20
Task 2323,Job 0,5,9,3,9,0,8,14,6,3,1,2,2323,2357,7
Task 2323,Job 1,10,9,3,11,0,13,21,8,3,4,2,2323,2357,15
Task 2324,Job 0,2,4,3,8,0,5,10,5,3,3,0,2324,2357,12
Task 2324,Job 1,7,10,4,6,0,11,13,2,4,1,1,2324,2357,15
Task 2325,Job 0,7,8,2,7,0,9,14,5,2,4,2,2325,2358,13
Task 2325,Job 1,12,4,1,7,0,13,19,6,1,3,2,2325,2358,18
Task 2326,Job 0,1,7,1,7,0,2,8,6,1,2,1,2326,2359,7
Task 2326,Job 1,6,5,1,12,1,7,18,11,1,3,1,2326,2359,7
Task 2327,Job 0,8,9,3,6,0,11,14,3,3,1,0,2327,2361,8
Task 2327,Job 1,13,7,2,10,0,15,23,8,2,4,0,2327,2361,15
Task 2328,Job 0,1,5,4,10,1,5,11,6,4,3,1,2328,2361,11
Task 2328,Job 1,6,9,1,12,0,7,18,11,1,1,2,2328,2361,19
Task 2329,Job 0,7,6,1,12,0,8,19,11,1,2,2,2329,2363,18
Task 2329,Job 1,12,10,4,10,0,16,22,6,4,3,2,2329,2363,15
Task 2330,Job 0,4,5,1,12,1,5,16,11,1,4,0,2330,2363,8
Task 2330,Job 1,9,6,4,9,0,13,18,5,4,3,1,2330,2363,15
Task 2331,Job 0,2,8,2,12,0,4,14,10,2,4,1,2331,2364,8
Task 2331,Job 1,7,6,3,7,0,10,14,4,3,1,0,2331,2364,19
Task 2332,Job 0,10,9,3,11,0,13,21,8,3,1,0,2332,2365,15
Task 2332,Job 1,15,9,2,7,0,17,22,5,2,1,0,2332,2365,3
Task 2333,Job 0,8,9,1,11,0,9,19,10,1,4,1,2333,2366,18
Task 2333,Job 1,13,8,4,6,1,17,19,2,4,1,1,2333,2366,3
Task 2334,Job 0,4,9,4,10,0,8,14,6,4,1,2,2334,2367,4
Task 2334,Job 1,9,10,4,11,0,13,20,7,4,4,2,2334,2367,3
Task 2335,Job 0,10,9,2,7,1,12,17,5,2,2,0,2335,2368,16
Task 2335,Job 1,15,8,3,10,0,18,25,7,3,3,1,2335,2368,2
Task 2336,Job 0,1,8,4,9,0,5,10,5,4,1,0,2336,2370,9
Task 2336,Job 1,6,8,1,12,1,7,18,11,1,2,2,2336,2370,14
Task 2337,Job 0,4,7,3,7,0,7,11,4,3,3,1,2337,2371,11
Task 2337,Job 1,9,7,1,9,0,10,18,8,1,1,0,2337,2371,11
Task 2338,Job 0,5,5,4,11,1,9,16,7,4,2,0,2338,2372,17
Task 2338,Job 1,10,6,4,6,0,14,16,2,4,3,0,2338,2372,2
Task 2339,Job 0,5,8,4,8,0,9,13,4,4,1,2,2339,2373,13
Task 2339,Job 1,10,4,1,11,0,11,21,10,1,2,0,2339,2373,19
Task 2340,Job 0,6,9,4,10,0,10,16,6,4,4,2,2340,2374,10
Task 2340,Job 1,11,9,1,11,0,12,22,10,1,1,2,2340,2374,8
Task 2341,Job 0,3,6,4,6,1,7,9,2,4,1,2,2341,2374,12
Task 2341,Job 1,8,4,1,10,0,9,18,9,1,4,1,2341,2374,13
Task 2342,Job 0,1,8,2,8,1,3,9,6,2,3,1,2342,2375,10
Task 2342,Job 1,6,9,1,11,0,7,17,10,1,2,0,2342,2375,16
Task 2343,Job 0,3,8,3,8,1,6,11,5,3,3,0,2343,2376,7
Task 2343,Job 1,8,9,3,12,0,11,20,9,3,3,0,2343,2376,4
Task 2344,Job 0,4,5,2,12,1,6,16,10,2,2,2,2344,2377,6
Task 2344,Job 1,9,9,1,7,0,10,16,6,1,1,0,2344,2377,9
Task 2345,Job 0,4,4,2,11,0,6,15,9,2,1,1,2345,2378,5
Task 2345,Job 1,9,8,1,7,1,10,16,6,1,4,0,2345,2378,13
Task 2346,Job 0,2,10,3,12,0,5,14,9,3,1,0,2346,2379,16
Task 2346,Job 1,7,6,4,9,0,11,16,5,4,3,1,2346,2379,6
Task 2347,Job 0,10,9,1,6,0,11,16,5,1,2,0,2347,2381,6
Task 2347,Job 1,15,9,2,12,0,17,27,10,2,3,1,2347,2381,8
Task 2348,Job 0,7,5,1,12,0,8,19,11,1,4,1,2348,2382,7
Task 2348,Job 1,12,6,4,9,1,16,21,5,4,3,2,2348,2382,13
Task 2349,Job 0,10,4,4,12,0,14,22,8,4,4,2,2349,2383,14
Task 2349,Job 1,15,5,4,11,0,19,26,7,4,3,1,2349,2383,16
Task 2350,Job 0,9,8,3,6,0,12,15,3,3,3,1,2350,2384,12
Task 2350,Job 1,14,8,3,12,0,17,26,9,3,2,0,2350,2384,3
Task 2351,Job 0,8,10,4,6,1,12,14,2,4,2,1,2351,2385,15
Task 2351,Job 1,13,7,1,11,0,14,24,10,1,2,0,2351,2385,2
Task 2352,Job 0,2,4,4,6,0,6,8,2,4,3,2,2352,2386,3
Task 2352,Job 1,7,8,3,7,0,10,14,4,3,2,2,2352,2386,19
Task 2353,Job 0,10,7,1,7,0,11,17,6,1,3,0,2353,2386,5
Task 2353,Job 1,15,5,4,12,1,19,27,8,4,4,2,2353,2386,10
Task 2354,Job 0,10,6,4,7,0,14,17,3,4,2,0,2354,2387,8
Task 2354,Job 1,15,8,1,10,0,16,25,9,1,1,0,2354,2387,9
Task 2355,Job 0,5,7,2,8,1,7,13,6,2,3,1,2355,2388,18
Task 2355,Job 1,10,4,3,12,0,13,22,9,3,2,0,2355,2388,4
Task 2356,Job 0,5,10,4,7,0,9,12,3,4,4,2,2356,2390,8
Task 2356,Job 1,10,6,1,6,0,11,16,5,1,2,0,2356,2390,10
Task 2357,Job 0,4,10,1,12,0,5,16,11,1,4,1,2357,2390,5
Task 2357,Job 1,9,4,4,8,0,13,17,4,4,3,1,2357,2390,4
Task 2358,Job 0,4,4,4,9,1,8,13,5,4,4,0,2358,2391,12
Task 2358,Job 1,9,8,1,12,0,10,21,11,1,1,0,2358,2391,9
Task 2359,Job 0,7,7,3,12,0,10,19,9,3,1,0,2359,2392,3
Task 2359,Job 1,12,7,3,10,0,15,22,7,3,3,0,2359,2392,5
Task 2360,Job 0,4,7,3,7,0,7,11,4,3,4,1,2360,2393,6
Task 2360,Job 1,9,9,4,6,0,13,15,2,4,3,1,2360,2393,2
Task 2361,Job 0,4,10,3,9,0,7,13,6,3,3,0,2361,2395,20
Task 2361,Job 1,9,7,1,7,1,10,16,6,1,1,0,2361,2395,12
Task 2362,Job 0,1,8,4,10,0,5,11,6,4,3,1,2362,2396,2
Task 2362,Job 1,6,10,1,12,1,7,18,11,1,1,1,2362,2396,19
Task 2363,Job 0,9,5,2,9,0,11,18,7,2,2,1,2363,2397,18
Task 2363,Job 1,14,8,4,7,0,18,21,3,4,2,0,2363,2397,18
Task 2364,Job 0,9,5,1,9,0,10,18,8,1,2,0,2364,2397,19
Task 2364,Job 1,14,9,3,8,0,17,22,5,3,4,0,2364,2397,6
Task 2365,Job 0,4,8,1,12,0,5,16,11,1,2,0,2365,2398,20
Task 2365,Job 1,9,7,2,7,0,11,16,5,2,3,0,2365,2398,8
Task 2366,Job 0,2,4,3,9,0,5,11,6,3,4,2,2366,2399,12
Task 2366,Job 1,7,10,3,7,1,10,14,4,3,1,1,2366,2399,13
Task 2367,Job 0,5,5,4,6,0,9,11,2,4,3,1,2367,2401,15
Task 2367,Job 1,10,7,3,9,0,13,19,6,3,1,0,2367,2401,13
Task 2368,Job 0,8,7,1,9,1,9,17,8,1,1,2,2368,2402,11
Task 2368,Job 1,13,10,2,11,0,15,24,9,2,2,0,2368,2402,17
Task 2369,Job 0,3,5,4,7,0,7,10,3,4,3,0,2369,2403,16
Task 2369,Job 1,8,7,1,6,0,9,14,5,1,2,1,2369,2403,4
Task 2370,Job 0,2,10,4,12,0,6,14,8,4,1,0,2370,2403,2
Task 2370,Job 1,7,8,2,9,0,9,16,7,2,1,0,2370,2403,2
Task 2371,Job 0,5,8,1,12,0,6,17,11,1,4,0,2371,2404,15
Task 2371,Job 1,10,5,1,9,0,11,19,8,1,2,1,2371,2404,2
Task 2372,Job 0,8,6,1,6,0,9,14,5,1,4,1,2372,2406,4
Task 2372,Job 1,13,7,4,12,0,17,25,8,4,3,1,2372,2406,3
Task 2373,Job 0,8,6,3,8,0,11,16,5,3,4,1,2373,2406,17
Task 2373,Job 1,13,5,2,9,0,15,22,7,2,1,2,2373,2406,9
Task 2374,Job 0,2,5,1,7,0,3,9,6,1,3,1,2374,2407,10
Task 2374,Job 1,7,5,1,11,0,8,18,10,1,3,2,2374,2407,14
Task 2375,Job 0,8,5,4,10,0,12,18,6,4,2,2,2375,2408,2
Task 2375,Job 1,13,8,1,10,0,14,23,9,1,3,0,2375,2408,2
Task 2376,Job 0,5,6,3,11,0,8,16,8,3,2,1,2376,2409,18
Task 2376,Job 1,10,8,4,10,0,14,20,6,4,3,2,2376,2409,13
Task 2377,Job 0,10,10,2,12,0,12,22,10,2,3,0,2377,2410,18
Task 2377,Job 1,15,9,1,12,1,16,27,11,1,1,0,2377,2410,9
Task 2378,Job 0,8,9,1,12,1,9,20,11,1,3,1,2378,2412,5
Task 2378,Job 1,13,4,3,9,0,16,22,6,3,4,1,2378,2412,16
Task 2379,Job 0,3,7,1,12,1,4,15,11,1,3,0,2379,2413,3
Task 2379,Job 1,8,4,1,10,0,9,18,9,1,4,1,2379,2413,3
Task 2380,Job 0,5,4,4,7,0,9,12,3,4,2,1,2380,2414,18
Task 2380,Job 1,10,5,3,6,1,13,16,3,3,2,2,2380,2414,10
Task 2381,Job 0,7,6,3,6,0,10,13,3,3,4,0,2381,2415,4
Task 2381,Job 1,12,7,2,8,0,14,20,6,2,1,2,2381,2415,15
Task 2382,Job 0,10,9,4,9,0,14,19,5,4,3,0,2382,2416,15
Task 2382,Job 1,15,9,2,6,1,17,21,4,2,4,1,2382,2416,18
Task 2383,Job 0,8,7,1,11,0,9,19,10,1,3,1,2383,2416,13
Task 2383,Job 1,13,5,3,10,0,16,23,7,3,3,1,2383,2416,7
Task 2384,Job 0,9,10,4,6,0,13,15,2,4,2,0,2384,2418,17
Task 2384,Job 1,14,10,1,9,0,15,23,8,1,2,0,2384,2418,4
Task 2385,Job 0,3,8,2,10,0,5,13,8,2,4,1,2385,2418,8
Task 2385,Job 1,8,9,1,7,1,9,15,6,1,3,2,2385,2418,16
Task 2386,Job 0,4,8,2,11,1,6,15,9,2,2,1,2386,2420,7
Task 2386,Job 1,9,7,2,8,0,11,17,6,2,2,1,2386,2420,2
Task 2387,Job 0,2,10,1,8,0,3,10,7,1,3,2,2387,2421,16
Task 2387,Job 1,7,6,4,6,0,11,13,2,4,1,2,2387,2421,15
Task 2388,Job 0,7,4,1,6,0,8,13,5,1,3,2,2388,2422,12
Task 2388,Job 1,12,7,4,6,0,16,18,2,4,4,2,2388,2422,9
Task 2389,Job 0,4,7,2,7,0,6,11,5,2,3,2,2389,2422,7
Task 2389,Job 1,9,10,4,12,0,13,21,8,4,4,2,2389,2422,18
Task 2390,Job 0,10,9,3,12,0,13,22,9,3,3,1,2390,2423,3
Task 2390,Job 1,15,10,2,10,1,17,25,8,2,2,0,2390,2423,13
Task 2391,Job 0,7,9,3,7,0,10,14,4,3,2,2,2391,2424,16
Task 2391,Job 1,12,6,4,8,0,16,20,4,4,4,0,2391,2424,10
Task 2392,Job 0,3,8,4,11,0,7,14,7,4,2,1,2392,2426,19
Task 2392,Job 1,8,6,1,8,0,9,16,7,1,1,1,2392,2426,5
Task 2393,Job 0,5,6,2,11,1,7,16,9,2,3,0,2393,2426,17
Task 2393,Job 1,10,10,2,10,0,12,20,8,2,4,1,2393,2426,7
Task 2394,Job 0,1,8,4,9,1,5,10,5,4,3,1,2394,2428,15
Task 2394,Job 1,6,7,4,12,0,10,18,8,4,2,2,2394,2428,13
Task 2395,Job 0,8,10,2,10,1,10,18,8,2,4,1,2395,2428,10
Task 2395,Job 1,13,8,2,12,0,15,25,10,2,4,2,2395,2428,7
Task 2396,Job 0,7,5,1,8,0,8,15,7,1,4,0,2396,2430,18
Task 2396,Job 1,12,9,3,7,0,15,19,4,3,3,1,2396,2430,16
Task 2397,Job 0,1,4,1,9,0,2,10,8,1,4,2,2397,2431,5
Task 2397,Job 1,6,5,2,12,0,8,18,10,2,1,0,2397,2431,5
Task 2398,Job 0,5,9,2,8,1,7,13,6,2,4,0,2398,2432,10
Task 2398,Job 1,10,6,2,7,0,12,17,5,2,1,0,2398,2432,8
Task 2399,Job 0,2,6,2,8,0,4,10,6,2,1,1,2399,2432,3
Task 2399,Job 1,7,5,1,9,0,8,16,8,1,1,1,2399,2432,15
Task 2400,Job 0,3,6,3,8,0,6,11,5,3,2,0,2400,2434,6
Task 2400,Job 1,8,10,3,11,0,11,19,8,3,3,1,2400,2434,13
Task 2401,Job 0,9,9,2,9,0,11,18,7,2,2,0,2401,2434,7
Task 2401,Job 1,14,10,1,7,0,15,21,6,1,3,0,2401,2434,12
Task 2402,Job 0,1,8,1,11,0,2,12,10,1,3,1,2402,2435,16
Task 2402,Job 1,6,4,3,8,1,9,14,5,3,1,0,2402,2435,18
Task 2403,Job 0,2,10,4,10,1,6,12,6,4,2,1,2403,2436,6
Task 2403,Job 1,7,9,3,6,0,10,13,3,3,4,0,2403,2436,19
Task 2404,Job 0,10,9,4,7,0,14,17,3,4,3,0,2404,2438,19
Task 2404,Job 1,15,10,2,12,1,17,27,10,2,1,1,2404,2438,5
Task 2405,Job 0,10,10,1,10,0,11,20,9,1,3,2,2405,2439,20
Task 2405,Job 1,15,4,2,8,0,17,23,6,2,4,1,2405,2439,6
Task 2406,Job 0,9,10,2,6,1,11,15,4,2,2,1,2406,2440,15
Task 2406,Job 1,14,10,4,6,0,18,20,2,4,3,2,2406,2440,11
Task 2407,Job 0,2,7,2,12,0,4,14,10,2,4,0,2407,2440,2
Task 2407,Job 1,7,5,4,6,0,11,13,2,4,2,2,2407,2440,18
Task 2408,Job 0,4,9,3,12,0,7,16,9,3,1,2,2408,2441,3
Task 2408,Job 1,9,10,1,9,0,10,18,8,1,2,0,2408,2441,18
Task 2409,Job 0,2,10,3,6,1,5,8,3,3,3,1,2409,2443,2
Task 2409,Job 1,7,9,1,8,1,8,15,7,1,3,0,2409,2443,12
Task 2410,Job 0,3,6,2,6,0,5,9,4,2,4,2,2410,2444,5
Task 2410,Job 1,8,5,4,10,1,12,18,6,4,1,0,2410,2444,17
Task 2411,Job 0,6,9,2,8,0,8,14,6,2,2,0,2411,2444,12
Task 2411,Job 1,11,5,4,8,1,15,19,4,4,4,0,2411,2444,2
Task 2412,Job 0,5,5,2,8,0,7,13,6,2,1,0,2412,2446,3
Task 2412,Job 1,10,7,1,12,0,11,22,11,1,4,1,2412,2446,9
Task 2413,Job 0,7,5,2,6,0,9,13,4,2,4,2,2413,2446,14
Task 2413,Job 1,12,6,1,6,0,13,18,5,1,2,0,2413,2446,14
Task 2414,Job 0,3,5,2,11,1,5,14,9,2,3,2,2414,2447,8
Task 2414,Job 1,8,10,2,10,1,10,18,8,2,4,0,2414,2447,20
Task 2415,Job 0,10,4,2,11,0,12,21,9,2,4,2,2415,2448,13
Task 2415,Job 1,15,9,3,12,1,18,27,9,3,3,2,2415,2448,9
Task 2416,Job 0,6,7,2,12,1,8,18,10,2,4,1,2416,2450,16
Task 2416,Job 1,11,7,2,7,0,13,18,5,2,2,0,2416,2450,19
Task 2417,Job 0,4,5,1,6,0,5,10,5,1,2,2,2417,2450,5
Task 2417,Job 1,9,4,3,10,1,12,19,7,3,3,2,2417,2450,9
Task 2418,Job 0,3,10,4,12,0,7,15,8,4,1,2,2418,2452,5
Task 2418,Job 1,8,9,4,8,0,12,16,4,4,1,0,2418,2452,6
Task 2419,Job 0,5,9,1,11,0,6,16,10,1,2,2,2419,2452,8
Task 2419,Job 1,10,6,1,6,0,11,16,5,1,1,0,2419,2452,19
Task 2420,Job 0,6,4,3,6,1,9,12,3,3,4,2,2420,2453,16
Task 2420,Job 1,11,6,3,9,1,14,20,6,3,2,0,2420,2453,10
Task 2421,Job 0,10,5,3,12,1,13,22,9,3,1,1,2421,2455,12
Task 2421,Job 1,15,6,3,8,0,18,23,5,3,1,2,2421,2455,18
Task 2422,Job 0,2,7,3,6,1,5,8,3,3,2,1,2422,2456,14
Task 2422,Job 1,7,5,4,7,1,11,14,3,4,4,1,2422,2456,2
Task 2423,Job 0,8,10,4,6,0,12,14,2,4,2,2,2423,2456,16
Task 2423,Job 1,13,8,2,11,0,15,24,9,2,3,0,2423,2456,7
Task 2424,Job 0,2,4,2,6,1,4,8,4,2,2,0,2424,2458,6
Task 2424,Job 1,7,8,1,8,0,8,15,7,1,1,0,2424,2458,14
Task 2425,Job 0,5,8,4,9,0,9,14,5,4,4,1,2425,2459,17
Task 2425,Job 1,10,8,4,8,0,14,18,4,4,3,2,2425,2459,3
Task 2426,Job 0,9,4,3,7,1,12,16,4,3,4,0,2426,2459,12
Task 2426,Job 1,14,4,2,9,0,16,23,7,2,2,1,2426,2459,4
Task 2427,Job 0,10,8,3,12,1,13,22,9,3,4,0,2427,2461,7
Task 2427,Job 1,15,8,2,11,0,17,26,9,2,2,0,2427,2461,3
Task 2428,Job 0,2,10,4,7,0,6,9,3,4,2,1,2428,2461,20
Task 2428,Job 1,7,8,4,12,0,11,19,8,4,3,2,2428,2461,14
Task 2429,Job 0,1,10,2,12,1,3,13,10,2,1,0,2429,2462,5
Task 2429,Job 1,6,5,2,7,0,8,13,5,2,1,2,2429,2462,3
Task 2430,Job 0,9,10,2,7,1,11,16,5,2,2,2,2430,2464,2
Task 2430,Job 1,14,9,3,6,1,17,20,3,3,2,1,2430,2464,15
Task 2431,Job 0,5,8,1,8,0,6,13,7,1,1,0,2431,2464,15
Task 2431,Job 1,10,6,4,7,1,14,17,3,4,1,1,2431,2464,9
Task 2432,Job 0,7,6,1,8,1,8,15,7,1,2,1,2432,2465,10
Task 2432,Job 1,12,6,1,7,0,13,19,6,1,4,1,2432,2465,2
Task 2433,Job 0,10,4,2,7,1,12,17,5,2,2,2,2433,2467,13
Task 2433,Job 1,15,6,3,12,0,18,27,9,3,1,2,2433,2467,16
Task 2434,Job 0,5,10,3,8,0,8,13,5,3,4,0,2434,2467,19
Task 2434,Job 1,10,4,3,10,1,13,20,7,3,4,2,2434,2467,11
Task 2435,Job 0,2,10,1,6,1,3,8,5,1,3,1,2435,2468,3
Task 2435,Job 1,7,5,3,11,1,10,18,8,3,4,2,2435,2468,11
Task 2436,Job 0,10,6,1,12,0,11,22,11,1,1,2,2436,2470,4
Task 2436,Job 1,15,10,1,12,0,16,27,11,1,4,1,2436,2470,14
Task 2437,Job 0,6,4,2,9,1,8,15,7,2,4,0,2437,2470,17
Task 2437,Job 1,11,7,1,12,0,12,23,11,1,1,2,2437,2470,4
Task 2438,Job 0,5,9,3,12,0,8,17,9,3,1,0,2438,2471,13
Task 2438,Job 1,10,5,2,6,0,12,16,4,2,4,1,2438,2471,16
Task 2439,Job 0,1,5,1,12,0,2,13,11,1,1,2,2439,2473,8
Task 2439,Job 1,6,7,4,10,0,10,16,6,4,1,0,2439,2473,11
Task 2440,Job 0,6,8,4,9,0,10,15,5,4,3,0,2440,2474,3
Task 2440,Job 1,11,6,2,9,1,13,20,7,2,3,2,2440,2474,13
Task 2441,Job 0,1,6,1,7,1,2,8,6,1,2,2,2441,2474,11
Task 2441,Job 1,6,7,3,10,0,9,16,7,3,4,1,2441,2474,14
Task 2442,Job 0,2,4,4,6,0,6,8,2,4,2,1,2442,2476,8
Task 2442,Job 1,7,8,2,8,0,9,15,6,2,3,0,2442,2476,12
Task 2443,Job 0,8,10,2,9,1,10,17,7,2,3,2,2443,2477,3
Task 2443,Job 1,13,6,1,7,1,14,20,6,1,2,1,2443,2477,11
Task 2444,Job 0,8,6,3,7,1,11,15,4,3,3,2,2444,2478,13
Task 2444,Job 1,13,4,2,6,0,15,19,4,2,2,2,2444,2478,19
Task 2445,Job 0,10,8,2,6,1,12,16,4,2,1,0,2445,2478,17
Task 2445,Job 1,15,5,2,7,0,17,22,5,2,2,0,2445,2478,20
Task 2446,Job 0,2,10,4,11,1,6,13,7,4,3,0,2446,2479,20
Task 2446,Job 1,7,4,1,6,0,8,13,5,1,4,1,2446,2479,4
Task 2447,Job 0,1,5,4,7,0,5,8,3,4,4,1,2447,2480,17
Task 2447,Job 1,6,6,4,9,0,10,15,5,4,1,2,2447,2480,15
Task 2448,Job 0,5,9,1,10,0,6,15,9,1,3,0,2448,2481,8
Task 2448,Job 1,10,6,3,12,0,13,22,9,3,3,2,2448,2481,6
Task 2449,Job 0,9,6,1,6,1,10,15,5,1,4,0,2449,2483,14
Task 2449,Job 1,14,5,2,8,1,16,22,6,2,4,2,2449,2483,2
Task 2450,Job 0,7,10,1,9,0,8,16,8,1,4,2,2450,2484,9
Task 2450,Job 1,12,4,3,12,0,15,24,9,3,3,0,2450,2484,18
Task 2451,Job 0,5,8,2,7,1,7,12,5,2,3,2,2451,2484,5
Task 2451,Job 1,10,4,4,12,0,14,22,8,4,1,0,2451,2484,11
Task 2452,Job 0,8,9,2,6,0,10,14,4,2,2,0,2452,2485,5
Task 2452,Job 1,13,4,2,7,0,15,20,5,2,1,0,2452,2485,3
Task 2453,Job 0,2,5,1,7,0,3,9,6,1,2,0,2453,2487,16
Task 2453,Job 1,7,5,4,11,0,11,18,7,4,3,2,2453,2487,10
Task 2454,Job 0,1,10,4,12,0,5,13,8,4,2,2,2454,2487,20
Task 2454,Job 1,6,4,2,9,0,8,15,7,2,3,2,2454,2487,12
Task 2455,Job 0,7,7,1,7,0,8,14,6,1,1,0,2455,2489,4
Task 2455,Job 1,12,7,4,8,0,16,20,4,4,2,0,2455,2489,17
Task 2456,Job 0,2,4,3,12,0,5,14,9,3,1,0,2456,2489,6
Task 2456,Job 1,7,8,1,9,0,8,16,8,1,1,0,2456,2489,6
Task 2457,Job 0,7,5,1,11,0,8,18,10,1,4,2,2457,2491,20
Task 2457,Job 1,12,8,1,7,0,13,19,6,1,4,1,2457,2491,20
Task 2458,Job 0,4,9,2,12,0,6,16,10,2,4,1,2458,2491,7
Task 2458,Job 1,9,4,2,8,1,11,17,6,2,2,2,2458,2491,9
Task 2459,Job 0,1,4,3,8,0,4,9,5,3,4,0,2459,2493,6
Task 2459,Job 1,6,4,2,7,1,8,13,5,2,3,2,2459,2493,7
Task 2460,Job 0,1,9,1,10,0,2,11,9,1,1,2,2460,2494,19
Task 2460,Job 1,6,7,4,6,0,10,12,2,4,1,2,2460,2494,9
Task 2461,Job 0,10,8,2,8,1,12,18,6,2,1,2,2461,2495,7
Task 2461,Job 1,15,5,3,7,0,18,22,4,3,1,1,2461,2495,15
Task 2462,Job 0,5,4,4,12,0,9,17,8,4,1,2,2462,2496,7
Task 2462,Job 1,10,9,2,10,0,12,20,8,2,3,0,2462,2496,19
Task 2463,Job 0,10,6,3,11,0,13,21,8,3,3,1,2463,2496,19
Task 2463,Job 1,15,9,2,6,0,17,21,4,2,4,2,2463,2496,19
Task 2464,Job 0,8,10,2,11,1,10,19,9,2,2,2,2464,2497,17
Task 2464,Job 1,13,7,1,10,0,14,23,9,1,3,0,2464,2497,13
Task 2465,Job 0,9,5,4,8,1,13,17,4,4,4,0,2465,2499,5
Task 2465,Job 1,14,7,3,6,1,17,20,3,3,2,2,2465,2499,3
Task 2466,Job 0,8,10,4,10,0,12,18,6,4,4,1,2466,2499,13
Task 2466,Job 1,13,7,1,7,0,14,20,6,1,3,2,2466,2499,4
Task 2467,Job 0,4,6,3,9,1,7,13,6,3,4,2,2467,2501,12
Task 2467,Job 1,9,7,1,9,0,10,18,8,1,4,2,2467,2501,18
Task 2468,Job 0,4,6,1,8,0,5,12,7,1,3,1,2468,2502,16
Task 2468,Job 1,9,5,3,8,0,12,17,5,3,3,1,2468,2502,12
Task 2469,Job 0,5,8,1,12,0,6,17,11,1,3,2,2469,2502,12
Task 2469,Job 1,10,4,4,9,0,14,19,5,4,4,1,2469,2502,20
Task 2470,Job 0,3,4,1,10,0,4,13,9,1,3,2,2470,2504,16
Task 2470,Job 1,8,8,1,8,0,9,16,7,1,4,2,2470,2504,17
Task 2471,Job 0,4,6,1,11,1,5,15,10,1,1,1,2471,2504,4
Task 2471,Job 1,9,6,2,8,0,11,17,6,2,1,2,2471,2504,13
Task 2472,Job 0,3,8,4,7,1,7,10,3,4,4,2,2472,2505,7
Task 2472,Job 1,8,10,1,6,0,9,14,5,1,3,1,2472,2505,6
Task 2473,Job 0,5,9,2,10,1,7,15,8,2,4,1,2473,2506,8
Task 2473,Job 1,10,8,3,11,0,13,21,8,3,3,0,2473,2506,7
Task 2474,Job 0,3,5,2,7,0,5,10,5,2,4,2,2474,2507,9
Task 2474,Job 1,8,10,4,9,0,12,17,5,4,2,0,2474,2507,13
Task 2475,Job 0,9,5,3,12,0,12,21,9,3,1,2,2475,2509,13
Task 2475,Job 1,14,7,2,12,1,16,26,10,2,4,2,2475,2509,16
Task 2476,Job 0,3,5,3,8,0,6,11,5,3,3,0,2476,2510,13
Task 2476,Job 1,8,10,1,11,0,9,19,10,1,3,2,2476,2510,7
Task 2477,Job 0,6,7,3,6,0,9,12,3,3,4,0,2477,2511,9
Task 2477,Job 1,11,5,3,9,0,14,20,6,3,1,0,2477,2511,4
Task 2478,Job 0,5,10,2,8,1,7,13,6,2,4,0,2478,2511,5
Task 2478,Job 1,10,4,1,10,0,11,20,9,1,2,1,2478,2511,4
Task 2479,Job 0,4,5,4,6,0,8,10,2,4,4,0,2479,2513,19
Task 2479,Job 1,9,4,2,6,0,11,15,4,2,1,0,2479,2513,18
Task 2480,Job 0,3,5,4,9,0,7,12,5,4,3,1,2480,2514,16
Task 2480,Job 1,8,7,4,12,0,12,20,8,4,1,2,2480,2514,14
Task 2481,Job 0,5,10,3,12,0,8,17,9,3,4,2,2481,2515,20
Task 2481,Job 1,10,9,1,12,1,11,22,11,1,1,2,2481,2515,9
Task 2482,Job 0,3,9,3,7,0,6,10,4,3,4,0,2482,2516,7
Task 2482,Job 1,8,7,3,10,1,11,18,7,3,3,1,2482,2516,13
Task 2483,Job 0,8,5,1,8,0,9,16,7,1,2,2,2483,2516,12
Task 2483,Job 1,13,6,2,12,1,15,25,10,2,4,0,2483,2516,10
Task 2484,Job 0,2,5,2,9,1,4,11,7,2,3,0,2484,2517,16
Task 2484,Job 1,7,7,2,8,0,9,15,6,2,2,2,2484,2517,12
Task 2485,Job 0,4,9,2,7,1,6,11,5,2,3,1,2485,2518,6
Task 2485,Job 1,9,5,2,9,1,11,18,7,2,2,1,2485,2518,6
Task 2486,Job 0,4,6,3,12,1,7,16,9,3,3,1,2486,2520,10
Task 2486,Job 1,9,10,3,10,0,12,19,7,3,1,0,2486,2520,3
Task 2487,Job 0,8,5,3,6,0,11,14,3,3,1,0,2487,2520,12
Task 2487,Job 1,13,6,4,7,1,17,20,3,4,3,1,2487,2520,3
Task 2488,Job 0,2,6,4,10,0,6,12,6,4,2,0,2488,2522,14
Task 2488,Job 1,7,10,4,7,0,11,14,3,4,3,0,2488,2522,12
Task 2489,Job 0,3,6,4,12,0,7,15,8,4,2,0,2489,2522,4
Task 2489,Job 1,8,7,1,11,0,9,19,10,1,1,1,2489,2522,15
Task 2490,Job 0,9,8,2,7,1,11,16,5,2,3,0,2490,2524,20
Task 2490,Job 1,14,7,2,11,1,16,25,9,2,1,1,2490,2524,3
Task 2491,Job 0,10,10,4,12,0,14,22,8,4,4,2,2491,2525,18
Task 2491,Job 1,15,5,4,11,0,19,26,7,4,2,0,2491,2525,6
Task 2492,Job 0,9,9,4,11,0,13,20,7,4,4,0,2492,2525,9
Task 2492,Job 1,14,6,4,12,0,18,26,8,4,2,2,2492,2525,12
Task 2493,Job 0,2,10,1,6,0,3,8,5,1,1,2,2493,2526,19
Task 2493,Job 1,7,8,4,10,0,11,17,6,4,4,1,2493,2526,19
Task 2494,Job 0,8,5,3,6,0,11,14,3,3,3,1,2494,2527,6
Task 2494,Job 1,13,5,1,11,0,14,24,10,1,1,2,2494,2527,5
Task 2495,Job 0,8,5,3,10,0,11,18,7,3,3,0,2495,2528,6
Task 2495,Job 1,13,8,3,7,1,16,20,4,3,3,1,2495,2528,5
Task 2496,Job 0,9,10,3,8,1,12,17,5,3,3,1,2496,2530,7
Task 2496,Job 1,14,9,4,7,0,18,21,3,4,1,2,2496,2530,18
Task 2497,Job 0,1,7,4,10,1,5,11,6,4,3,0,2497,2530,4
Task 2497,Job 1,6,8,3,10,0,9,16,7,3,2,1,2497,2530,13
Task 2498,Job 0,8,7,4,11,0,12,19,7,4,1,1,2498,2532,3
Task 2498,Job 1,13,10,2,11,0,15,24,9,2,2,2,2498,2532,20
Task 2499,Job 0,7,6,4,12,0,11,19,8,4,4,1,2499,2532,4
Task 2499,Job 1,12,7,3,11,1,15,23,8,3,4,1,2499,2532,13
Task 2500,Job 0,8,9,4,8,0,12,16,4,4,4,1,2500,2533,11
Task 2500,Job 1,13,4,1,7,0,14,20,6,1,4,1,2500,2533,7
Task 2501,Job 0,6,9,4,7,0,10,13,3,4,4,1,2501,2535,13
Task 2501,Job 1,11,4,4,6,0,15,17,2,4,4,2,2501,2535,7
Task 2502,Job 0,9,9,1,7,0,10,16,6,1,3,2,2502,2536,5
Task 2502,Job 1,14,8,3,6,0,17,20,3,3,3,0,2502,2536,17
Task 2503,Job 0,10,6,3,8,1,13,18,5,3,2,0,2503,2537,16
Task 2503,Job 1,15,6,1,10,0,16,25,9,1,1,1,2503,2537,8
Task 2504,Job 0,5,8,1,12,0,6,17,11,1,4,0,2504,2538,11
Task 2504,Job 1,10,8,4,7,0,14,17,3,4,3,1,2504,2538,15
Task 2505,Job 0,1,5,2,6,1,3,7,4,2,2,0,2505,2539,12
Task 2505,Job 1,6,5,3,12,0,9,18,9,3,4,2,2505,2539,2
Task 2506,Job 0,1,5,1,11,0,2,12,10,1,2,1,2506,2540,10
Task 2506,Job 1,6,4,3,7,1,9,13,4,3,3,0,2506,2540,4
Task 2507,Job 0,3,10,1,9,0,4,12,8,1,1,2,2507,2540,19
Task 2507,Job 1,8,6,3,10,0,11,18,7,3,1,2,2507,2540,17
Task 2508,Job 0,3,5,4,10,0,7,13,6,4,3,1,2508,2541,2
Task 2508,Job 1,8,7,1,9,0,9,17,8,1,4,2,2508,2541,14
Task 2509,Job 0,2,9,1,12,0,3,14,11,1,4,1,2509,2543,2
Task 2509,Job 1,7,5,2,12,0,9,19,10,2,3,0,2509,2543,2
Task 2510,Job 0,3,8,2,6,0,5,9,4,2,1,1,2510,2543,20
Task 2510,Job 1,8,8,2,6,1,10,14,4,2,4,0,2510,2543,6
Task 2511,Job 0,6,8,4,9,1,10,15,5,4,4,1,2511,2544,7
Task 2511,Job 1,11,4,2,10,0,13,21,8,2,4,0,2511,2544,8
Task 2512,Job 0,4,8,1,11,0,5,15,10,1,4,2,2512,2545,8
Task 2512,Job 1,9,7,3,11,0,12,20,8,3,3,1,2512,2545,13
Task 2513,Job 0,10,10,4,7,1,14,17,3,4,1,1,2513,2547,8
Task 2513,Job 1,15,7,2,8,0,17,23,6,2,4,2,2513,2547,20
Task 2514,Job 0,3,8,3,10,0,6,13,7,3,1,1,2514,2548,12
Task 2514,Job 1,8,5,2,8,0,10,16,6,2,4,2,2514,2548,7
Task 2515,Job 0,5,4,2,11,0,7,16,9,2,2,1,2515,2549,20
Task 2515,Job 1,10,10,1,9,0,11,19,8,1,4,0,2515,2549,8
Task 2516,Job 0,2,10,3,6,0,5,8,3,3,1,1,2516,2549,5
Task 2516,Job 1,7,5,4,6,0,11,13,2,4,4,0,2516,2549,17
Task 2517,Job 0,6,6,2,6,0,8,12,4,2,2,2,2517,2550,16
Task 2517,Job 1,11,10,3,9,0,14,20,6,3,3,1,2517,2550,6
Task 2518,Job 0,3,5,3,8,0,6,11,5,3,4,2,2518,2552,6
Task 2518,Job 1,8,10,3,10,1,11,18,7,3,1,1,2518,2552,16
Task 2519,Job 0,6,8,4,11,0,10,17,7,4,1,1,2519,2552,5
Task 2519,Job 1,11,9,1,7,0,12,18,6,1,2,0,2519,2552,12
Task 2520,Job 0,10,4,3,11,0,13,21,8,3,4,1,2520,2553,9
Task 2520,Job 1,15,10,2,10,0,17,25,8,2,2,1,2520,2553,7
Task 2521,Job 0,1,9,2,8,0,3,9,6,2,1,0,2521,2554,3
Task 2521,Job 1,6,8,3,11,0,9,17,8,3,3,1,2521,2554,11
Task 2522,Job 0,4,6,3,12,0,7,16,9,3,3,0,2522,2555,5
Task 2522,Job 1,9,9,2,6,0,11,15,4,2,2,0,2522,2555,19
Task 2523,Job 0,9,7,1,12,1,10,21,11,1,1,2,2523,2556,14
Task 2523,Job 1,14,8,4,11,0,18,25,7,4,4,2,2523,2556,12
Task 2524,Job 0,4,10,3,8,0,7,12,5,3,1,1,2524,2558,4
Task 2524,Job 1,9,9,2,10,0,11,19,8,2,2,2,2524,2558,10
Task 2525,Job 0,8,7,2,9,0,10,17,7,2,4,1,2525,2558,12
Task 2525,Job 1,13,6,1,8,0,14,21,7,1,3,2,2525,2558,13
Task 2526,Job 0,7,7,1,12,0,8,19,11,1,2,0,2526,2559,12
Task 2526,Job 1,12,7,1,10,0,13,22,9,1,3,0,2526,2559,9
Task 2527,Job 0,4,8,3,9,1,7,13,6,3,3,0,2527,2561,2
Task 2527,Job 1,9,4,3,7,0,12,16,4,3,1,2,2527,2561,12
Task 2528,Job 0,4,8,1,7,0,5,11,6,1,4,0,2528,2562,13
Task 2528,Job 1,9,9,1,12,0,10,21,11,1,3,2,2528,2562,13
Task 2529,Job 0,5,6,1,11,1,6,16,10,1,4,0,2529,2562,5
Task 2529,Job 1,10,5,3,7,0,13,17,4,3,4,0,2529,2562,19
Task 2530,Job 0,10,5,1,9,0,11,19,8,1,2,1,2530,2563,19
Task 2530,Job 1,15,5,3,12,1,18,27,9,3,2,0,2530,2563,17
Task 2531,Job 0,9,8,1,12,0,10,21,11,1,1,0,2531,2565,4
Task 2531,Job 1,14,5,1,11,0,15,25,10,1,1,1,2531,2565,13
Task 2532,Job 0,6,6,3,7,0,9,13,4,3,2,1,2532,2566,2
Task 2532,Job 1,11,7,2,11,0,13,22,9,2,2,1,2532,2566,16
Task 2533,Job 0,10,5,4,9,0,14,19,5,4,3,0,2533,2567,19
Task 2533,Job 1,15,5,2,10,1,17,25,8,2,4,1,2533,2567,8
Task 2534,Job 0,7,5,3,9,1,10,16,6,3,1,1,2534,2568,6
Task 2534,Job 1,12,9,1,6,0,13,18,5,1,2,2,2534,2568,14
Task 2535,Job 0,10,4,2,7,1,12,17,5,2,3,2,2535,2569,13
Task 2535,Job 1,15,4,4,11,1,19,26,7,4,3,2,2535,2569,13
Task 2536,Job 0,2,10,2,7,1,4,9,5,2,2,1,2536,2570,15
Task 2536,Job 1,7,7,2,9,0,9,16,7,2,3,1,2536,2570,10
Task 2537,Job 0,9,4,2,12,0,11,21,10,2,3,0,2537,2571,11
Task 2537,Job 1,14,10,1,10,0,15,24,9,1,1,0,2537,2571,20
Task 2538,Job 0,1,8,3,11,0,4,12,8,3,2,1,2538,2571,5
Task 2538,Job 1,6,8,3,10,0,9,16,7,3,1,2,2538,2571,3
Task 2539,Job 0,7,4,2,12,1,9,19,10,2,3,0,2539,2573,8
Task 2539,Job 1,12,9,2,9,1,14,21,7,2,4,1,2539,2573,4
Task 2540,Job 0,5,5,1,11,0,6,16,10,1,2,2,2540,2574,2
Task 2540,Job 1,10,5,2,9,0,12,19,7,2,3,2,2540,2574,20
Task 2541,Job 0,10,4,4,9,0,14,19,5,4,2,0,2541,2574,12
Task 2541,Job 1,15,7,1,8,0,16,23,7,1,3,1,2541,2574,17
Task 2542,Job 0,1,10,4,11,0,5,12,7,4,3,1,2542,2575,20
Task 2542,Job 1,6,4,4,8,0,10,14,4,4,1,1,2542,2575,8
Task 2543,Job 0,9,7,4,10,1,13,19,6,4,1,0,2543,2576,2
Task 2543,Job 1,14,8,3,6,1,17,20,3,3,4,1,2543,2576,13
Task 2544,Job 0,6,10,3,7,0,9,13,4,3,3,2,2544,2578,5
Task 2544,Job 1,11,5,4,9,0,15,20,5,4,2,0,2544,2578,19
Task 2545,Job 0,7,8,4,8,0,11,15,4,4,4,2,2545,2579,17
Task 2545,Job 1,12,10,4,9,1,16,21,5,4,1,0,2545,2579,10
Task 2546,Job 0,6,7,4,8,0,10,14,4,4,3,1,2546,2579,18
Task 2546,Job 1,11,6,2,6,0,13,17,4,2,4,0,2546,2579,11
Task 2547,Job 0,8,9,3,9,0,11,17,6,3,2,2,2547,2581,8
Task 2547,Job 1,13,4,3,6,0,16,19,3,3,4,0,2547,2581,11
Task 2548,Job 0,8,4,1,6,0,9,14,5,1,4,1,2548,2582,6
Task 2548,Job 1,13,10,4,9,0,17,22,5,4,1,2,2548,2582,9
Task 2549,Job 0,9,9,1,10,0,10,19,9,1,1,0,2549,2583,17
Task 2549,Job 1,14,7,4,9,0,18,23,5,4,2,2,2549,2583,18
Task 2550,Job 0,5,5,1,7,0,6,12,6,1,4,2,2550,2583,16
Task 2550,Job 1,10,7,3,9,1,13,19,6,3,2,2,2550,2583,3
Task 2551,Job 0,1,4,1,7,0,2,8,6,1,2,1,2551,2585,18
Task 2551,Job 1,6,4,3,9,0,9,15,6,3,4,0,2551,2585,16
Task 2552,Job 0,4,10,3,7,1,7,11,4,3,1,0,2552,2586,7
Task 2552,Job 1,9,7,3,8,1,12,17,5,3,4,2,2552,2586,12
Task 2553,Job 0,6,8,1,11,0,7,17,10,1,3,2,2553,2586,2
Task 2553,Job 1,11,8,2,11,0,13,22,9,2,2,0,2553,2586,11
Task 2554,Job 0,4,8,4,9,0,8,13,5,4,3,0,2554,2587,10
Task 2554,Job 1,9,6,4,11,0,13,20,7,4,1,2,2554,2587,6
Task 2555,Job 0,3,7,1,9,0,4,12,8,1,4,1,2555,2589,4
Task 2555,Job 1,8,7,1,12,0,9,20,11,1,4,2,2555,2589,15
Task 2556,Job 0,10,7,1,7,0,11,17,6,1,2,1,2556,2589,7
Task 2556,Job 1,15,10,2,9,0,17,24,7,2,4,0,2556,2589,7
Task 2557,Job 0,2,4,3,12,0,5,14,9,3,2,1,2557,2591,8
Task 2557,Job 1,7,6,1,12,0,8,19,11,1,2,1,2557,2591,2
Task 2558,Job 0,5,8,2,12,1,7,17,10,2,2,1,2558,2591,20
Task 2558,Job 1,10,4,1,8,0,11,18,7,1,3,2,2558,2591,13
Task 2559,Job 0,2,7,2,12,0,4,14,10,2,3,0,2559,2592,15
Task 2559,Job 1,7,10,2,6,0,9,13,4,2,1,2,2559,2592,13
Task 2560,Job 0,4,10,3,8,0,7,12,5,3,1,1,2560,2594,17
Task 2560,Job 1,9,5,3,11,0,12,20,8,3,3,1,2560,2594,2
Task 2561,Job 0,5,9,4,9,0,9,14,5,4,4,2,2561,2595,2
Task 2561,Job 1,10,7,1,9,0,11,19,8,1,3,0,2561,2595,15
Task 2562,Job 0,9,5,2,9,1,11,18,7,2,3,2,2562,2596,14
Task 2562,Job 1,14,10,3,7,0,17,21,4,3,4,0,2562,2596,18
Task 2563,Job 0,8,7,1,7,0,9,15,6,1,3,1,2563,2597,15
Task 2563,Job 1,13,6,4,11,0,17,24,7,4,4,0,2563,2597,16
Task 2564,Job 0,8,8,3,12,0,11,20,9,3,2,2,2564,2597,16
Task 2564,Job 1,13,10,3,10,0,16,23,7,3,1,2,2564,2597,8
Task 2565,Job 0,10,6,2,11,0,12,21,9,2,4,1,2565,2598,8
Task 2565,Job 1,15,7,2,7,1,17,22,5,2,2,1,2565,2598,15
Task 2566,Job 0,7,6,2,6,0,9,13,4,2,4,1,2566,2599,6
Task 2566,Job 1,12,7,2,10,0,14,22,8,2,2,0,2566,2599,9
Task 2567,Job 0,10,4,2,9,0,12,19,7,2,4,0,2567,2601,17
Task 2567,Job 1,15,8,1,9,0,16,24,8,1,4,0,2567,2601,19
Task 2568,Job 0,5,9,2,11,0,7,16,9,2,2,2,2568,2601,4
Task 2568,Job 1,10,10,2,8,0,12,18,6,2,1,1,2568,2601,13
Task 2569,Job 0,10,5,4,7,1,14,17,3,4,4,1,2569,2603,6
Task 2569,Job 1,15,7,1,12,1,16,27,11,1,3,1,2569,2603,5
Task 2570,Job 0,4,5,4,12,0,8,16,8,4,2,2,2570,2604,3
Task 2570,Job 1,9,10,3,8,0,12,17,5,3,1,0,2570,2604,8
Task 2571,Job 0,10,9,4,9,0,14,19,5,4,3,2,2571,2604,17
Task 2571,Job 1,15,5,3,6,0,18,21,3,3,1,1,2571,2604,14
Task 2572,Job 0,10,9,1,12,0,11,22,11,1,2,2,2572,2605,10
Task 2572,Job 1,15,4,3,10,1,18,25,7,3,4,2,2572,2605,16
Task 2573,Job 0,6,7,1,7,0,7,13,6,1,1,2,2573,2607,15
Task 2573,Job 1,11,8,4,8,0,15,19,4,4,1,1,2573,2607,17
Task 2574,Job 0,7,7,1,10,0,8,17,9,1,1,2,2574,2608,19
Task 2574,Job 1,12,6,1,7,0,13,19,6,1,3,0,2574,2608,8
Task 2575,Job 0,2,10,4,10,1,6,12,6,4,3,0,2575,2609,3
Task 2575,Job 1,7,7,3,12,0,10,19,9,3,1,0,2575,2609,8
Task 2576,Job 0,10,8,2,8,1,12,18,6,2,4,1,2576,2610,13
Task 2576,Job 1,15,8,3,11,0,18,26,8,3,4,2,2576,2610,13
Task 2577,Job 0,3,4,3,7,1,6,10,4,3,3,2,2577,2611,13
Task 2577,Job 1,8,5,4,11,0,12,19,7,4,2,2,2577,2611,12
Task 2578,Job 0,10,4,3,8,0,13,18,5,3,3,0,2578,2611,3
Task 2578,Job 1,15,7,2,11,0,17,26,9,2,1,1,2578,2611,11
Task 2579,Job 0,7,7,3,6,0,10,13,3,3,1,0,2579,2612,8
Task 2579,Job 1,12,8,1,7,1,13,19,6,1,4,2,2579,2612,11
Task 2580,Job 0,4,5,2,12,1,6,16,10,2,1,0,2580,2613,3
Task 2580,Job 1,9,5,3,11,0,12,20,8,3,2,2,2580,2613,19
Task 2581,Job 0,2,4,4,11,0,6,13,7,4,3,2,2581,2614,12
Task 2581,Job 1,7,9,2,10,0,9,17,8,2,2,1,2581,2614,18
Task 2582,Job 0,7,10,1,7,0,8,14,6,1,4,1,2582,2615,15
Task 2582,Job 1,12,6,2,11,0,14,23,9,2,2,1,2582,2615,12
Task 2583,Job 0,4,8,2,10,0,6,14,8,2,2,2,2583,2617,6
Task 2583,Job 1,9,5,4,11,0,13,20,7,4,3,2,2583,2617,9
Task 2584,Job 0,7,5,4,9,0,11,16,5,4,3,2,2584,2618,17
Task 2584,Job 1,12,6,2,7,0,14,19,5,2,4,1,2584,2618,17
Task 2585,Job 0,1,10,2,12,0,3,13,10,2,4,0,2585,2619,11
Task 2585,Job 1,6,6,1,10,0,7,16,9,1,4,2,2585,2619,3
Task 2586,Job 0,4,8,1,10,0,5,14,9,1,3,2,2586,2620,16
Task 2586,Job 1,9,6,4,10,1,13,19,6,4,1,2,2586,2620,13
Task 2587,Job 0,9,8,1,8,0,10,17,7,1,2,2,2587,2620,17
Task 2587,Job 1,14,8,2,9,0,16,23,7,2,2,0,2587,2620,13
Task 2588,Job 0,2,7,3,10,0,5,12,7,3,2,2,2588,2621,6
Task 2588,Job 1,7,5,3,10,0,10,17,7,3,1,1,2588,2621,9
Task 2589,Job 0,5,5,2,8,0,7,13,6,2,3,0,2589,2623,19
Task 2589,Job 1,10,6,3,9,0,13,19,6,3,4,1,2589,2623,4
Task 2590,Job 0,5,10,2,12,1,7,17,10,2,3,2,2590,2623,14
Task 2590,Job 1,10,10,1,9,0,11,19,8,1,3,0,2590,2623,17
Task 2591,Job 0,1,6,3,8,0,4,9,5,3,3,2,2591,2625,17
Task 2591,Job 1,6,10,1,10,1,7,16,9,1,4,1,2591,2625,7
Task 2592,Job 0,6,9,4,7,0,10,13,3,4,2,0,2592,2625,10
Task 2592,Job 1,11,9,3,12,1,14,23,9,3,1,0,2592,2625,5
Task 2593,Job 0,3,10,3,9,0,6,12,6,3,3,1,2593,2626,4
Task 2593,Job 1,8,5,2,10,0,10,18,8,2,1,2,2593,2626,3
Task 2594,Job 0,8,10,4,11,0,12,19,7,4,4,1,2594,2627,20
Task 2594,Job 1,13,4,1,11,0,14,24,10,1,4,2,2594,2627,18
Task 2595,Job 0,7,8,4,8,0,11,15,4,4,2,2,2595,2629,9
Task 2595,Job 1,12,5,2,6,0,14,18,4,2,4,1,2595,2629,2
Task 2596,Job 0,3,7,3,8,0,6,11,5,3,1,2,2596,2630,11
Task 2596,Job 1,8,10,1,11,0,9,19,10,1,3,2,2596,2630,3
Task 2597,Job 0,2,9,4,8,1,6,10,4,4,1,1,2597,2631,16
Task 2597,Job 1,7,10,3,10,1,10,17,7,3,1,0,2597,2631,17
Task 2598,Job 0,7,9,2,8,0,9,15,6,2,1,2,2598,2631,6
Task 2598,Job 1,12,9,1,7,0,13,19,6,1,3,0,2598,2631,6
Task 2599,Job 0,2,7,1,10,0,3,12,9,1,2,2,2599,2633,5
Task 2599,Job 1,7,6,2,10,0,9,17,8,2,2,0,2599,2633,12
Task 2600,Job 0,7,9,4,12,0,11,19,8,4,1,2,2600,2633,3
Task 2600,Job 1,12,5,4,8,1,16,20,4,4,4,0,2600,2633,18
Task 2601,Job 0,10,7,2,6,0,12,16,4,2,3,0,2601,2635,17
Task 2601,Job 1,15,9,4,6,0,19,21,2,4,2,2,2601,2635,3
Task 2602,Job 0,2,6,4,11,0,6,13,7,4,4,1,2602,2635,18
Task 2602,Job 1,7,4,2,7,1,9,14,5,2,3,2,2602,2635,11
Task 2603,Job 0,9,6,4,10,1,13,19,6,4,2,2,2603,2637,13
Task 2603,Job 1,14,6,4,7,1,18,21,3,4,1,1,2603,2637,11
Task 2604,Job 0,3,7,3,11,1,6,14,8,3,2,2,2604,2638,10
Task 2604,Job 1,8,7,3,9,0,11,17,6,3,1,1,2604,2638,6
Task 2605,Job 0,10,5,4,6,0,14,16,2,4,4,2,2605,2638,13
Task 2605,Job 1,15,8,4,9,0,19,24,5,4,4,1,2605,2638,6
Task 2606,Job 0,6,8,1,11,0,7,17,10,1,2,1,2606,2640,18
Task 2606,Job 1,11,8,4,9,0,15,20,5,4,3,1,2606,2640,13
Task 2607,Job 0,7,7,1,10,0,8,17,9,1,1,1,2607,2640,9
Task 2607,Job 1,12,8,3,12,0,15,24,9,3,4,1,2607,2640,16
Task 2608,Job 0,7,4,2,8,0,9,15,6,2,3,2,2608,2641,19
Task 2608,Job 1,12,7,1,7,0,13,19,6,1,2,1,2608,2641,15
Task 2609,Job 0,1,4,4,10,0,5,11,6,4,3,0,2609,2643,10
Task 2609,Job 1,6,9,4,7,0,10,13,3,4,2,0,2609,2643,12
Task 2610,Job 0,5,7,2,6,1,7,11,4,2,1,0,2610,2644,8
Task 2610,Job 1,10,7,1,12,0,11,22,11,1,4,0,2610,2644,15
Task 2611,Job 0,4,5,1,8,0,5,12,7,1,1,0,2611,2645,8
Task 2611,Job 1,9,5,2,12,0,11,21,10,2,4,0,2611,2645,12
Task 2612,Job 0,1,4,2,9,0,3,10,7,2,3,0,2612,2645,7
Task 2612,Job 1,6,4,3,7,0,9,13,4,3,1,2,2612,2645,9
Task 2613,Job 0,8,8,3,12,0,11,20,9,3,4,0,2613,2646,17
Task 2613,Job 1,13,6,2,9,0,15,22,7,2,4,1,2613,2646,13
Task 2614,Job 0,9,5,4,11,0,13,20,7,4,4,1,2614,2648,2
Task 2614,Job 1,14,5,3,12,0,17,26,9,3,1,1,2614,2648,18
Task 2615,Job 0,7,7,3,9,0,10,16,6,3,2,2,2615,2649,4
Task 2615,Job 1,12,8,3,11,0,15,23,8,3,3,1,2615,2649,19
Task 2616,Job 0,8,10,4,8,0,12,16,4,4,3,0,2616,2650,20
Task 2616,Job 1,13,5,1,9,0,14,22,8,1,2,0,2616,2650,20
Task 2617,Job 0,1,4,1,11,0,2,12,10,1,1,1,2617,2651,17
Task 2617,Job 1,6,9,3,7,0,9,13,4,3,4,0,2617,2651,14
Task 2618,Job 0,1,7,4,11,0,5,12,7,4,1,1,2618,2652,7
Task 2618,Job 1,6,5,4,11,0,10,17,7,4,3,0,2618,2652,4
Task 2619,Job 0,7,10,4,12,0,11,19,8,4,3,0,2619,2653,16
Task 2619,Job 1,12,9,2,7,1,14,19,5,2,3,1,2619,2653,8
Task 2620,Job 0,6,6,4,11,0,10,17,7,4,3,2,2620,2653,20
Task 2620,Job 1,11,9,4,10,0,15,21,6,4,4,2,2620,2653,18
Task 2621,Job 0,8,9,1,9,0,9,17,8,1,1,2,2621,2655,9
Task 2621,Job 1,13,4,4,12,0,17,25,8,4,1,2,2621,2655,20
Task 2622,Job 0,4,4,1,8,0,5,12,7,1,1,2,2622,2655,13
Task 2622,Job 1,9,5,4,7,1,13,16,3,4,4,1,2622,2655,7
Task 2623,Job 0,10,4,2,9,0,12,19,7,2,1,0,2623,2657,18
Task 2623,Job 1,15,4,3,12,1,18,27,9,3,3,1,2623,2657,12
Task 2624,Job 0,4,9,4,10,0,8,14,6,4,2,2,2624,2657,20
Task 2624,Job 1,9,4,3,12,1,12,21,9,3,2,1,2624,2657,9
Task 2625,Job 0,9,4,1,8,0,10,17,7,1,2,2,2625,2659,7
Task 2625,Job 1,14,6,4,6,0,18,20,2,4,1,0,2625,2659,5
Task 2626,Job 0,5,9,2,8,0,7,13,6,2,2,0,2626,2659,17
Task 2626,Job 1,10,10,3,9,0,13,19,6,3,2,2,2626,2659,5
Task 2627,Job 0,5,4,4,8,0,9,13,4,4,1,1,2627,2661,6
Task 2627,Job 1,10,6,2,10,1,12,20,8,2,4,1,2627,2661,20
Task 2628,Job 0,4,9,2,11,0,6,15,9,2,2,0,2628,2662,12
Task 2628,Job 1,9,5,2,11,0,11,20,9,2,1,2,2628,2662,16
Task 2629,Job 0,6,6,3,11,0,9,17,8,3,1,0,2629,2662,8
Task 2629,Job 1,11,10,2,7,1,13,18,5,2,2,1,2629,2662,15
Task 2630,Job 0,2,7,4,11,0,6,13,7,4,4,0,2630,2663,19
Task 2630,Job 1,7,9,3,6,1,10,13,3,3,1,0,2630,2663,20
Task 2631,Job 0,4,9,1,9,0,5,13,8,1,4,0,2631,2664,2
Task 2631,Job 1,9,10,2,8,0,11,17,6,2,1,2,2631,2664,3
Task 2632,Job 0,2,4,1,12,1,3,14,11,1,4,2,2632,2666,20
Task 2632,Job 1,7,10,3,6,0,10,13,3,3,2,0,2632,2666,6
Task 2633,Job 0,9,10,3,7,1,12,16,4,3,1,2,2633,2667,9
Task 2633,Job 1,14,7,1,9,1,15,23,8,1,2,2,2633,2667,8
Task 2634,Job 0,4,5,2,11,1,6,15,9,2,3,0,2634,2668,9
Task 2634,Job 1,9,9,4,10,0,13,19,6,4,1,0,2634,2668,15
Task 2635,Job 0,6,10,4,10,1,10,16,6,4,2,1,2635,2668,10
Task 2635,Job 1,11,4,1,7,0,12,18,6,1,3,1,2635,2668,2
Task 2636,Job 0,5,6,3,10,0,8,15,7,3,4,1,2636,2669,3
Task 2636,Job 1,10,4,4,7,0,14,17,3,4,4,2,2636,2669,5
Task 2637,Job 0,7,5,2,8,0,9,15,6,2,1,1,2637,2670,11
Task 2637,Job 1,12,8,4,6,0,16,18,2,4,2,1,2637,2670,12
Task 2638,Job 0,4,9,3,6,1,7,10,3,3,1,0,2638,2672,11
Task 2638,Job 1,9,10,1,12,0,10,21,11,1,4,1,2638,2672,19
Task 2639,Job 0,8,6,2,7,0,10,15,5,2,4,0,2639,2673,17
Task 2639,Job 1,13,5,3,11,0,16,24,8,3,2,0,2639,2673,4
Task 2640,Job 0,3,6,2,7,1,5,10,5,2,1,0,2640,2674,9
Task 2640,Job 1,8,8,4,6,0,12,14,2,4,3,1,2640,2674,11
Task 2641,Job 0,5,9,2,12,1,7,17,10,2,2,1,2641,2675,11
Task 2641,Job 1,10,9,1,10,0,11,20,9,1,2,2,2641,2675,10
Task 2642,Job 0,2,8,4,7,0,6,9,3,4,3,2,2642,2675,18
Task 2642,Job 1,7,4,1,7,0,8,14,6,1,1,2,2642,2675,5
Task 2643,Job 0,9,9,1,9,0,10,18,8,1,3,2,2643,2677,3
Task 2643,Job 1,14,10,2,8,0,16,22,6,2,3,1,2643,2677,6
Task 2644,Job 0,7,6,3,11,0,10,18,8,3,1,0,2644,2678,18
Task 2644,Job 1,12,6,1,7,0,13,19,6,1,4,1,2644,2678,4
Task 2645,Job 0,5,6,4,11,0,9,16,7,4,4,1,2645,2678,18
Task 2645,Job 1,10,9,1,9,0,11,19,8,1,4,2,2645,2678,6
Task 2646,Job 0,4,8,4,6,0,8,10,2,4,4,0,2646,2680,12
Task 2646,Job 1,9,4,3,12,0,12,21,9,3,3,1,2646,2680,6
Task 2647,Job 0,6,8,1,12,0,7,18,11,1,1,1,2647,2680,3
Task 2647,Job 1,11,10,1,10,1,12,21,9,1,4,0,2647,2680,12
Task 2648,Job 0,9,9,1,12,0,10,21,11,1,3,1,2648,2682,6
Task 2648,Job 1,14,9,1,10,0,15,24,9,1,3,1,2648,2682,3
Task 2649,Job 0,3,4,2,11,0,5,14,9,2,1,2,2649,2682,20
Task 2649,Job 1,8,9,4,9,0,12,17,5,4,2,1,2649,2682,7
Task 2650,Job 0,4,5,2,11,0,6,15,9,2,3,1,2650,2683,12
Task 2650,Job 1,9,7,2,10,1,11,19,8,2,2,0,2650,2683,20
Task 2651,Job 0,9,4,2,10,0,11,19,8,2,3,1,2651,2685,15
Task 2651,Job 1,14,5,1,8,0,15,22,7,1,2,0,2651,2685,9
Task 2652,Job 0,10,4,2,12,0,12,22,10,2,2,0,2652,2685,12
Task 2652,Job 1,15,9,1,10,0,16,25,9,1,3,0,2652,2685,6
Task 2653,Job 0,3,7,3,9,0,6,12,6,3,4,0,2653,2686,13
Task 2653,Job 1,8,10,3,6,1,11,14,3,3,3,1,2653,2686,18
Task 2654,Job 0,5,4,4,9,0,9,14,5,4,4,2,2654,2688,17
Task 2654,Job 1,10,9,2,10,1,12,20,8,2,1,2,2654,2688,3
Task 2655,Job 0,4,7,2,12,0,6,16,10,2,4,1,2655,2688,18
Task 2655,Job 1,9,10,3,11,1,12,20,8,3,2,1,2655,2688,2
Task 2656,Job 0,1,9,1,11,0,2,12,10,1,1,2,2656,2690,11
Task 2656,Job 1,6,7,4,10,0,10,16,6,4,3,0,2656,2690,12
Task 2657,Job 0,8,7,3,12,0,11,20,9,3,3,0,2657,2690,8
Task 2657,Job 1,13,9,3,7,0,16,20,4,3,2,0,2657,2690,5
Task 2658,Job 0,4,8,1,6,0,5,10,5,1,4,1,2658,2692,4
Task 2658,Job 1,9,8,3,10,0,12,19,7,3,1,2,2658,2692,10
Task 2659,Job 0,1,4,4,8,0,5,9,4,4,1,2,2659,2693,17
Task 2659,Job 1,6,6,4,12,0,10,18,8,4,4,0,2659,2693,11
Task 2660,Job 0,5,9,3,6,0,8,11,3,3,3,2,2660,2693,11
Task 2660,Job 1,10,9,3,10,0,13,20,7,3,2,2,2660,2693,11
Task 2661,Job 0,7,8,4,7,0,11,14,3,4,4,0,2661,2695,19
Task 2661,Job 1,12,7,1,10,1,13,22,9,1,4,1,2661,2695,2
Task 2662,Job 0,6,9,3,11,0,9,17,8,3,1,0,2662,2696,15
Task 2662,Job 1,11,10,4,9,1,15,20,5,4,2,0,2662,2696,4
Task 2663,Job 0,4,5,2,6,0,6,10,4,2,4,2,2663,2697,13
Task 2663,Job 1,9,5,1,7,0,10,16,6,1,3,0,2663,2697,19
Task 2664,Job 0,8,9,4,12,0,12,20,8,4,4,1,2664,2697,11
Task 2664,Job 1,13,9,2,12,1,15,25,10,2,4,2,2664,2697,20
Task 2665,Job 0,7,9,3,9,1,10,16,6,3,1,0,2665,2699,7
Task 2665,Job 1,12,8,1,12,0,13,24,11,1,1,2,2665,2699,12
Task 2666,Job 0,8,5,1,12,0,9,20,11,1,1,1,2666,2700,10
Task 2666,Job 1,13,6,1,6,0,14,19,5,1,1,1,2666,2700,3
Task 2667,Job 0,8,8,2,11,0,10,19,9,2,1,1,2667,2701,19
Task 2667,Job 1,13,4,1,6,0,14,19,5,1,1,1,2667,2701,19
Task 2668,Job 0,1,4,1,7,0,2,8,6,1,3,1,2668,2702,3
Task 2668,Job 1,6,10,3,9,0,9,15,6,3,3,2,2668,2702,12
Task 2669,Job 0,9,6,1,6,0,10,15,5,1,2,1,2669,2703,9
Task 2669,Job 1,14,4,2,9,0,16,23,7,2,3,0,2669,2703,3
Task 2670,Job 0,4,6,1,11,0,5,15,10,1,4,0,2670,2704,19
Task 2670,Job 1,9,6,4,7,0,13,16,3,4,2,1,2670,2704,13
Task 2671,Job 0,9,7,2,8,0,11,17,6,2,1,2,2671,2704,10
Task 2671,Job 1,14,4,4,9,0,18,23,5,4,2,2,2671,2704,8
Task 2672,Job 0,7,8,1,7,1,8,14,6,1,3,2,2672,2706,8
Task 2672,Job 1,12,6,3,7,0,15,19,4,3,2,0,2672,2706,14
Task 2673,Job 0,5,5,2,9,0,7,14,7,2,4,2,2673,2706,7
Task 2673,Job 1,10,10,1,8,0,11,18,7,1,2,1,2673,2706,17
Task 2674,Job 0,4,8,2,6,1,6,10,4,2,4,2,2674,2708,3
Task 2674,Job 1,9,5,2,12,1,11,21,10,2,1,2,2674,2708,7
Task 2675,Job 0,4,4,2,8,0,6,12,6,2,3,1,2675,2708,8
Task 2675,Job 1,9,9,3,6,1,12,15,3,3,1,0,2675,2708,10
Task 2676,Job 0,6,10,1,7,0,7,13,6,1,2,1,2676,2709,15
Task 2676,Job 1,11,5,2,6,0,13,17,4,2,1,1,2676,2709,2
Task 2677,Job 0,1,4,4,9,0,5,10,5,4,1,2,2677,2710,3
Task 2677,Job 1,6,9,1,11,0,7,17,10,1,4,1,2677,2710,20
Task 2678,Job 0,6,4,2,7,0,8,13,5,2,2,2,2678,2712,10
Task 2678,Job 1,11,7,3,11,0,14,22,8,3,3,2,2678,2712,9
Task 2679,Job 0,2,8,4,6,1,6,8,2,4,4,2,2679,2713,14
Task 2679,Job 1,7,8,3,8,0,10,15,5,3,2,2,2679,2713,16
Task 2680,Job 0,8,9,4,10,0,12,18,6,4,2,1,2680,2713,3
Task 2680,Job 1,13,7,1,7,0,14,20,6,1,1,1,2680,2713,8
Task 2681,Job 0,3,5,3,9,0,6,12,6,3,4,0,2681,2715,10
Task 2681,Job 1,8,10,3,10,0,11,18,7,3,4,2,2681,2715,16
Task 2682,Job 0,2,6,2,7,0,4,9,5,2,1,1,2682,2715,8
Task 2682,Job 1,7,4,2,8,1,9,15,6,2,4,1,2682,2715,15
Task 2683,Job 0,7,6,3,9,0,10,16,6,3,2,0,2683,2716,13
Task 2683,Job 1,12,8,1,10,0,13,22,9,1,1,1,2683,2716,8
Task 2684,Job 0,4,10,4,12,0,8,16,8,4,2,2,2684,2717,5
Task 2684,Job 1,9,10,1,12,1,10,21,11,1,2,1,2684,2717,3
Task 2685,Job 0,2,9,1,7,0,3,9,6,1,3,1,2685,2719,17
Task 2685,Job 1,7,4,4,9,1,11,16,5,4,1,1,2685,2719,8
Task 2686,Job 0,9,10,4,9,1,13,18,5,4,1,1,2686,2720,10
Task 2686,Job 1,14,5,2,8,0,16,22,6,2,1,1,2686,2720,12
Task 2687,Job 0,5,10,2,11,0,7,16,9,2,4,2,2687,2721,4
Task 2687,Job 1,10,9,3,7,0,13,17,4,3,4,1,2687,2721,5
Task 2688,Job 0,2,4,1,12,0,3,14,11,1,4,2,2688,2722,12
Task 2688,Job 1,7,5,4,9,0,11,16,5,4,3,2,2688,2722,19
Task 2689,Job 0,4,6,4,12,0,8,16,8,4,4,2,2689,2722,2
Task 2689,Job 1,9,6,1,10,0,10,19,9,1,3,1,2689,2722,9
Task 2690,Job 0,1,9,3,10,0,4,11,7,3,3,0,2690,2724,13
Task 2690,Job 1,6,8,4,8,0,10,14,4,4,3,1,2690,2724,12
Task 2691,Job 0,8,6,1,9,0,9,17,8,1,4,2,2691,2724,5
Task 2691,Job 1,13,6,4,7,0,17,20,3,4,1,0,2691,2724,9
Task 2692,Job 0,10,10,2,11,0,12,21,9,2,4,0,2692,2725,20
Task 2692,Job 1,15,9,1,11,0,16,26,10,1,4,0,2692,2725,19
Task 2693,Job 0,8,6,3,6,1,11,14,3,3,2,2,2693,2726,6
Task 2693,Job 1,13,10,2,10,0,15,23,8,2,1,0,2693,2726,5
Task 2694,Job 0,9,7,2,6,1,11,15,4,2,4,1,2694,2728,17
Task 2694,Job 1,14,10,4,10,1,18,24,6,4,1,0,2694,2728,6
Task 2695,Job 0,3,4,1,12,1,4,15,11,1,2,2,2695,2729,11
Task 2695,Job 1,8,9,1,12,0,9,20,11,1,1,2,2695,2729,6
Task 2696,Job 0,6,10,3,11,1,9,17,8,3,1,1,2696,2729,10
Task 2696,Job 1,11,4,2,9,0,13,20,7,2,4,0,2696,2729,18
Task 2697,Job 0,3,10,3,9,1,6,12,6,3,1,2,2697,2731,12
Task 2697,Job 1,8,9,4,11,0,12,19,7,4,4,2,2697,2731,11
Task 2698,Job 0,9,9,1,10,0,10,19,9,1,3,2,2698,2732,18
Task 2698,Job 1,14,8,4,9,1,18,23,5,4,1,1,2698,2732,9
Task 2699,Job 0,2,10,1,6,1,3,8,5,1,2,2,2699,2733,17
Task 2699,Job 1,7,6,4,6,1,11,13,2,4,2,1,2699,2733,2
Task 2700,Job 0,7,6,4,12,0,11,19,8,4,2,1,2700,2734,19
Task 2700,Job 1,12,7,4,8,0,16,20,4,4,3,2,2700,2734,14
Task 2701,Job 0,10,5,1,6,0,11,16,5,1,1,2,2701,2734,2
Task 2701,Job 1,15,5,2,10,0,17,25,8,2,4,2,2701,2734,4
Task 2702,Job 0,3,8,3,9,0,6,12,6,3,3,2,2702,2736,11
Task 2702,Job 1,8,4,3,11,1,11,19,8,3,2,1,2702,2736,5
Task 2703,Job 0,4,10,4,10,0,8,14,6,4,1,1,2703,2736,19
Task 2703,Job 1,9,10,3,12,0,12,21,9,3,4,1,2703,2736,8
Task 2704,Job 0,10,8,1,9,0,11,19,8,1,3,0,2704,2737,20
Task 2704,Job 1,15,8,1,6,1,16,21,5,1,3,0,2704,2737,12
Task 2705,Job 0,5,9,1,11,0,6,16,10,1,4,1,2705,2738,2
Task 2705,Job 1,10,7,2,10,0,12,20,8,2,2,0,2705,2738,15
Task 2706,Job 0,9,4,2,7,0,11,16,5,2,3,1,2706,2740,19
Task 2706,Job 1,14,5,3,12,0,17,26,9,3,4,2,2706,2740,9
Task 2707,Job 0,2,6,2,10,0,4,12,8,2,1,0,2707,2741,17
Task 2707,Job 1,7,7,3,8,0,10,15,5,3,4,0,2707,2741,2
Task 2708,Job 0,4,5,3,7,1,7,11,4,3,1,2,2708,2741,14
Task 2708,Job 1,9,4,1,12,0,10,21,11,1,1,2,2708,2741,13
Task 2709,Job 0,2,4,4,11,0,6,13,7,4,1,1,2709,2742,9
Task 2709,Job 1,7,4,1,12,0,8,19,11,1,2,1,2709,2742,12
Task 2710,Job 0,3,8,1,9,0,4,12,8,1,1,2,2710,2743,4
Task 2710,Job 1,8,5,1,7,0,9,15,6,1,4,0,2710,2743,7
Task 2711,Job 0,7,5,1,9,0,8,16,8,1,2,2,2711,2745,20
Task 2711,Job 1,12,4,2,12,1,14,24,10,2,3,1,2711,2745,3
Task 2712,Job 0,3,8,2,8,1,5,11,6,2,1,2,2712,2745,11
Task 2712,Job 1,8,10,3,10,0,11,18,7,3,2,2,2712,2745,13
Task 2713,Job 0,9,5,1,10,1,10,19,9,1,1,1,2713,2747,18
Task 2713,Job 1,14,7,1,8,0,15,22,7,1,2,2,2713,2747,9
Task 2714,Job 0,3,9,3,12,0,6,15,9,3,3,2,2714,2748,19
Task 2714,Job 1,8,5,3,11,0,11,19,8,3,4,2,2714,2748,14
Task 2715,Job 0,2,6,1,6,1,3,8,5,1,3,1,2715,2748,17
Task 2715,Job 1,7,7,2,9,1,9,16,7,2,2,1,2715,2748,12
Task 2716,Job 0,8,5,2,10,0,10,18,8,2,2,1,2716,2749,18
Task 2716,Job 1,13,7,3,7,0,16,20,4,3,2,0,2716,2749,20
Task 2717,Job 0,10,6,1,8,1,11,18,7,1,3,1,2717,2750,14
Task 2717,Job 1,15,9,3,8,1,18,23,5,3,3,1,2717,2750,17
Task 2718,Job 0,9,9,4,10,0,13,19,6,4,4,1,2718,2751,13
Task 2718,Job 1,14,8,2,8,0,16,22,6,2,4,1,2718,2751,4
Task 2719,Job 0,7,4,1,6,0,8,13,5,1,2,2,2719,2753,5
Task 2719,Job 1,12,4,1,6,0,13,18,5,1,2,2,2719,2753,4
Task 2720,Job 0,9,5,3,8,0,12,17,5,3,1,1,2720,2753,2
Task 2720,Job 1,14,5,3,7,1,17,21,4,3,3,0,2720,2753,15
Task 2721,Job 0,6,7,4,11,1,10,17,7,4,4,2,2721,2754,6
Task 2721,Job 1,11,7,2,11,0,13,22,9,2,1,1,2721,2754,7
Task 2722,Job 0,4,10,3,12,0,7,16,9,3,4,0,2722,2756,13
Task 2722,Job 1,9,4,3,12,0,12,21,9,3,4,2,2722,2756,17
Task 2723,Job 0,9,10,3,10,0,12,19,7,3,4,0,2723,2756,12
Task 2723,Job 1,14,4,2,7,0,16,21,5,2,4,2,2723,2756,17
Task 2724,Job 0,5,10,4,10,1,9,15,6,4,3,2,2724,2758,2
Task 2724,Job 1,10,7,4,12,0,14,22,8,4,1,2,2724,2758,6
Task 2725,Job 0,10,5,1,12,1,11,22,11,1,4,1,2725,2759,8
Task 2725,Job 1,15,8,2,7,0,17,22,5,2,3,1,2725,2759,2
Task 2726,Job 0,6,6,1,6,0,7,12,5,1,2,2,2726,2760,18
Task 2726,Job 1,11,9,2,10,0,13,21,8,2,1,1,2726,2760,9
Task 2727,Job 0,6,8,2,7,0,8,13,5,2,3,1,2727,2760,5
Task 2727,Job 1,11,9,2,8,0,13,19,6,2,4,2,2727,2760,20
Task 2728,Job 0,8,9,2,12,0,10,20,10,2,2,2,2728,2762,6
Task 2728,Job 1,13,6,2,12,1,15,25,10,2,2,2,2728,2762,15
Task 2729,Job 0,9,7,4,8,1,13,17,4,4,3,0,2729,2762,13
Task 2729,Job 1,14,5,4,7,0,18,21,3,4,3,1,2729,2762,13
Task 2730,Job 0,9,5,1,11,0,10,20,10,1,1,1,2730,2763,19
Task 2730,Job 1,14,7,4,12,0,18,26,8,4,3,0,2730,2763,15
Task 2731,Job 0,2,8,1,6,0,3,8,5,1,3,2,2731,2765,12
Task 2731,Job 1,7,4,4,12,0,11,19,8,4,1,0,2731,2765,9
Task 2732,Job 0,3,4,1,8,1,4,11,7,1,3,1,2732,2765,10
Task 2732,Job 1,8,6,1,12,0,9,20,11,1,1,0,2732,2765,12
Task 2733,Job 0,9,7,2,9,0,11,18,7,2,1,0,2733,2767,19
Task 2733,Job 1,14,7,1,10,0,15,24,9,1,3,2,2733,2767,6
Task 2734,Job 0,3,8,2,12,0,5,15,10,2,3,0,2734,2768,20
Task 2734,Job 1,8,5,4,9,1,12,17,5,4,1,1,2734,2768,17
Task 2735,Job 0,9,9,4,11,1,13,20,7,4,2,1,2735,2769,13
Task 2735,Job 1,14,6,1,10,0,15,24,9,1,2,2,2735,2769,15
Task 2736,Job 0,9,5,3,6,0,12,15,3,3,3,0,2736,2770,7
Task 2736,Job 1,14,5,2,11,0,16,25,9,2,3,1,2736,2770,10
Task 2737,Job 0,1,6,1,6,1,2,7,5,1,1,1,2737,2771,6
Task 2737,Job 1,6,6,3,7,0,9,13,4,3,2,1,2737,2771,11
Task 2738,Job 0,5,7,1,7,0,6,12,6,1,3,2,2738,2772,20
Task 2738,Job 1,10,7,1,7,0,11,17,6,1,2,0,2738,2772,14
Task 2739,Job 0,5,8,1,6,0,6,11,5,1,4,2,2739,2773,18
Task 2739,Job 1,10,4,1,8,0,11,18,7,1,1,0,2739,2773,17
Task 2740,Job 0,5,7,2,9,1,7,14,7,2,2,2,2740,2773,19
Task 2740,Job 1,10,10,4,11,1,14,21,7,4,3,0,2740,2773,6
Task 2741,Job 0,4,5,2,6,0,6,10,4,2,2,0,2741,2775,7
Task 2741,Job 1,9,8,3,11,0,12,20,8,3,4,1,2741,2775,5
Task 2742,Job 0,10,4,3,9,1,13,19,6,3,1,2,2742,2775,15
Task 2742,Job 1,15,6,3,9,0,18,24,6,3,3,0,2742,2775,3
Task 2743,Job 0,5,5,3,9,0,8,14,6,3,4,0,2743,2777,13
Task 2743,Job 1,10,10,1,6,1,11,16,5,1,1,2,2743,2777,19
Task 2744,Job 0,6,5,3,8,0,9,14,5,3,3,0,2744,2777,9
Task 2744,Job 1,11,7,2,12,0,13,23,10,2,1,1,2744,2777,5
Task 2745,Job 0,1,6,2,7,0,3,8,5,2,3,1,2745,2779,6
Task 2745,Job 1,6,5,4,9,0,10,15,5,4,1,2,2745,2779,6
Task 2746,Job 0,5,4,2,7,0,7,12,5,2,2,1,2746,2780,5
Task 2746,Job 1,10,4,1,7,0,11,17,6,1,3,2,2746,2780,19
Task 2747,Job 0,2,7,4,9,0,6,11,5,4,2,0,2747,2781,11
Task 2747,Job 1,7,5,4,12,0,11,19,8,4,3,0,2747,2781,18
Task 2748,Job 0,4,6,4,7,1,8,11,3,4,3,1,2748,2782,16
Task 2748,Job 1,9,10,3,7,0,12,16,4,3,3,2,2748,2782,16
Task 2749,Job 0,5,4,3,12,1,8,17,9,3,2,1,2749,2783,9
Task 2749,Job 1,10,5,4,11,0,14,21,7,4,4,0,2749,2783,20
Task 2750,Job 0,2,10,4,9,1,6,11,5,4,2,0,2750,2783,5
Task 2750,Job 1,7,7,3,6,0,10,13,3,3,2,0,2750,2783,8
Task 2751,Job 0,2,4,2,12,0,4,14,10,2,1,0,2751,2785,12
Task 2751,Job 1,7,6,3,12,0,10,19,9,3,2,0,2751,2785,2
Task 2752,Job 0,10,10,4,10,1,14,20,6,4,4,0,2752,2785,19
Task 2752,Job 1,15,5,4,9,0,19,24,5,4,4,2,2752,2785,18
Task 2753,Job 0,2,5,2,10,0,4,12,8,2,4,2,2753,2786,18
Task 2753,Job 1,7,8,3,11,0,10,18,8,3,3,0,2753,2786,19
Task 2754,Job 0,3,6,4,7,1,7,10,3,4,3,0,2754,2788,5
Task 2754,Job 1,8,9,1,12,0,9,20,11,1,1,2,2754,2788,20
Task 2755,Job 0,6,9,4,7,1,10,13,3,4,3,2,2755,2789,8
Task 2755,Job 1,11,6,1,12,0,12,23,11,1,2,0,2755,2789,13
Task 2756,Job 0,2,6,1,12,0,3,14,11,1,3,0,2756,2790,16
Task 2756,Job 1,7,5,4,12,0,11,19,8,4,1,1,2756,2790,20
Task 2757,Job 0,2,5,4,8,0,6,10,4,4,4,1,2757,2791,19
Task 2757,Job 1,7,8,1,7,0,8,14,6,1,3,1,2757,2791,16
Task 2758,Job 0,9,9,3,6,0,12,15,3,3,2,2,2758,2791,4
Task 2758,Job 1,14,8,1,9,0,15,23,8,1,2,1,2758,2791,7
Task 2759,Job 0,2,4,3,10,0,5,12,7,3,2,0,2759,2793,17
Task 2759,Job 1,7,8,3,7,0,10,14,4,3,2,0,2759,2793,15
Task 2760,Job 0,9,8,2,7,0,11,16,5,2,3,2,2760,2794,3
Task 2760,Job 1,14,4,3,10,0,17,24,7,3,4,0,2760,2794,12
Task 2761,Job 0,1,6,4,9,1,5,10,5,4,1,1,2761,2794,14
Task 2761,Job 1,6,7,1,7,1,7,13,6,1,3,0,2761,2794,10
Task 2762,Job 0,1,8,1,8,1,2,9,7,1,4,1,2762,2795,9
Task 2762,Job 1,6,6,2,7,1,8,13,5,2,1,1,2762,2795,7
Task 2763,Job 0,10,4,1,8,0,11,18,7,1,1,0,2763,2797,17
Task 2763,Job 1,15,5,4,6,0,19,21,2,4,4,0,2763,2797,14
Task 2764,Job 0,1,8,2,6,1,3,7,4,2,4,0,2764,2798,4
Task 2764,Job 1,6,8,1,6,1,7,12,5,1,2,1,2764,2798,8
Task 2765,Job 0,10,4,1,12,0,11,22,11,1,1,0,2765,2798,11
Task 2765,Job 1,15,4,3,6,0,18,21,3,3,3,2,2765,2798,13
Task 2766,Job 0,9,10,4,6,0,13,15,2,4,2,2,2766,2799,4
Task 2766,Job 1,14,8,4,6,0,18,20,2,4,1,1,2766,2799,12
Task 2767,Job 0,10,9,4,12,0,14,22,8,4,1,2,2767,2801,12
Task 2767,Job 1,15,7,4,8,0,19,23,4,4,3,2,2767,2801,19
Task 2768,Job 0,5,10,2,9,0,7,14,7,2,1,2,2768,2801,17
Task 2768,Job 1,10,9,2,11,0,12,21,9,2,1,1,2768,2801,15
Task 2769,Job 0,5,8,2,11,0,7,16,9,2,3,0,2769,2803,11
Task 2769,Job 1,10,6,1,10,0,11,20,9,1,2,2,2769,2803,17
Task 2770,Job 0,5,5,3,12,1,8,17,9,3,3,1,2770,2804,10
Task 2770,Job 1,10,7,3,12,0,13,22,9,3,4,2,2770,2804,15
Task 2771,Job 0,4,9,4,8,0,8,12,4,4,2,2,2771,2804,8
Task 2771,Job 1,9,7,2,8,0,11,17,6,2,3,2,2771,2804,5
Task 2772,Job 0,4,6,4,7,0,8,11,3,4,1,0,2772,2805,13
Task 2772,Job 1,9,7,1,7,0,10,16,6,1,4,1,2772,2805,7
Task 2773,Job 0,6,9,1,7,0,7,13,6,1,1,2,2773,2806,4
Task 2773,Job 1,11,10,4,10,1,15,21,6,4,4,0,2773,2806,12
Task 2774,Job 0,2,5,2,9,1,4,11,7,2,2,0,2774,2808,8
Task 2774,Job 1,7,4,1,11,0,8,18,10,1,3,0,2774,2808,5
Task 2775,Job 0,9,9,4,6,0,13,15,2,4,1,2,2775,2808,16
Task 2775,Job 1,14,7,1,12,0,15,26,11,1,2,0,2775,2808,11
Task 2776,Job 0,6,10,1,11,1,7,17,10,1,3,1,2776,2809,3
Task 2776,Job 1,11,9,1,6,0,12,17,5,1,2,0,2776,2809,10
Task 2777,Job 0,5,7,4,9,1,9,14,5,4,4,0,2777,2810,10
Task 2777,Job 1,10,5,4,8,0,14,18,4,4,1,1,2777,2810,16
Task 2778,Job 0,9,6,3,6,0,12,15,3,3,2,2,2778,2812,6
Task 2778,Job 1,14,5,2,11,0,16,25,9,2,2,1,2778,2812,18
Task 2779,Job 0,9,9,4,8,0,13,17,4,4,3,0,2779,2812,17
Task 2779,Job 1,14,9,1,9,0,15,23,8,1,4,0,2779,2812,9
Task 2780,Job 0,3,6,4,8,0,7,11,4,4,3,0,2780,2814,6
Task 2780,Job 1,8,8,2,12,0,10,20,10,2,4,1,2780,2814,10
Task 2781,Job 0,2,5,1,7,0,3,9,6,1,1,0,2781,2814,4
Task 2781,Job 1,7,5,3,7,0,10,14,4,3,2,0,2781,2814,4
Task 2782,Job 0,10,9,4,9,1,14,19,5,4,1,0,2782,2816,5
Task 2782,Job 1,15,4,2,9,0,17,24,7,2,4,2,2782,2816,9
Task 2783,Job 0,5,9,1,8,1,6,13,7,1,4,2,2783,2816,5
Task 2783,Job 1,10,7,3,10,1,13,20,7,3,2,0,2783,2816,2
Task 2784,Job 0,6,5,1,8,0,7,14,7,1,2,2,2784,2818,18
Task 2784,Job 1,11,8,4,8,0,15,19,4,4,4,0,2784,2818,13
Task 2785,Job 0,5,9,1,9,0,6,14,8,1,2,2,2785,2819,20
Task 2785,Job 1,10,8,1,6,0,11,16,5,1,1,2,2785,2819,14
Task 2786,Job 0,2,4,4,11,1,6,13,7,4,3,2,2786,2819,8
Task 2786,Job 1,7,6,3,9,0,10,16,6,3,2,2,2786,2819,12
Task 2787,Job 0,1,10,4,10,0,5,11,6,4,1,0,2787,2820,17
Task 2787,Job 1,6,8,3,11,0,9,17,8,3,1,0,2787,2820,7
Task 2788,Job 0,10,10,1,9,0,11,19,8,1,2,0,2788,2822,4
Task 2788,Job 1,15,9,2,8,0,17,23,6,2,3,2,2788,2822,9
Task 2789,Job 0,4,10,1,6,0,5,10,5,1,4,1,2789,2822,5
Task 2789,Job 1,9,6,1,12,0,10,21,11,1,3,0,2789,2822,20
Task 2790,Job 0,9,10,1,11,0,10,20,10,1,4,2,2790,2823,9
Task 2790,Job 1,14,6,3,8,0,17,22,5,3,1,0,2790,2823,6
Task 2791,Job 0,5,10,1,8,0,6,13,7,1,4,1,2791,2825,16
Task 2791,Job 1,10,5,2,7,0,12,17,5,2,4,0,2791,2825,16
Task 2792,Job 0,1,5,2,11,1,3,12,9,2,2,1,2792,2825,14
Task 2792,Job 1,6,10,1,6,1,7,12,5,1,1,2,2792,2825,5
Task 2793,Job 0,10,6,4,9,0,14,19,5,4,3,2,2793,2826,19
Task 2793,Job 1,15,6,1,10,0,16,25,9,1,2,2,2793,2826,19
Task 2794,Job 0,1,9,4,9,1,5,10,5,4,2,2,2794,2827,5
Task 2794,Job 1,6,5,3,11,1,9,17,8,3,1,2,2794,2827,6
Task 2795,Job 0,5,5,2,6,0,7,11,4,2,1,1,2795,2829,3
Task 2795,Job 1,10,10,2,6,0,12,16,4,2,2,1,2795,2829,17
Task 2796,Job 0,8,10,3,11,0,11,19,8,3,2,2,2796,2830,5
Task 2796,Job 1,13,10,2,10,0,15,23,8,2,4,2,2796,2830,11
Task 2797,Job 0,1,7,2,10,0,3,11,8,2,2,0,2797,2831,19
Task 2797,Job 1,6,6,2,12,1,8,18,10,2,4,1,2797,2831,16
Task 2798,Job 0,7,9,2,11,0,9,18,9,2,3,0,2798,2831,11
Task 2798,Job 1,12,5,4,7,1,16,19,3,4,3,0,2798,2831,4
Task 2799,Job 0,1,4,3,10,0,4,11,7,3,1,1,2799,2832,13
Task 2799,Job 1,6,10,3,11,0,9,17,8,3,3,2,2799,2832,6
Task 2800,Job 0,2,8,1,11,0,3,13,10,1,1,1,2800,2834,18
Task 2800,Job 1,7,5,3,7,0,10,14,4,3,4,2,2800,2834,20
Task 2801,Job 0,1,9,2,11,1,3,12,9,2,1,0,2801,2835,6
Task 2801,Job 1,6,8,2,6,1,8,12,4,2,1,0,2801,2835,5
Task 2802,Job 0,4,9,2,6,0,6,10,4,2,3,1,2802,2836,11
Task 2802,Job 1,9,9,2,7,0,11,16,5,2,2,1,2802,2836,18
Task 2803,Job 0,1,5,1,8,0,2,9,7,1,1,1,2803,2837,9
Task 2803,Job 1,6,10,4,9,0,10,15,5,4,2,2,2803,2837,10
Task 2804,Job 0,6,5,4,7,0,10,13,3,4,4,1,2804,2838,5
Task 2804,Job 1,11,10,1,8,0,12,19,7,1,3,0,2804,2838,9
Task 2805,Job 0,2,6,2,10,0,4,12,8,2,4,0,2805,2839,15
Task 2805,Job 1,7,8,2,9,0,9,16,7,2,3,2,2805,2839,15
Task 2806,Job 0,3,6,1,9,1,4,12,8,1,1,0,2806,2840,14
Task 2806,Job 1,8,9,3,11,0,11,19,8,3,4,0,2806,2840,13
Task 2807,Job 0,6,4,2,10,0,8,16,8,2,2,0,2807,2841,20
Task 2807,Job 1,11,7,3,11,0,14,22,8,3,2,2,2807,2841,13
Task 2808,Job 0,1,10,4,12,0,5,13,8,4,2,1,2808,2842,10
Task 2808,Job 1,6,10,2,11,0,8,17,9,2,3,2,2808,2842,14
Task 2809,Job 0,1,6,1,11,1,2,12,10,1,4,2,2809,2843,6
Task 2809,Job 1,6,10,3,10,0,9,16,7,3,3,1,2809,2843,8
Task 2810,Job 0,7,10,2,9,0,9,16,7,2,4,2,2810,2843,15
Task 2810,Job 1,12,9,2,6,1,14,18,4,2,1,2,2810,2843,5
Task 2811,Job 0,3,4,2,6,0,5,9,4,2,2,0,2811,2845,5
Task 2811,Job 1,8,6,4,9,0,12,17,5,4,1,2,2811,2845,20
Task 2812,Job 0,10,6,2,6,1,12,16,4,2,1,1,2812,2845,11
Task 2812,Job 1,15,10,2,12,0,17,27,10,2,4,2,2812,2845,17
Task 2813,Job 0,5,9,2,10,0,7,15,8,2,4,1,2813,2846,12
Task 2813,Job 1,10,5,3,12,0,13,22,9,3,4,2,2813,2846,17
Task 2814,Job 0,7,8,4,11,0,11,18,7,4,1,0,2814,2847,15
Task 2814,Job 1,12,7,2,10,0,14,22,8,2,3,2,2814,2847,11
Task 2815,Job 0,3,10,3,9,0,6,12,6,3,3,1,2815,2849,14
Task 2815,Job 1,8,6,4,10,1,12,18,6,4,2,1,2815,2849,20
Task 2816,Job 0,4,8,3,9,1,7,13,6,3,4,2,2816,2850,16
Task 2816,Job 1,9,7,3,11,1,12,20,8,3,1,0,2816,2850,7
Task 2817,Job 0,8,4,3,12,1,11,20,9,3,3,2,2817,2851,10
Task 2817,Job 1,13,10,2,6,0,15,19,4,2,2,0,2817,2851,5
Task 2818,Job 0,6,9,1,11,0,7,17,10,1,4,0,2818,2851,10
Task 2818,Job 1,11,10,1,11,1,12,22,10,1,1,2,2818,2851,3
Task 2819,Job 0,7,4,4,6,0,11,13,2,4,3,0,2819,2853,15
Task 2819,Job 1,12,5,1,7,0,13,19,6,1,4,0,2819,2853,8
Task 2820,Job 0,9,10,2,12,0,11,21,10,2,3,1,2820,2853,18
Task 2820,Job 1,14,10,4,11,0,18,25,7,4,3,2,2820,2853,9
Task 2821,Job 0,2,6,3,12,1,5,14,9,3,3,1,2821,2855,15
Task 2821,Job 1,7,9,1,11,0,8,18,10,1,4,1,2821,2855,16
Task 2822,Job 0,2,8,1,8,1,3,10,7,1,4,0,2822,2856,5
Task 2822,Job 1,7,9,2,7,1,9,14,5,2,1,0,2822,2856,13
Task 2823,Job 0,2,10,4,8,0,6,10,4,4,2,1,2823,2857,19
Task 2823,Job 1,7,4,2,9,0,9,16,7,2,2,2,2823,2857,2
Task 2824,Job 0,9,6,1,11,0,10,20,10,1,1,2,2824,2858,17
Task 2824,Job 1,14,9,1,11,0,15,25,10,1,3,1,2824,2858,20
Task 2825,Job 0,7,8,2,12,0,9,19,10,2,3,1,2825,2859,15
Task 2825,Job 1,12,8,1,7,0,13,19,6,1,3,0,2825,2859,7
Task 2826,Job 0,10,9,3,7,0,13,17,4,3,4,0,2826,2860,7
Task 2826,Job 1,15,9,2,9,0,17,24,7,2,3,0,2826,2860,6
Task 2827,Job 0,8,5,3,12,1,11,20,9,3,3,1,2827,2861,5
Task 2827,Job 1,13,5,1,9,1,14,22,8,1,4,2,2827,2861,16
Task 2828,Job 0,3,4,2,11,0,5,14,9,2,3,1,2828,2862,4
Task 2828,Job 1,8,7,3,8,0,11,16,5,3,4,1,2828,2862,15
Task 2829,Job 0,6,7,1,12,0,7,18,11,1,3,2,2829,2862,15
Task 2829,Job 1,11,7,1,12,0,12,23,11,1,1,0,2829,2862,3
Task 2830,Job 0,8,10,3,10,0,11,18,7,3,4,1,2830,2863,9
Task 2830,Job 1,13,6,2,10,0,15,23,8,2,1,0,2830,2863,3
Task 2831,Job 0,6,9,3,9,1,9,15,6,3,1,0,2831,2864,20
Task 2831,Job 1,11,7,4,12,0,15,23,8,4,2,0,2831,2864,11
Task 2832,Job 0,3,6,2,12,0,5,15,10,2,4,2,2832,2865,3
Task 2832,Job 1,8,8,3,10,0,11,18,7,3,1,2,2832,2865,6
Task 2833,Job 0,2,4,4,7,0,6,9,3,4,4,2,2833,2867,7
Task 2833,Job 1,7,10,3,10,1,10,17,7,3,4,1,2833,2867,16
Task 2834,Job 0,9,8,4,6,0,13,15,2,4,1,2,2834,2868,3
Task 2834,Job 1,14,6,3,12,0,17,26,9,3,1,2,2834,2868,8
Task 2835,Job 0,8,4,4,6,0,12,14,2,4,2,0,2835,2869,19
Task 2835,Job 1,13,4,4,11,0,17,24,7,4,3,0,2835,2869,14
Task 2836,Job 0,1,4,4,9,1,5,10,5,4,2,1,2836,2870,17
Task 2836,Job 1,6,10,2,11,0,8,17,9,2,1,0,2836,2870,6
Task 2837,Job 0,1,5,2,6,0,3,7,4,2,2,1,2837,2870,16
Task 2837,Job 1,6,10,1,11,0,7,17,10,1,1,1,2837,2870,18
Task 2838,Job 0,7,9,1,7,0,8,14,6,1,1,2,2838,2871,16
Task 2838,Job 1,12,10,1,8,0,13,20,7,1,3,2,2838,2871,7
Task 2839,Job 0,2,9,4,11,0,6,13,7,4,3,1,2839,2873,19
Task 2839,Job 1,7,6,3,12,0,10,19,9,3,4,1,2839,2873,17
Task 2840,Job 0,3,8,2,8,0,5,11,6,2,4,1,2840,2873,16
Task 2840,Job 1,8,4,4,7,0,12,15,3,4,1,2,2840,2873,12
Task 2841,Job 0,10,4,4,9,1,14,19,5,4,1,2,2841,2875,13
Task 2841,Job 1,15,5,1,7,0,16,22,6,1,3,1,2841,2875,7
Task 2842,Job 0,9,4,3,7,0,12,16,4,3,3,0,2842,2876,20
Task 2842,Job 1,14,5,3,9,1,17,23,6,3,3,1,2842,2876,16
Task 2843,Job 0,6,7,4,11,0,10,17,7,4,4,2,2843,2876,19
Task 2843,Job 1,11,8,3,6,0,14,17,3,3,1,2,2843,2876,15
Task 2844,Job 0,9,4,4,7,0,13,16,3,4,3,2,2844,2878,3
Task 2844,Job 1,14,8,3,10,0,17,24,7,3,3,1,2844,2878,17
Task 2845,Job 0,2,8,3,12,0,5,14,9,3,1,1,2845,2879,6
Task 2845,Job 1,7,8,1,9,0,8,16,8,1,1,1,2845,2879,7
Task 2846,Job 0,9,4,3,7,0,12,16,4,3,4,0,2846,2880,18
Task 2846,Job 1,14,4,1,12,0,15,26,11,1,3,0,2846,2880,16
Task 2847,Job 0,5,4,2,9,0,7,14,7,2,1,1,2847,2880,14
Task 2847,Job 1,10,6,1,12,0,11,22,11,1,2,0,2847,2880,4
Task 2848,Job 0,10,8,1,9,0,11,19,8,1,4,2,2848,2881,4
Task 2848,Job 1,15,7,4,12,0,19,27,8,4,1,2,2848,2881,2
Task 2849,Job 0,4,8,2,12,0,6,16,10,2,2,0,2849,2883,19
Task 2849,Job 1,9,6,4,10,0,13,19,6,4,1,0,2849,2883,12
Task 2850,Job 0,9,8,4,10,0,13,19,6,4,4,1,2850,2884,11
Task 2850,Job 1,14,5,3,8,0,17,22,5,3,1,1,2850,2884,6
Task 2851,Job 0,10,4,2,10,0,12,20,8,2,1,0,2851,2884,11
Task 2851,Job 1,15,9,4,8,0,19,23,4,4,2,2,2851,2884,3
Task 2852,Job 0,10,5,2,8,1,12,18,6,2,1,1,2852,2885,9
Task 2852,Job 1,15,10,2,11,1,17,26,9,2,4,2,2852,2885,14
Task 2853,Job 0,10,7,4,9,0,14,19,5,4,2,0,2853,2887,16
Task 2853,Job 1,15,5,4,6,0,19,21,2,4,1,2,2853,2887,5
Task 2854,Job 0,7,9,2,11,1,9,18,9,2,2,1,2854,2888,20
Task 2854,Job 1,12,10,3,7,1,15,19,4,3,2,0,2854,2888,6
Task 2855,Job 0,4,5,2,6,0,6,10,4,2,3,1,2855,2888,12
Task 2855,Job 1,9,7,4,11,0,13,20,7,4,3,1,2855,2888,3
Task 2856,Job 0,7,4,1,7,1,8,14,6,1,4,2,2856,2889,3
Task 2856,Job 1,12,6,1,11,1,13,23,10,1,2,2,2856,2889,5
Task 2857,Job 0,4,9,2,7,0,6,11,5,2,1,1,2857,2890,16
Task 2857,Job 1,9,10,4,8,0,13,17,4,4,1,2,2857,2890,7
Task 2858,Job 0,2,9,2,10,0,4,12,8,2,1,0,2858,2891,20
Task 2858,Job 1,7,5,4,10,0,11,17,6,4,2,0,2858,2891,17
Task 2859,Job 0,8,4,4,11,1,12,19,7,4,3,1,2859,2893,3
Task 2859,Job 1,13,4,3,7,0,16,20,4,3,3,0,2859,2893,8
Task 2860,Job 0,1,10,4,6,0,5,7,2,4,2,1,2860,2893,12
Task 2860,Job 1,6,8,1,7,0,7,13,6,1,4,0,2860,2893,8
Task 2861,Job 0,5,6,2,7,0,7,12,5,2,2,1,2861,2895,16
Task 2861,Job 1,10,6,1,6,0,11,16,5,1,3,2,2861,2895,4
Task 2862,Job 0,9,9,1,12,0,10,21,11,1,4,2,2862,2895,18
Task 2862,Job 1,14,8,4,6,1,18,20,2,4,2,0,2862,2895,4
Task 2863,Job 0,8,10,1,12,0,9,20,11,1,4,2,2863,2896,15
Task 2863,Job 1,13,8,4,9,0,17,22,5,4,1,0,2863,2896,12
Task 2864,Job 0,7,8,4,7,0,11,14,3,4,1,2,2864,2897,14
Task 2864,Job 1,12,6,3,12,0,15,24,9,3,4,2,2864,2897,15
Task 2865,Job 0,4,7,2,7,0,6,11,5,2,1,2,2865,2899,6
Task 2865,Job 1,9,5,1,11,0,10,20,10,1,2,0,2865,2899,19
Task 2866,Job 0,7,4,2,6,0,9,13,4,2,1,2,2866,2899,13
Task 2866,Job 1,12,9,3,12,0,15,24,9,3,4,0,2866,2899,3
Task 2867,Job 0,8,7,1,10,0,9,18,9,1,3,1,2867,2901,18
Task 2867,Job 1,13,4,4,7,0,17,20,3,4,4,1,2867,2901,5
Task 2868,Job 0,7,10,2,12,0,9,19,10,2,2,0,2868,2902,2
Task 2868,Job 1,12,9,1,7,1,13,19,6,1,3,1,2868,2902,4
Task 2869,Job 0,3,4,2,10,0,5,13,8,2,2,2,2869,2902,9
Task 2869,Job 1,8,4,4,8,0,12,16,4,4,4,2,2869,2902,12
Task 2870,Job 0,4,5,2,9,0,6,13,7,2,4,0,2870,2904,17
Task 2870,Job 1,9,7,2,7,1,11,16,5,2,3,2,2870,2904,20
Task 2871,Job 0,9,10,1,10,0,10,19,9,1,3,2,2871,2905,11
Task 2871,Job 1,14,8,3,10,1,17,24,7,3,3,0,2871,2905,14
Task 2872,Job 0,1,6,1,12,0,2,13,11,1,4,1,2872,2905,15
Task 2872,Job 1,6,9,1,7,1,7,13,6,1,1,1,2872,2905,12
Task 2873,Job 0,3,9,4,9,0,7,12,5,4,1,0,2873,2907,19
Task 2873,Job 1,8,6,1,6,0,9,14,5,1,3,2,2873,2907,18
Task 2874,Job 0,8,5,1,8,0,9,16,7,1,2,1,2874,2907,15
Task 2874,Job 1,13,7,1,10,0,14,23,9,1,3,1,2874,2907,17
Task 2875,Job 0,9,5,4,10,1,13,19,6,4,2,0,2875,2908,18
Task 2875,Job 1,14,9,1,8,1,15,22,7,1,1,1,2875,2908,5
Task 2876,Job 0,1,5,2,9,0,3,10,7,2,2,2,2876,2910,17
Task 2876,Job 1,6,7,2,10,0,8,16,8,2,1,1,2876,2910,2
Task 2877,Job 0,10,9,4,12,0,14,22,8,4,2,2,2877,2911,11
Task 2877,Job 1,15,4,1,12,0,16,27,11,1,3,1,2877,2911,9
Task 2878,Job 0,3,6,4,7,1,7,10,3,4,3,2,2878,2912,4
Task 2878,Job 1,8,4,3,9,0,11,17,6,3,3,2,2878,2912,4
Task 2879,Job 0,9,4,4,12,0,13,21,8,4,2,2,2879,2913,6
Task 2879,Job 1,14,9,3,7,1,17,21,4,3,2,2,2879,2913,18
Task 2880,Job 0,5,10,2,6,0,7,11,4,2,4,2,2880,2914,7
Task 2880,Job 1,10,9,4,11,0,14,21,7,4,3,2,2880,2914,20
Task 2881,Job 0,7,7,1,6,1,8,13,5,1,3,0,2881,2915,14
Task 2881,Job 1,12,9,4,10,0,16,22,6,4,2,2,2881,2915,2
Task 2882,Job 0,2,7,2,7,0,4,9,5,2,4,2,2882,2915,3
Task 2882,Job 1,7,10,1,10,0,8,17,9,1,2,1,2882,2915,9
Task 2883,Job 0,9,6,2,12,0,11,21,10,2,2,1,2883,2917,7
Task 2883,Job 1,14,5,3,12,0,17,26,9,3,3,1,2883,2917,13
Task 2884,Job 0,6,6,4,12,0,10,18,8,4,4,2,2884,2917,15
Task 2884,Job 1,11,6,2,8,0,13,19,6,2,1,2,2884,2917,2
Task 2885,Job 0,8,7,3,12,0,11,20,9,3,2,2,2885,2919,8
Task 2885,Job 1,13,4,4,10,1,17,23,6,4,4,0,2885,2919,18
Task 2886,Job 0,9,7,1,9,0,10,18,8,1,1,0,2886,2920,8
Task 2886,Job 1,14,8,1,8,0,15,22,7,1,2,1,2886,2920,3
Task 2887,Job 0,6,6,2,9,0,8,15,7,2,1,2,2887,2921,13
Task 2887,Job 1,11,8,2,9,0,13,20,7,2,4,1,2887,2921,6
Task 2888,Job 0,3,10,3,7,1,6,10,4,3,1,0,2888,2922,11
Task 2888,Job 1,8,7,1,12,1,9,20,11,1,1,1,2888,2922,9
Task 2889,Job 0,2,6,1,12,0,3,14,11,1,1,2,2889,2922,17
Task 2889,Job 1,7,10,4,6,0,11,13,2,4,1,1,2889,2922,16
Task 2890,Job 0,5,8,2,8,0,7,13,6,2,2,1,2890,2923,16
Task 2890,Job 1,10,4,3,6,0,13,16,3,3,3,1,2890,2923,4
Task 2891,Job 0,8,5,3,11,1,11,19,8,3,4,2,2891,2924,15
Task 2891,Job 1,13,10,1,10,0,14,23,9,1,3,0,2891,2924,12
Task 2892,Job 0,8,10,4,9,0,12,17,5,4,2,2,2892,2925,20
Task 2892,Job 1,13,8,4,9,0,17,22,5,4,3,1,2892,2925,10
Task 2893,Job 0,6,8,1,9,1,7,15,8,1,4,0,2893,2927,15
Task 2893,Job 1,11,10,4,10,0,15,21,6,4,3,2,2893,2927,11
Task 2894,Job 0,2,4,2,10,0,4,12,8,2,1,1,2894,2928,18
Task 2894,Job 1,7,7,1,7,0,8,14,6,1,1,0,2894,2928,7
Task 2895,Job 0,10,4,1,8,0,11,18,7,1,3,1,2895,2928,13
Task 2895,Job 1,15,8,1,9,0,16,24,8,1,4,1,2895,2928,19
Task 2896,Job 0,1,7,4,11,0,5,12,7,4,1,1,2896,2929,17
Task 2896,Job 1,6,9,3,10,0,9,16,7,3,1,1,2896,2929,6
Task 2897,Job 0,9,6,1,10,0,10,19,9,1,4,0,2897,2930,2
Task 2897,Job 1,14,4,3,6,1,17,20,3,3,1,1,2897,2930,13
Task 2898,Job 0,6,8,3,10,0,9,16,7,3,2,1,2898,2932,9
Task 2898,Job 1,11,8,1,7,1,12,18,6,1,1,0,2898,2932,14
Task 2899,Job 0,5,6,1,12,0,6,17,11,1,2,2,2899,2932,14
Task 2899,Job 1,10,8,4,8,0,14,18,4,4,1,1,2899,2932,6
Task 2900,Job 0,8,8,1,8,0,9,16,7,1,3,0,2900,2933,18
Task 2900,Job 1,13,6,2,8,0,15,21,6,2,3,2,2900,2933,6
Task 2901,Job 0,2,5,1,9,0,3,11,8,1,4,1,2901,2935,13
Task 2901,Job 1,7,7,3,6,0,10,13,3,3,2,1,2901,2935,18
Task 2902,Job 0,3,5,4,6,1,7,9,2,4,4,0,2902,2936,11
Task 2902,Job 1,8,4,3,12,1,11,20,9,3,4,2,2902,2936,2
Task 2903,Job 0,5,7,2,11,1,7,16,9,2,1,2,2903,2936,18
Task 2903,Job 1,10,5,1,7,0,11,17,6,1,4,2,2903,2936,19
Task 2904,Job 0,10,9,2,9,0,12,19,7,2,3,2,2904,2938,13
Task 2904,Job 1,15,7,4,8,0,19,23,4,4,4,0,2904,2938,7
Task 2905,Job 0,9,7,4,8,0,13,17,4,4,4,1,2905,2938,3
Task 2905,Job 1,14,4,4,11,1,18,25,7,4,3,0,2905,2938,8
Task 2906,Job 0,7,9,4,11,0,11,18,7,4,1,2,2906,2940,10
Task 2906,Job 1,12,9,2,10,0,14,22,8,2,4,0,2906,2940,7
Task 2907,Job 0,3,10,1,12,0,4,15,11,1,3,1,2907,2940,8
Task 2907,Job 1,8,9,4,9,0,12,17,5,4,2,2,2907,2940,4
Task 2908,Job 0,3,7,2,7,0,5,10,5,2,1,0,2908,2942,17
Task 2908,Job 1,8,4,1,6,0,9,14,5,1,3,2,2908,2942,6
Task 2909,Job 0,10,7,4,11,0,14,21,7,4,1,1,2909,2942,15
Task 2909,Job 1,15,8,2,8,0,17,23,6,2,3,1,2909,2942,20
Task 2910,Job 0,1,5,3,9,0,4,10,6,3,1,1,2910,2943,2
Task 2910,Job 1,6,4,4,11,1,10,17,7,4,3,0,2910,2943,10
Task 2911,Job 0,9,9,3,10,1,12,19,7,3,2,2,2911,2945,4
Task 2911,Job 1,14,6,1,9,0,15,23,8,1,1,2,2911,2945,19
Task 2912,Job 0,7,5,4,6,0,11,13,2,4,3,1,2912,2946,10
Task 2912,Job 1,12,6,3,7,0,15,19,4,3,3,1,2912,2946,10
Task 2913,Job 0,5,5,1,10,1,6,15,9,1,2,2,2913,2946,8
Task 2913,Job 1,10,5,4,9,1,14,19,5,4,4,1,2913,2946,2
Task 2914,Job 0,5,6,3,8,1,8,13,5,3,4,1,2914,2947,19
Task 2914,Job 1,10,5,3,12,0,13,22,9,3,4,1,2914,2947,19
Task 2915,Job 0,10,4,1,11,1,11,21,10,1,1,1,2915,2948,19
Task 2915,Job 1,15,7,3,10,0,18,25,7,3,3,1,2915,2948,10
Task 2916,Job 0,5,10,4,6,0,9,11,2,4,1,2,2916,2950,14
Task 2916,Job 1,10,8,3,9,0,13,19,6,3,1,0,2916,2950,13
Task 2917,Job 0,3,10,2,6,1,5,9,4,2,3,2,2917,2951,6
Task 2917,Job 1,8,6,4,8,1,12,16,4,4,4,2,2917,2951,10
Task 2918,Job 0,8,6,3,9,0,11,17,6,3,2,1,2918,2952,5
Task 2918,Job 1,13,5,4,9,0,17,22,5,4,3,0,2918,2952,9
Task 2919,Job 0,8,9,3,11,0,11,19,8,3,2,0,2919,2952,2
Task 2919,Job 1,13,5,4,8,1,17,21,4,4,2,2,2919,2952,15
Task 2920,Job 0,4,7,3,8,1,7,12,5,3,3,2,2920,2953,7
Task 2920,Job 1,9,5,4,11,0,13,20,7,4,4,0,2920,2953,12
Task 2921,Job 0,10,4,1,7,1,11,17,6,1,2,2,2921,2954,8
Task 2921,Job 1,15,10,1,6,0,16,21,5,1,4,1,2921,2954,11
Task 2922,Job 0,3,6,3,7,1,6,10,4,3,2,2,2922,2955,19
Task 2922,Job 1,8,9,3,6,0,11,14,3,3,4,0,2922,2955,5
Task 2923,Job 0,5,6,3,10,1,8,15,7,3,1,1,2923,2956,12
Task 2923,Job 1,10,8,3,10,1,13,20,7,3,2,2,2923,2956,18
Task 2924,Job 0,9,9,4,6,1,13,15,2,4,3,0,2924,2958,19
Task 2924,Job 1,14,5,4,8,0,18,22,4,4,2,0,2924,2958,9
Task 2925,Job 0,2,10,2,12,1,4,14,10,2,2,1,2925,2958,18
Task 2925,Job 1,7,5,1,6,0,8,13,5,1,3,1,2925,2958,11
Task 2926,Job 0,10,8,1,8,0,11,18,7,1,1,2,2926,2960,8
Task 2926,Job 1,15,4,4,9,1,19,24,5,4,3,2,2926,2960,4
Task 2927,Job 0,3,9,3,8,0,6,11,5,3,2,0,2927,2961,14
Task 2927,Job 1,8,9,4,9,1,12,17,5,4,3,0,2927,2961,18
Task 2928,Job 0,2,8,3,6,0,5,8,3,3,4,0,2928,2961,4
Task 2928,Job 1,7,7,2,7,0,9,14,5,2,1,0,2928,2961,2
Task 2929,Job 0,1,5,3,7,0,4,8,4,3,2,1,2929,2962,6
Task 2929,Job 1,6,7,1,8,0,7,14,7,1,1,2,2929,2962,18
Task 2930,Job 0,1,5,3,12,0,4,13,9,3,1,2,2930,2963,17
Task 2930,Job 1,6,4,4,11,0,10,17,7,4,1,2,2930,2963,15
Task 2931,Job 0,8,7,4,10,0,12,18,6,4,3,2,2931,2964,16
Task 2931,Job 1,13,10,1,7,0,14,20,6,1,3,2,2931,2964,3
Task 2932,Job 0,4,7,1,10,0,5,14,9,1,1,1,2932,2966,5
Task 2932,Job 1,9,7,2,7,1,11,16,5,2,4,0,2932,2966,18
Task 2933,Job 0,5,5,1,7,0,6,12,6,1,3,1,2933,2967,5
Task 2933,Job 1,10,8,2,9,1,12,19,7,2,1,2,2933,2967,3
Task 2934,Job 0,10,4,2,9,0,12,19,7,2,3,1,2934,2968,11
Task 2934,Job 1,15,8,3,11,0,18,26,8,3,3,1,2934,2968,20
Task 2935,Job 0,6,4,3,6,0,9,12,3,3,4,0,2935,2969,19
Task 2935,Job 1,11,5,4,9,0,15,20,5,4,4,1,2935,2969,8
Task 2936,Job 0,2,7,3,8,1,5,10,5,3,1,0,2936,2970,4
Task 2936,Job 1,7,5,1,11,0,8,18,10,1,1,1,2936,2970,14
Task 2937,Job 0,5,8,4,8,0,9,13,4,4,4,0,2937,2971,15
Task 2937,Job 1,10,10,3,8,1,13,18,5,3,4,1,2937,2971,4
Task 2938,Job 0,5,5,4,12,0,9,17,8,4,3,0,2938,2972,15
Task 2938,Job 1,10,8,4,12,0,14,22,8,4,3,1,2938,2972,5
Task 2939,Job 0,4,10,4,9,0,8,13,5,4,3,2,2939,2972,3
Task 2939,Job 1,9,7,2,7,0,11,16,5,2,4,1,2939,2972,3
Task 2940,Job 0,6,9,3,7,0,9,13,4,3,1,2,2940,2974,9
Task 2940,Job 1,11,7,1,8,1,12,19,7,1,4,2,2940,2974,12
Task 2941,Job 0,4,7,3,7,0,7,11,4,3,3,2,2941,2974,17
Task 2941,Job 1,9,8,4,6,1,13,15,2,4,1,1,2941,2974,10
Task 2942,Job 0,7,6,4,10,0,11,17,6,4,2,0,2942,2976,11
Task 2942,Job 1,12,5,1,10,0,13,22,9,1,1,2,2942,2976,11
Task 2943,Job 0,1,10,1,6,1,2,7,5,1,4,0,2943,2976,3
Task 2943,Job 1,6,7,4,12,0,10,18,8,4,4,0,2943,2976,10
Task 2944,Job 0,9,4,2,7,0,11,16,5,2,2,0,2944,2977,8
Task 2944,Job 1,14,8,2,6,0,16,20,4,2,2,2,2944,2977,19
Task 2945,Job 0,3,7,1,6,0,4,9,5,1,3,0,2945,2979,3
Task 2945,Job 1,8,10,1,10,1,9,18,9,1,4,2,2945,2979,14
Task 2946,Job 0,2,9,2,6,0,4,8,4,2,1,1,2946,2980,19
Task 2946,Job 1,7,9,4,8,0,11,15,4,4,1,2,2946,2980,14
Task 2947,Job 0,1,8,3,12,1,4,13,9,3,1,0,2947,2981,4
Task 2947,Job 1,6,10,2,6,0,8,12,4,2,4,0,2947,2981,15
Task 2948,Job 0,1,10,1,8,0,2,9,7,1,4,0,2948,2981,12
Task 2948,Job 1,6,6,2,10,0,8,16,8,2,2,0,2948,2981,9
Task 2949,Job 0,7,5,2,11,0,9,18,9,2,3,2,2949,2982,11
Task 2949,Job 1,12,5,1,6,0,13,18,5,1,2,2,2949,2982,10
Task 2950,Job 0,5,5,3,7,0,8,12,4,3,2,2,2950,2984,10
Task 2950,Job 1,10,8,4,7,0,14,17,3,4,4,2,2950,2984,7
Task 2951,Job 0,6,5,4,7,0,10,13,3,4,2,2,2951,2985,11
Task 2951,Job 1,11,8,4,11,0,15,22,7,4,1,0,2951,2985,7
Task 2952,Job 0,5,6,2,9,1,7,14,7,2,4,1,2952,2986,17
Task 2952,Job 1,10,8,1,8,0,11,18,7,1,2,1,2952,2986,12
Task 2953,Job 0,1,5,4,12,0,5,13,8,4,2,1,2953,2986,14
Task 2953,Job 1,6,6,2,11,1,8,17,9,2,2,0,2953,2986,14
Task 2954,Job 0,2,6,3,9,0,5,11,6,3,4,1,2954,2988,10
Task 2954,Job 1,7,10,1,6,1,8,13,5,1,4,2,2954,2988,9
Task 2955,Job 0,8,9,2,7,0,10,15,5,2,1,0,2955,2988,11
Task 2955,Job 1,13,8,1,7,0,14,20,6,1,1,2,2955,2988,6
Task 2956,Job 0,4,6,1,12,0,5,16,11,1,2,0,2956,2989,13
Task 2956,Job 1,9,9,1,12,0,10,21,11,1,2,1,2956,2989,5
Task 2957,Job 0,3,7,4,12,0,7,15,8,4,3,1,2957,2990,20
Task 2957,Job 1,8,4,2,10,0,10,18,8,2,1,1,2957,2990,11
Task 2958,Job 0,10,6,4,6,0,14,16,2,4,4,2,2958,2992,16
Task 2958,Job 1,15,10,2,12,0,17,27,10,2,3,2,2958,2992,5
Task 2959,Job 0,2,8,2,11,0,4,13,9,2,3,1,2959,2992,12
Task 2959,Job 1,7,9,1,7,0,8,14,6,1,2,1,2959,2992,7
Task 2960,Job 0,10,9,2,11,0,12,21,9,2,4,0,2960,2993,13
Task 2960,Job 1,15,7,1,6,0,16,21,5,1,4,2,2960,2993,7
Task 2961,Job 0,8,4,4,10,0,12,18,6,4,2,1,2961,2995,5
Task 2961,Job 1,13,10,1,6,0,14,19,5,1,4,2,2961,2995,20
Task 2962,Job 0,2,9,1,9,1,3,11,8,1,4,2,2962,2996,9
Task 2962,Job 1,7,7,3,10,0,10,17,7,3,1,1,2962,2996,10
Task 2963,Job 0,4,8,2,6,0,6,10,4,2,4,0,2963,2996,16
Task 2963,Job 1,9,9,3,6,0,12,15,3,3,1,1,2963,2996,13
Task 2964,Job 0,2,4,2,11,0,4,13,9,2,4,0,2964,2997,4
Task 2964,Job 1,7,5,3,8,0,10,15,5,3,2,1,2964,2997,16
Task 2965,Job 0,10,8,3,12,0,13,22,9,3,1,2,2965,2999,17
Task 2965,Job 1,15,4,3,9,0,18,24,6,3,3,2,2965,2999,4
Task 2966,Job 0,2,10,3,8,0,5,10,5,3,1,0,2966,3000,17
Task 2966,Job 1,7,4,2,12,0,9,19,10,2,3,1,2966,3000,17
Task 2967,Job 0,1,6,3,7,1,4,8,4,3,2,0,2967,3001,19
Task 2967,Job 1,6,6,4,12,1,10,18,8,4,1,1,2967,3001,5
Task 2968,Job 0,5,4,3,12,0,8,17,9,3,4,2,2968,3001,15
Task 2968,Job 1,10,4,4,6,0,14,16,2,4,2,2,2968,3001,17
Task 2969,Job 0,8,9,4,7,0,12,15,3,4,2,1,2969,3002,11
Task 2969,Job 1,13,7,2,10,0,15,23,8,2,2,0,2969,3002,4
Task 2970,Job 0,2,7,3,12,0,5,14,9,3,4,1,2970,3003,14
Task 2970,Job 1,7,4,4,8,0,11,15,4,4,4,1,2970,3003,20
Task 2971,Job 0,2,6,4,9,0,6,11,5,4,3,1,2971,3005,5
Task 2971,Job 1,7,5,2,9,0,9,16,7,2,1,2,2971,3005,19
Task 2972,Job 0,2,9,3,10,1,5,12,7,3,2,2,2972,3006,10
Task 2972,Job 1,7,4,1,6,0,8,13,5,1,4,2,2972,3006,14
Task 2973,Job 0,2,5,3,6,1,5,8,3,3,2,2,2973,3006,7
Task 2973,Job 1,7,4,2,8,1,9,15,6,2,4,0,2973,3006,10
Task 2974,Job 0,6,4,3,9,1,9,15,6,3,1,2,2974,3007,11
Task 2974,Job 1,11,9,1,10,0,12,21,9,1,4,1,2974,3007,7
Task 2975,Job 0,6,8,2,7,0,8,13,5,2,3,0,2975,3009,6
Task 2975,Job 1,11,10,1,12,0,12,23,11,1,1,0,2975,3009,3
Task 2976,Job 0,2,4,4,10,0,6,12,6,4,3,2,2976,3010,12
Task 2976,Job 1,7,6,3,7,0,10,14,4,3,3,1,2976,3010,3
Task 2977,Job 0,2,5,4,10,0,6,12,6,4,1,0,2977,3011,8
Task 2977,Job 1,7,6,1,11,0,8,18,10,1,4,1,2977,3011,8
Task 2978,Job 0,5,8,2,7,1,7,12,5,2,1,0,2978,3011,20
Task 2978,Job 1,10,4,2,8,0,12,18,6,2,2,1,2978,3011,9
Task 2979,Job 0,8,7,4,9,0,12,17,5,4,4,1,2979,3013,4
Task 2979,Job 1,13,6,1,8,0,14,21,7,1,1,0,2979,3013,7
Task 2980,Job 0,3,5,2,9,1,5,12,7,2,3,2,2980,3013,17
Task 2980,Job 1,8,6,1,10,0,9,18,9,1,4,1,2980,3013,20
Task 2981,Job 0,1,4,1,10,0,2,11,9,1,2,0,2981,3014,16
Task 2981,Job 1,6,4,1,6,0,7,12,5,1,4,1,2981,3014,15
Task 2982,Job 0,7,8,3,11,0,10,18,8,3,1,2,2982,3015,17
Task 2982,Job 1,12,7,1,6,0,13,18,5,1,4,1,2982,3015,2
Task 2983,Job 0,2,10,2,6,1,4,8,4,2,4,2,2983,3017,2
Task 2983,Job 1,7,5,1,9,0,8,16,8,1,2,1,2983,3017,3
Task 2984,Job 0,9,4,4,9,1,13,18,5,4,3,0,2984,3017,5
Task 2984,Job 1,14,5,1,8,0,15,22,7,1,2,0,2984,3017,16
Task 2985,Job 0,10,4,1,12,0,11,22,11,1,3,2,2985,3019,4
Task 2985,Job 1,15,7,2,9,1,17,24,7,2,2,0,2985,3019,12
Task 2986,Job 0,9,5,3,9,0,12,18,6,3,1,1,2986,3019,10
Task 2986,Job 1,14,7,1,10,0,15,24,9,1,2,0,2986,3019,18
Task 2987,Job 0,6,7,2,10,0,8,16,8,2,4,1,2987,3020,13
Task 2987,Job 1,11,4,4,10,0,15,21,6,4,1,2,2987,3020,10
Task 2988,Job 0,9,8,4,8,1,13,17,4,4,2,2,2988,3021,15
Task 2988,Job 1,14,5,1,12,1,15,26,11,1,1,2,2988,3021,11
Task 2989,Job 0,6,8,3,7,0,9,13,4,3,2,2,2989,3022,20
Task 2989,Job 1,11,9,2,10,1,13,21,8,2,1,1,2989,3022,16
Task 2990,Job 0,3,4,4,7,1,7,10,3,4,1,1,2990,3023,4
Task 2990,Job 1,8,4,4,11,0,12,19,7,4,4,0,2990,3023,2
Task 2991,Job 0,2,4,3,7,0,5,9,4,3,3,1,2991,3024,10
Task 2991,Job 1,7,4,1,7,1,8,14,6,1,3,2,2991,3024,15
Task 2992,Job 0,6,5,2,7,0,8,13,5,2,4,2,2992,3025,7
Task 2992,Job 1,11,8,2,7,1,13,18,5,2,3,0,2992,3025,14
Task 2993,Job 0,10,9,4,9,0,14,19,5,4,1,0,2993,3027,17
Task 2993,Job 1,15,7,4,8,0,19,23,4,4,1,2,2993,3027,7
Task 2994,Job 0,2,4,4,7,1,6,9,3,4,3,0,2994,3028,3
Task 2994,Job 1,7,4,4,7,0,11,14,3,4,1,1,2994,3028,2
Task 2995,Job 0,1,9,2,8,0,3,9,6,2,4,2,2995,3029,9
Task 2995,Job 1,6,4,3,8,0,9,14,5,3,1,2,2995,3029,8
Task 2996,Job 0,6,8,3,10,0,9,16,7,3,3,1,2996,3030,2
Task 2996,Job 1,11,5,2,9,1,13,20,7,2,2,0,2996,3030,10
Task 2997,Job 0,7,5,3,8,0,10,15,5,3,4,2,2997,3030,2
Task 2997,Job 1,12,7,1,9,0,13,21,8,1,4,0,2997,3030,14
Task 2998,Job 0,10,9,3,11,0,13,21,8,3,3,0,2998,3032,16
Task 2998,Job 1,15,5,1,7,0,16,22,6,1,4,1,2998,3032,15
Task 2999,Job 0,4,4,3,12,0,7,16,9,3,2,0,2999,3033,15
Task 2999,Job 1,9,9,4,7,0,13,16,3,4,1,1,2999,3033,8
Task 3000,Job 0,6,8,3,8,0,9,14,5,3,2,2,3000,3033,18
Task 3000,Job 1,11,10,1,6,0,12,17,5,1,3,0,3000,3033,16
Task 3001,Job 0,8,7,3,8,0,11,16,5,3,1,0,3001,3035,12
Task 3001,Job 1,13,6,3,10,0,16,23,7,3,2,1,3001,3035,19
Task 3002,Job 0,3,7,1,12,0,4,15,11,1,3,1,3002,3035,2
Task 3002,Job 1,8,6,1,9,0,9,17,8,1,2,2,3002,3035,9
Task 3003,Job 0,9,6,3,7,0,12,16,4,3,4,1,3003,3037,16
Task 3003,Job 1,14,6,1,8,0,15,22,7,1,4,1,3003,3037,7
Task 3004,Job 0,5,10,4,7,0,9,12,3,4,2,2,3004,3038,7
Task 3004,Job 1,10,6,4,12,1,14,22,8,4,3,1,3004,3038,14
Task 3005,Job 0,2,7,3,12,0,5,14,9,3,3,2,3005,3039,12
Task 3005,Job 1,7,6,4,9,1,11,16,5,4,2,1,3005,3039,10
Task 3006,Job 0,7,5,4,11,0,11,18,7,4,4,1,3006,3040,20
Task 3006,Job 1,12,6,3,8,1,15,20,5,3,2,1,3006,3040,2
Task 3007,Job 0,10,5,4,12,0,14,22,8,4,2,1,3007,3040,14
Task 3007,Job 1,15,10,4,7,1,19,22,3,4,2,1,3007,3040,3
Task 3008,Job 0,9,5,1,8,0,10,17,7,1,4,1,3008,3042,12
Task 3008,Job 1,14,6,2,8,0,16,22,6,2,1,2,3008,3042,9
Task 3009,Job 0,7,7,2,10,0,9,17,8,2,1,2,3009,3043,19
Task 3009,Job 1,12,4,1,11,1,13,23,10,1,3,2,3009,3043,19
Task 3010,Job 0,1,9,3,10,0,4,11,7,3,1,0,3010,3044,11
Task 3010,Job 1,6,6,1,11,1,7,17,10,1,4,1,3010,3044,13
Task 3011,Job 0,6,9,1,6,0,7,12,5,1,1,1,3011,3044,12
Task 3011,Job 1,11,8,1,12,0,12,23,11,1,3,1,3011,3044,14
Task 3012,Job 0,1,7,1,12,0,2,13,11,1,2,1,3012,3046,8
Task 3012,Job 1,6,5,4,8,0,10,14,4,4,4,0,3012,3046,15
Task 3013,Job 0,8,5,1,9,1,9,17,8,1,1,1,3013,3047,12
Task 3013,Job 1,13,4,2,12,0,15,25,10,2,3,2,3013,3047,7
Task 3014,Job 0,5,9,2,9,1,7,14,7,2,1,1,3014,3047,15
Task 3014,Job 1,10,4,4,11,0,14,21,7,4,4,1,3014,3047,17
Task 3015,Job 0,9,9,1,9,0,10,18,8,1,3,1,3015,3048,8
Task 3015,Job 1,14,6,3,12,1,17,26,9,3,3,2,3015,3048,5
Task 3016,Job 0,4,5,3,11,0,7,15,8,3,1,2,3016,3050,11
Task 3016,Job 1,9,6,2,7,1,11,16,5,2,4,0,3016,3050,8
Task 3017,Job 0,8,6,3,6,0,11,14,3,3,1,1,3017,3050,19
Task 3017,Job 1,13,10,4,7,0,17,20,3,4,3,1,3017,3050,8
Task 3018,Job 0,2,8,1,8,0,3,10,7,1,3,0,3018,3052,4
Task 3018,Job 1,7,8,4,9,1,11,16,5,4,3,2,3018,3052,11
Task 3019,Job 0,2,10,2,11,1,4,13,9,2,1,2,3019,3052,8
Task 3019,Job 1,7,6,3,10,0,10,17,7,3,1,0,3019,3052,7
Task 3020,Job 0,3,7,1,8,0,4,11,7,1,3,1,3020,3053,7
Task 3020,Job 1,8,5,1,11,1,9,19,10,1,1,2,3020,3053,16
Task 3021,Job 0,7,6,4,12,0,11,19,8,4,4,2,3021,3054,5
Task 3021,Job 1,12,9,3,8,0,15,20,5,3,1,2,3021,3054,19
Task 3022,Job 0,4,10,4,11,0,8,15,7,4,1,0,3022,3055,8
Task 3022,Job 1,9,5,1,9,0,10,18,8,1,1,2,3022,3055,2
Task 3023,Job 0,1,7,1,9,1,2,10,8,1,3,2,3023,3056,4
Task 3023,Job 1,6,6,3,12,0,9,18,9,3,2,1,3023,3056,9
Task 3024,Job 0,2,8,4,10,0,6,12,6,4,2,1,3024,3057,9
Task 3024,Job 1,7,10,1,12,1,8,19,11,1,4,2,3024,3057,20
Task 3025,Job 0,3,6,2,6,0,5,9,4,2,4,2,3025,3059,5
Task 3025,Job 1,8,10,1,10,0,9,18,9,1,1,2,3025,3059,16
Task 3026,Job 0,10,8,1,8,1,11,18,7,1,2,2,3026,3059,10
Task 3026,Job 1,15,8,1,11,0,16,26,10,1,4,0,3026,3059,6
Task 3027,Job 0,8,5,4,11,0,12,19,7,4,2,1,3027,3061,12
Task 3027,Job 1,13,8,1,6,0,14,19,5,1,4,0,3027,3061,10
Task 3028,Job 0,7,5,3,11,0,10,18,8,3,4,1,3028,3062,3
Task 3028,Job 1,12,7,3,12,0,15,24,9,3,1,2,3028,3062,14
Task 3029,Job 0,5,8,1,8,0,6,13,7,1,4,2,3029,3063,4
Task 3029,Job 1,10,9,4,10,0,14,20,6,4,4,2,3029,3063,18
Task 3030,Job 0,2,9,1,8,0,3,10,7,1,4,1,3030,3063,6
Task 3030,Job 1,7,8,2,9,0,9,16,7,2,3,1,3030,3063,17
Task 3031,Job 0,4,4,1,9,0,5,13,8,1,2,1,3031,3065,12
Task 3031,Job 1,9,10,3,8,0,12,17,5,3,4,0,3031,3065,7
Task 3032,Job 0,10,5,3,12,0,13,22,9,3,2,2,3032,3065,2
Task 3032,Job 1,15,5,2,11,0,17,26,9,2,2,2,3032,3065,6
Task 3033,Job 0,3,9,3,7,0,6,10,4,3,3,1,3033,3066,15
Task 3033,Job 1,8,6,4,6,1,12,14,2,4,2,1,3033,3066,6
Task 3034,Job 0,2,9,1,8,0,3,10,7,1,4,2,3034,3067,6
Task 3034,Job 1,7,4,2,6,0,9,13,4,2,3,0,3034,3067,15
Task 3035,Job 0,5,5,1,11,0,6,16,10,1,3,1,3035,3068,5
Task 3035,Job 1,10,10,3,11,0,13,21,8,3,4,0,3035,3068,9
Task 3036,Job 0,10,6,2,10,0,12,20,8,2,4,1,3036,3070,19
Task 3036,Job 1,15,10,3,8,0,18,23,5,3,2,1,3036,3070,15
Task 3037,Job 0,10,9,3,12,0,13,22,9,3,3,2,3037,3070,14
Task 3037,Job 1,15,8,1,8,0,16,23,7,1,3,1,3037,3070,9
Task 3038,Job 0,4,9,4,12,0,8,16,8,4,4,0,3038,3072,10
Task 3038,Job 1,9,5,1,9,0,10,18,8,1,2,0,3038,3072,13
Task 3039,Job 0,1,9,1,11,0,2,12,10,1,1,1,3039,3072,18
Task 3039,Job 1,6,9,1,11,0,7,17,10,1,1,2,3039,3072,16
Task 3040,Job 0,8,8,2,8,0,10,16,6,2,4,0,3040,3073,15
Task 3040,Job 1,13,8,4,10,0,17,23,6,4,4,1,3040,3073,3
Task 3041,Job 0,10,5,3,10,1,13,20,7,3,4,2,3041,3074,6
Task 3041,Job 1,15,6,2,10,0,17,25,8,2,2,0,3041,3074,15
Task 3042,Job 0,3,10,1,6,0,4,9,5,1,4,1,3042,3076,2
Task 3042,Job 1,8,7,3,11,0,11,19,8,3,4,1,3042,3076,10
Task 3043,Job 0,8,6,1,10,0,9,18,9,1,2,0,3043,3076,3
Task 3043,Job 1,13,4,3,8,0,16,21,5,3,3,0,3043,3076,10
Task 3044,Job 0,5,5,4,6,0,9,11,2,4,1,0,3044,3077,12
Task 3044,Job 1,10,7,2,7,0,12,17,5,2,2,1,3044,3077,19
Task 3045,Job 0,10,6,1,9,1,11,19,8,1,1,2,3045,3079,4
Task 3045,Job 1,15,8,1,10,1,16,25,9,1,4,0,3045,3079,16
Task 3046,Job 0,6,8,4,7,0,10,13,3,4,3,1,3046,3080,20
Task 3046,Job 1,11,5,2,7,0,13,18,5,2,1,2,3046,3080,5
Task 3047,Job 0,1,9,2,6,0,3,7,4,2,3,2,3047,3081,12
Task 3047,Job 1,6,10,3,12,0,9,18,9,3,2,1,3047,3081,13
Task 3048,Job 0,7,5,3,9,0,10,16,6,3,4,0,3048,3081,19
Task 3048,Job 1,12,8,4,9,0,16,21,5,4,2,1,3048,3081,19
Task 3049,Job 0,10,5,1,9,0,11,19,8,1,2,1,3049,3082,5
Task 3049,Job 1,15,9,1,7,0,16,22,6,1,1,0,3049,3082,4
Task 3050,Job 0,4,7,2,11,0,6,15,9,2,3,2,3050,3084,14
Task 3050,Job 1,9,4,2,10,0,11,19,8,2,3,2,3050,3084,15
Task 3051,Job 0,6,9,4,10,0,10,16,6,4,2,0,3051,3084,4
Task 3051,Job 1,11,10,3,7,0,14,18,4,3,3,2,3051,3084,15
Task 3052,Job 0,6,5,4,7,0,10,13,3,4,1,2,3052,3086,3
Task 3052,Job 1,11,8,1,9,0,12,20,8,1,4,0,3052,3086,13
Task 3053,Job 0,5,4,1,8,0,6,13,7,1,4,0,3053,3086,2
Task 3053,Job 1,10,7,1,7,1,11,17,6,1,1,2,3053,3086,5
Task 3054,Job 0,10,4,3,9,0,13,19,6,3,1,2,3054,3088,9
Task 3054,Job 1,15,5,2,7,1,17,22,5,2,4,0,3054,3088,5
Task 3055,Job 0,6,5,1,10,0,7,16,9,1,3,0,3055,3089,20
Task 3055,Job 1,11,9,2,7,1,13,18,5,2,1,1,3055,3089,5
Task 3056,Job 0,8,8,4,7,0,12,15,3,4,2,1,3056,3089,13
Task 3056,Job 1,13,8,3,10,0,16,23,7,3,2,0,3056,3089,17
Task 3057,Job 0,5,5,2,7,0,7,12,5,2,3,2,3057,3091,17
Task 3057,Job 1,10,6,1,9,0,11,19,8,1,1,2,3057,3091,13
Task 3058,Job 0,7,9,2,6,0,9,13,4,2,4,2,3058,3091,12
Task 3058,Job 1,12,10,4,12,1,16,24,8,4,2,0,3058,3091,13
Task 3059,Job 0,5,8,3,8,0,8,13,5,3,1,0,3059,3093,11
Task 3059,Job 1,10,9,4,11,0,14,21,7,4,2,2,3059,3093,12
Task 3060,Job 0,7,6,3,12,1,10,19,9,3,2,2,3060,3094,4
Task 3060,Job 1,12,7,3,11,1,15,23,8,3,3,1,3060,3094,16
Task 3061,Job 0,1,5,2,8,1,3,9,6,2,4,2,3061,3094,14
Task 3061,Job 1,6,5,4,8,0,10,14,4,4,1,0,3061,3094,18
Task 3062,Job 0,10,5,1,6,1,11,16,5,1,1,0,3062,3096,10
Task 3062,Job 1,15,9,1,8,0,16,23,7,1,2,1,3062,3096,3
Task 3063,Job 0,8,8,1,9,0,9,17,8,1,1,0,3063,3097,3
Task 3063,Job 1,13,5,1,6,0,14,19,5,1,3,1,3063,3097,17
Task 3064,Job 0,2,6,4,12,0,6,14,8,4,2,1,3064,3098,14
Task 3064,Job 1,7,5,1,11,0,8,18,10,1,1,0,3064,3098,6
Task 3065,Job 0,9,8,3,7,0,12,16,4,3,2,0,3065,3099,16
Task 3065,Job 1,14,6,3,11,0,17,25,8,3,4,0,3065,3099,7
Task 3066,Job 0,4,7,3,11,0,7,15,8,3,4,0,3066,3100,4
Task 3066,Job 1,9,6,2,7,1,11,16,5,2,1,0,3066,3100,2
Task 3067,Job 0,9,7,3,6,0,12,15,3,3,4,2,3067,3101,17
Task 3067,Job 1,14,5,3,10,1,17,24,7,3,3,0,3067,3101,18
Task 3068,Job 0,5,8,2,7,0,7,12,5,2,1,0,3068,3102,7
Task 3068,Job 1,10,6,2,7,1,12,17,5,2,3,1,3068,3102,9
Task 3069,Job 0,5,10,3,12,0,8,17,9,3,3,2,3069,3102,10
Task 3069,Job 1,10,6,1,6,0,11,16,5,1,1,0,3069,3102,3
Task 3070,Job 0,10,10,4,12,1,14,22,8,4,1,2,3070,3103,4
Task 3070,Job 1,15,8,4,8,0,19,23,4,4,1,1,3070,3103,16
Task 3071,Job 0,8,10,2,8,0,10,16,6,2,2,2,3071,3105,13
Task 3071,Job 1,13,9,3,8,1,16,21,5,3,2,1,3071,3105,12
Task 3072,Job 0,4,5,1,11,0,5,15,10,1,2,1,3072,3105,6
Task 3072,Job 1,9,4,2,10,0,11,19,8,2,1,1,3072,3105,20
Task 3073,Job 0,10,6,1,6,0,11,16,5,1,4,2,3073,3107,9
Task 3073,Job 1,15,7,2,7,0,17,22,5,2,1,1,3073,3107,20
Task 3074,Job 0,2,6,2,8,1,4,10,6,2,4,0,3074,3107,6
Task 3074,Job 1,7,9,4,12,0,11,19,8,4,1,0,3074,3107,11
Task 3075,Job 0,2,5,2,12,0,4,14,10,2,4,0,3075,3108,8
Task 3075,Job 1,7,9,3,12,0,10,19,9,3,4,0,3075,3108,14
Task 3076,Job 0,2,7,2,9,1,4,11,7,2,4,1,3076,3110,20
Task 3076,Job 1,7,10,1,6,0,8,13,5,1,4,1,3076,3110,8
Task 3077,Job 0,3,4,3,8,1,6,11,5,3,1,1,3077,3110,13
Task 3077,Job 1,8,4,4,6,1,12,14,2,4,4,1,3077,3110,7
Task 3078,Job 0,9,5,4,10,0,13,19,6,4,4,1,3078,3112,11
Task 3078,Job 1,14,6,1,11,1,15,25,10,1,1,1,3078,3112,5
Task 3079,Job 0,1,6,3,12,1,4,13,9,3,4,0,3079,3112,10
Task 3079,Job 1,6,5,3,11,0,9,17,8,3,3,1,3079,3112,3
Task 3080,Job 0,2,4,2,7,0,4,9,5,2,3,0,3080,3114,9
Task 3080,Job 1,7,4,2,7,1,9,14,5,2,2,1,3080,3114,11
Task 3081,Job 0,6,7,2,7,1,8,13,5,2,3,2,3081,3115,3
Task 3081,Job 1,11,6,4,7,0,15,18,3,4,1,0,3081,3115,17
Task 3082,Job 0,5,8,2,10,0,7,15,8,2,3,2,3082,3116,10
Task 3082,Job 1,10,7,4,11,1,14,21,7,4,4,1,3082,3116,15
Task 3083,Job 0,5,5,4,6,1,9,11,2,4,3,1,3083,3117,8
Task 3083,Job 1,10,4,4,11,0,14,21,7,4,1,1,3083,3117,8
Task 3084,Job 0,1,8,3,10,0,4,11,7,3,1,2,3084,3118,18
Task 3084,Job 1,6,8,1,6,0,7,12,5,1,2,0,3084,3118,2
Task 3085,Job 0,2,9,4,8,0,6,10,4,4,2,2,3085,3119,12
Task 3085,Job 1,7,7,4,9,0,11,16,5,4,4,1,3085,3119,2
Task 3086,Job 0,7,6,2,10,1,9,17,8,2,3,0,3086,3119,17
Task 3086,Job 1,12,4,3,7,0,15,19,4,3,1,1,3086,3119,8
Task 3087,Job 0,1,6,3,6,0,4,7,3,3,1,2,3087,3121,19
Task 3087,Job 1,6,5,3,8,0,9,14,5,3,4,2,3087,3121,2
Task 3088,Job 0,9,10,4,9,1,13,18,5,4,3,0,3088,3121,10
Task 3088,Job 1,14,4,3,10,0,17,24,7,3,2,0,3088,3121,17
Task 3089,Job 0,5,6,3,9,0,8,14,6,3,4,0,3089,3122,19
Task 3089,Job 1,10,4,3,10,0,13,20,7,3,2,0,3089,3122,8
Task 3090,Job 0,3,7,2,11,0,5,14,9,2,3,2,3090,3124,19
Task 3090,Job 1,8,9,4,10,0,12,18,6,4,2,0,3090,3124,13
Task 3091,Job 0,10,4,2,10,0,12,20,8,2,4,1,3091,3124,11
Task 3091,Job 1,15,8,4,7,0,19,22,3,4,1,2,3091,3124,9
Task 3092,Job 0,6,10,1,10,0,7,16,9,1,4,2,3092,3125,12
Task 3092,Job 1,11,6,4,10,0,15,21,6,4,2,0,3092,3125,10
Task 3093,Job 0,1,5,3,12,1,4,13,9,3,1,0,3093,3127,12
Task 3093,Job 1,6,5,2,10,1,8,16,8,2,3,0,3093,3127,8
Task 3094,Job 0,4,10,4,10,1,8,14,6,4,3,2,3094,3127,11
Task 3094,Job 1,9,4,2,12,1,11,21,10,2,1,0,3094,3127,10
Task 3095,Job 0,8,10,1,8,0,9,16,7,1,3,0,3095,3129,8
Task 3095,Job 1,13,7,2,12,0,15,25,10,2,1,0,3095,3129,13
Task 3096,Job 0,6,4,1,6,0,7,12,5,1,1,1,3096,3129,2
Task 3096,Job 1,11,8,2,8,0,13,19,6,2,3,0,3096,3129,4
Task 3097,Job 0,1,9,1,8,1,2,9,7,1,2,1,3097,3131,13
Task 3097,Job 1,6,7,2,7,0,8,13,5,2,4,2,3097,3131,11
Task 3098,Job 0,3,6,1,11,1,4,14,10,1,4,1,3098,3132,9
Task 3098,Job 1,8,8,3,9,0,11,17,6,3,2,1,3098,3132,5
Task 3099,Job 0,3,8,1,6,0,4,9,5,1,4,2,3099,3132,20
Task 3099,Job 1,8,4,3,9,1,11,17,6,3,2,0,3099,3132,4
Task 3100,Job 0,1,8,3,7,0,4,8,4,3,1,1,3100,3133,12
Task 3100,Job 1,6,7,2,7,1,8,13,5,2,2,2,3100,3133,20
Task 3101,Job 0,7,5,2,6,0,9,13,4,2,1,0,3101,3135,16
Task 3101,Job 1,12,6,1,9,1,13,21,8,1,3,1,3101,3135,20
Task 3102,Job 0,6,7,1,6,0,7,12,5,1,2,2,3102,3136,15
Task 3102,Job 1,11,4,2,12,1,13,23,10,2,2,2,3102,3136,15
Task 3103,Job 0,5,5,2,9,0,7,14,7,2,4,1,3103,3136,17
Task 3103,Job 1,10,5,3,7,0,13,17,4,3,1,2,3103,3136,10
Task 3104,Job 0,1,7,1,9,0,2,10,8,1,1,2,3104,3137,5
Task 3104,Job 1,6,4,1,12,0,7,18,11,1,2,1,3104,3137,7
Task 3105,Job 0,9,8,1,10,1,10,19,9,1,2,0,3105,3139,8
Task 3105,Job 1,14,4,2,9,0,16,23,7,2,1,1,3105,3139,20
Task 3106,Job 0,8,10,2,11,1,10,19,9,2,3,2,3106,3139,19
Task 3106,Job 1,13,9,4,8,0,17,21,4,4,4,0,3106,3139,12
Task 3107,Job 0,3,8,1,9,0,4,12,8,1,4,0,3107,3141,3
Task 3107,Job 1,8,9,3,10,1,11,18,7,3,2,1,3107,3141,15
Task 3108,Job 0,7,5,4,11,1,11,18,7,4,3,0,3108,3142,15
Task 3108,Job 1,12,9,3,6,1,15,18,3,3,2,2,3108,3142,3
Task 3109,Job 0,6,9,3,12,0,9,18,9,3,1,1,3109,3143,19
Task 3109,Job 1,11,7,1,12,0,12,23,11,1,3,2,3109,3143,19
Task 3110,Job 0,4,6,1,12,1,5,16,11,1,4,2,3110,3143,13
Task 3110,Job 1,9,8,4,11,0,13,20,7,4,2,2,3110,3143,18
Task 3111,Job 0,3,7,4,12,0,7,15,8,4,2,2,3111,3144,3
Task 3111,Job 1,8,9,4,9,0,12,17,5,4,4,0,3111,3144,7
Task 3112,Job 0,8,4,1,8,0,9,16,7,1,2,0,3112,3145,16
Task 3112,Job 1,13,4,4,8,1,17,21,4,4,3,2,3112,3145,5
Task 3113,Job 0,4,10,1,11,0,5,15,10,1,1,0,3113,3146,7
Task 3113,Job 1,9,5,3,8,0,12,17,5,3,1,2,3113,3146,9
Task 3114,Job 0,1,4,2,8,0,3,9,6,2,2,2,3114,3148,13
Task 3114,Job 1,6,4,1,6,1,7,12,5,1,2,2,3114,3148,14
Task 3115,Job 0,2,10,3,11,0,5,13,8,3,3,2,3115,3148,3
Task 3115,Job 1,7,4,1,12,1,8,19,11,1,1,1,3115,3148,11
Task 3116,Job 0,5,4,3,8,0,8,13,5,3,3,2,3116,3149,13
Task 3116,Job 1,10,10,1,6,0,11,16,5,1,2,2,3116,3149,3
Task 3117,Job 0,1,8,3,11,0,4,12,8,3,4,1,3117,3151,5
Task 3117,Job 1,6,9,1,10,0,7,16,9,1,2,0,3117,3151,11
Task 3118,Job 0,5,10,3,8,0,8,13,5,3,4,1,3118,3151,10
Task 3118,Job 1,10,5,2,8,0,12,18,6,2,1,2,3118,3151,16
Task 3119,Job 0,6,5,1,12,0,7,18,11,1,2,2,3119,3152,7
Task 3119,Job 1,11,10,2,10,0,13,21,8,2,4,0,3119,3152,11
Task 3120,Job 0,3,5,3,8,0,6,11,5,3,2,1,3120,3153,19
Task 3120,Job 1,8,7,1,11,0,9,19,10,1,2,2,3120,3153,2
Task 3121,Job 0,9,10,3,12,0,12,21,9,3,4,2,3121,3154,11
Task 3121,Job 1,14,4,3,9,0,17,23,6,3,4,0,3121,3154,8
Task 3122,Job 0,4,8,3,8,0,7,12,5,3,2,1,3122,3156,3
Task 3122,Job 1,9,10,2,11,0,11,20,9,2,2,0,3122,3156,6
Task 3123,Job 0,3,4,3,9,0,6,12,6,3,4,2,3123,3156,12
Task 3123,Job 1,8,5,4,11,0,12,19,7,4,2,0,3123,3156,14
Task 3124,Job 0,8,5,4,12,0,12,20,8,4,1,2,3124,3157,2
Task 3124,Job 1,13,10,3,7,1,16,20,4,3,4,2,3124,3157,19
Task 3125,Job 0,9,4,2,7,0,11,16,5,2,4,1,3125,3159,10
Task 3125,Job 1,14,6,3,8,0,17,22,5,3,1,0,3125,3159,16
Task 3126,Job 0,7,8,2,8,0,9,15,6,2,2,0,3126,3159,6
Task 3126,Job 1,12,10,1,8,1,13,20,7,1,2,2,3126,3159,4
Task 3127,Job 0,4,5,2,12,1,6,16,10,2,1,2,3127,3161,3
Task 3127,Job 1,9,10,4,6,0,13,15,2,4,2,2,3127,3161,6
Task 3128,Job 0,4,9,3,12,0,7,16,9,3,3,0,3128,3162,3
Task 3128,Job 1,9,9,1,8,0,10,17,7,1,3,2,3128,3162,8
Task 3129,Job 0,1,6,2,7,1,3,8,5,2,1,1,3129,3162,7
Task 3129,Job 1,6,7,2,12,0,8,18,10,2,4,0,3129,3162,17
Task 3130,Job 0,10,5,2,6,0,12,16,4,2,1,2,3130,3164,14
Task 3130,Job 1,15,10,1,7,0,16,22,6,1,3,1,3130,3164,5
Task 3131,Job 0,10,10,2,6,0,12,16,4,2,1,1,3131,3164,7
Task 3131,Job 1,15,8,2,7,0,17,22,5,2,2,2,3131,3164,19
Task 3132,Job 0,7,8,3,12,1,10,19,9,3,1,0,3132,3165,14
Task 3132,Job 1,12,6,2,11,0,14,23,9,2,3,2,3132,3165,6
Task 3133,Job 0,10,6,1,8,0,11,18,7,1,4,0,3133,3166,4
Task 3133,Job 1,15,9,3,6,0,18,21,3,3,1,0,3133,3166,6
Task 3134,Job 0,2,7,2,9,0,4,11,7,2,2,0,3134,3167,15
Task 3134,Job 1,7,6,2,8,0,9,15,6,2,2,1,3134,3167,17
Task 3135,Job 0,6,6,2,6,0,8,12,4,2,2,1,3135,3169,16
Task 3135,Job 1,11,8,3,12,0,14,23,9,3,1,0,3135,3169,5
Task 3136,Job 0,7,6,1,8,1,8,15,7,1,1,2,3136,3170,5
Task 3136,Job 1,12,10,3,12,0,15,24,9,3,1,0,3136,3170,6
Task 3137,Job 0,9,8,1,12,0,10,21,11,1,3,2,3137,3171,15
Task 3137,Job 1,14,4,4,7,0,18,21,3,4,1,2,3137,3171,2
Task 3138,Job 0,10,10,2,12,0,12,22,10,2,1,2,3138,3171,2
Task 3138,Job 1,15,7,4,12,0,19,27,8,4,1,1,3138,3171,14
Task 3139,Job 0,9,5,1,9,0,10,18,8,1,4,0,3139,3172,8
Task 3139,Job 1,14,7,3,11,1,17,25,8,3,3,2,3139,3172,15
Task 3140,Job 0,3,10,4,8,0,7,11,4,4,2,0,3140,3174,2
Task 3140,Job 1,8,9,2,6,0,10,14,4,2,1,0,3140,3174,10
Task 3141,Job 0,9,10,3,8,0,12,17,5,3,1,2,3141,3175,8
Task 3141,Job 1,14,5,1,6,0,15,20,5,1,2,2,3141,3175,7
Task 3142,Job 0,1,10,4,8,0,5,9,4,4,1,2,3142,3176,17
Task 3142,Job 1,6,6,3,10,0,9,16,7,3,3,1,3142,3176,19
Task 3143,Job 0,7,10,3,7,1,10,14,4,3,2,0,3143,3176,18
Task 3143,Job 1,12,6,4,12,0,16,24,8,4,2,2,3143,3176,2
Task 3144,Job 0,5,5,4,6,0,9,11,2,4,2,1,3144,3177,9
Task 3144,Job 1,10,4,2,6,0,12,16,4,2,1,0,3144,3177,10
Task 3145,Job 0,5,6,3,10,0,8,15,7,3,3,1,3145,3179,10
Task 3145,Job 1,10,7,3,8,1,13,18,5,3,1,2,3145,3179,15
Task 3146,Job 0,10,9,3,12,0,13,22,9,3,1,1,3146,3179,5
Task 3146,Job 1,15,4,3,9,1,18,24,6,3,4,0,3146,3179,11
Task 3147,Job 0,6,10,3,11,1,9,17,8,3,3,0,3147,3181,10
Task 3147,Job 1,11,8,4,7,0,15,18,3,4,2,2,3147,3181,10
Task 3148,Job 0,2,6,3,6,0,5,8,3,3,1,1,3148,3181,3
Task 3148,Job 1,7,7,2,9,0,9,16,7,2,4,1,3148,3181,9
Task 3149,Job 0,6,8,3,8,0,9,14,5,3,4,2,3149,3182,10
Task 3149,Job 1,11,10,2,8,1,13,19,6,2,1,1,3149,3182,16
Task 3150,Job 0,6,4,3,12,0,9,18,9,3,4,2,3150,3184,5
Task 3150,Job 1,11,5,4,7,0,15,18,3,4,2,0,3150,3184,20
Task 3151,Job 0,5,4,2,10,0,7,15,8,2,3,1,3151,3185,20
Task 3151,Job 1,10,4,1,12,0,11,22,11,1,3,2,3151,3185,12
Task 3152,Job 0,3,10,2,6,1,5,9,4,2,2,2,3152,3186,9
Task 3152,Job 1,8,5,4,11,1,12,19,7,4,1,0,3152,3186,16
Task 3153,Job 0,1,4,2,8,0,3,9,6,2,2,0,3153,3186,8
Task 3153,Job 1,6,7,2,8,0,8,14,6,2,3,0,3153,3186,12
Task 3154,Job 0,9,8,1,8,0,10,17,7,1,1,2,3154,3187,17
Task 3154,Job 1,14,7,3,8,0,17,22,5,3,4,0,3154,3187,5
Task 3155,Job 0,1,9,2,11,0,3,12,9,2,4,1,3155,3188,7
Task 3155,Job 1,6,8,4,11,0,10,17,7,4,3,1,3155,3188,2
Task 3156,Job 0,10,7,2,8,0,12,18,6,2,3,0,3156,3189,5
Task 3156,Job 1,15,7,2,11,1,17,26,9,2,1,0,3156,3189,18
Task 3157,Job 0,2,6,3,6,0,5,8,3,3,1,2,3157,3190,14
Task 3157,Job 1,7,7,1,9,0,8,16,8,1,4,1,3157,3190,13
Task 3158,Job 0,7,6,1,8,1,8,15,7,1,4,2,3158,3192,9
Task 3158,Job 1,12,9,4,8,0,16,20,4,4,3,0,3158,3192,8
Task 3159,Job 0,10,4,1,7,0,11,17,6,1,1,0,3159,3192,16
Task 3159,Job 1,15,8,2,12,0,17,27,10,2,4,0,3159,3192,10
Task 3160,Job 0,4,10,3,10,0,7,14,7,3,4,0,3160,3193,6
Task 3160,Job 1,9,8,1,8,1,10,17,7,1,3,0,3160,3193,16
Task 3161,Job 0,8,7,2,7,0,10,15,5,2,4,2,3161,3194,9
Task 3161,Job 1,13,7,4,11,0,17,24,7,4,2,1,3161,3194,3
Task 3162,Job 0,7,5,2,8,1,9,15,6,2,1,2,3162,3196,18
Task 3162,Job 1,12,4,1,12,1,13,24,11,1,3,0,3162,3196,15
Task 3163,Job 0,1,5,4,11,0,5,12,7,4,3,0,3163,3196,11
Task 3163,Job 1,6,10,1,7,0,7,13,6,1,3,1,3163,3196,5
Task 3164,Job 0,6,9,3,6,0,9,12,3,3,4,2,3164,3197,8
Task 3164,Job 1,11,9,3,9,0,14,20,6,3,1,0,3164,3197,10
Task 3165,Job 0,10,5,2,12,0,12,22,10,2,1,2,3165,3199,18
Task 3165,Job 1,15,9,3,10,1,18,25,7,3,2,2,3165,3199,4
Task 3166,Job 0,8,7,1,11,0,9,19,10,1,2,2,3166,3200,8
Task 3166,Job 1,13,5,1,10,0,14,23,9,1,3,0,3166,3200,9
Task 3167,Job 0,2,9,2,8,0,4,10,6,2,3,2,3167,3201,15
Task 3167,Job 1,7,9,3,11,0,10,18,8,3,3,2,3167,3201,4
Task 3168,Job 0,1,9,3,9,0,4,10,6,3,3,0,3168,3201,12
Task 3168,Job 1,6,9,3,10,0,9,16,7,3,3,1,3168,3201,6
Task 3169,Job 0,10,10,1,11,0,11,21,10,1,2,0,3169,3203,9
Task 3169,Job 1,15,6,3,7,0,18,22,4,3,1,0,3169,3203,13
Task 3170,Job 0,2,5,2,7,1,4,9,5,2,1,0,3170,3204,11
Task 3170,Job 1,7,9,3,9,0,10,16,6,3,4,1,3170,3204,3
Task 3171,Job 0,4,10,4,8,0,8,12,4,4,4,1,3171,3205,5
Task 3171,Job 1,9,9,2,12,0,11,21,10,2,1,0,3171,3205,2
Task 3172,Job 0,3,4,2,12,0,5,15,10,2,1,2,3172,3206,2
Task 3172,Job 1,8,10,4,8,1,12,16,4,4,1,2,3172,3206,12
Task 3173,Job 0,10,6,1,11,1,11,21,10,1,3,2,3173,3207,5
Task 3173,Job 1,15,8,3,6,0,18,21,3,3,1,0,3173,3207,18
Task 3174,Job 0,1,7,2,12,1,3,13,10,2,1,1,3174,3208,2
Task 3174,Job 1,6,7,2,9,0,8,15,7,2,4,2,3174,3208,5
Task 3175,Job 0,1,4,4,10,0,5,11,6,4,3,0,3175,3209,15
Task 3175,Job 1,6,7,2,6,0,8,12,4,2,3,1,3175,3209,14
Task 3176,Job 0,1,10,4,10,0,5,11,6,4,4,0,3176,3209,12
Task 3176,Job 1,6,8,2,11,0,8,17,9,2,1,1,3176,3209,17
Task 3177,Job 0,4,4,2,7,0,6,11,5,2,4,0,3177,3211,10
Task 3177,Job 1,9,6,4,11,0,13,20,7,4,4,1,3177,3211,19
Task 3178,Job 0,4,9,4,8,0,8,12,4,4,2,1,3178,3211,14
Task 3178,Job 1,9,6,2,11,1,11,20,9,2,4,1,3178,3211,9
Task 3179,Job 0,7,8,3,6,0,10,13,3,3,2,2,3179,3212,2
Task 3179,Job 1,12,4,1,8,1,13,20,7,1,4,0,3179,3212,18
Task 3180,Job 0,4,5,3,12,1,7,16,9,3,4,2,3180,3213,12
Task 3180,Job 1,9,4,1,9,0,10,18,8,1,3,0,3180,3213,4
Task 3181,Job 0,8,10,1,8,1,9,16,7,1,3,2,3181,3215,16
Task 3181,Job 1,13,4,2,7,0,15,20,5,2,1,2,3181,3215,14
Task 3182,Job 0,10,5,3,6,0,13,16,3,3,4,1,3182,3215,7
Task 3182,Job 1,15,5,1,6,0,16,21,5,1,3,0,3182,3215,9
Task 3183,Job 0,1,8,4,10,1,5,11,6,4,4,0,3183,3216,13
Task 3183,Job 1,6,10,4,10,0,10,16,6,4,3,2,3183,3216,15
Task 3184,Job 0,3,10,4,8,0,7,11,4,4,4,1,3184,3218,13
Task 3184,Job 1,8,9,4,7,0,12,15,3,4,1,0,3184,3218,18
Task 3185,Job 0,10,7,3,6,1,13,16,3,3,4,0,3185,3219,19
Task 3185,Job 1,15,6,3,8,1,18,23,5,3,3,1,3185,3219,10
Task 3186,Job 0,5,9,4,12,0,9,17,8,4,4,1,3186,3220,20
Task 3186,Job 1,10,5,1,12,0,11,22,11,1,3,2,3186,3220,10
Task 3187,Job 0,8,5,4,9,0,12,17,5,4,4,2,3187,3220,11
Task 3187,Job 1,13,6,1,8,0,14,21,7,1,4,2,3187,3220,16
Task 3188,Job 0,4,9,2,12,1,6,16,10,2,1,0,3188,3222,18
Task 3188,Job 1,9,5,1,9,0,10,18,8,1,3,1,3188,3222,4
Task 3189,Job 0,5,8,4,9,0,9,14,5,4,3,1,3189,3222,5
Task 3189,Job 1,10,4,3,6,0,13,16,3,3,4,1,3189,3222,5
Task 3190,Job 0,8,7,4,10,0,12,18,6,4,3,0,3190,3224,13
Task 3190,Job 1,13,4,2,6,0,15,19,4,2,1,2,3190,3224,12
Task 3191,Job 0,4,8,4,11,1,8,15,7,4,3,0,3191,3225,12
Task 3191,Job 1,9,7,1,11,0,10,20,10,1,2,1,3191,3225,6
Task 3192,Job 0,4,10,2,7,0,6,11,5,2,3,0,3192,3226,2
Task 3192,Job 1,9,5,3,7,0,12,16,4,3,4,0,3192,3226,13
Task 3193,Job 0,8,6,4,11,0,12,19,7,4,4,1,3193,3226,6
Task 3193,Job 1,13,5,2,8,1,15,21,6,2,3,1,3193,3226,16
Task 3194,Job 0,10,7,3,7,0,13,17,4,3,2,0,3194,3227,14
Task 3194,Job 1,15,5,1,6,0,16,21,5,1,4,2,3194,3227,18
Task 3195,Job 0,2,10,4,11,0,6,13,7,4,2,0,3195,3228,9
Task 3195,Job 1,7,8,3,9,1,10,16,6,3,2,1,3195,3228,14
Task 3196,Job 0,4,10,1,8,0,5,12,7,1,2,2,3196,3230,19
Task 3196,Job 1,9,6,4,6,0,13,15,2,4,3,0,3196,3230,14
Task 3197,Job 0,1,7,3,7,0,4,8,4,3,1,1,3197,3230,12
Task 3197,Job 1,6,8,2,8,0,8,14,6,2,2,1,3197,3230,13
Task 3198,Job 0,7,6,3,6,0,10,13,3,3,1,1,3198,3232,14
Task 3198,Job 1,12,4,2,7,0,14,19,5,2,2,0,3198,3232,17
Task 3199,Job 0,6,6,2,10,0,8,16,8,2,2,2,3199,3232,15
Task 3199,Job 1,11,7,2,9,0,13,20,7,2,1,0,3199,3232,12
Task 3200,Job 0,1,10,4,12,0,5,13,8,4,3,2,3200,3233,11
Task 3200,Job 1,6,7,4,11,0,10,17,7,4,3,2,3200,3233,16
Task 3201,Job 0,1,8,3,8,1,4,9,5,3,1,2,3201,3235,8
Task 3201,Job 1,6,8,1,12,0,7,18,11,1,2,1,3201,3235,10
Task 3202,Job 0,8,7,4,9,0,12,17,5,4,4,0,3202,3236,15
Task 3202,Job 1,13,5,4,12,0,17,25,8,4,1,2,3202,3236,12
Task 3203,Job 0,1,8,2,8,0,3,9,6,2,2,1,3203,3236,9
Task 3203,Job 1,6,10,2,7,1,8,13,5,2,1,0,3203,3236,20
Task 3204,Job 0,2,10,2,6,1,4,8,4,2,3,0,3204,3238,13
Task 3204,Job 1,7,10,4,12,0,11,19,8,4,1,1,3204,3238,4
Task 3205,Job 0,9,7,1,11,0,10,20,10,1,4,1,3205,3238,3
Task 3205,Job 1,14,9,2,11,0,16,25,9,2,2,1,3205,3238,20
Task 3206,Job 0,9,5,1,9,0,10,18,8,1,2,0,3206,3239,8
Task 3206,Job 1,14,4,1,7,0,15,21,6,1,1,0,3206,3239,2
Task 3207,Job 0,4,4,2,10,1,6,14,8,2,3,0,3207,3241,9
Task 3207,Job 1,9,4,4,8,0,13,17,4,4,2,0,3207,3241,14
Task 3208,Job 0,5,4,1,9,0,6,14,8,1,3,1,3208,3241,10
Task 3208,Job 1,10,7,2,9,0,12,19,7,2,3,0,3208,3241,13
Task 3209,Job 0,6,6,4,8,0,10,14,4,4,2,0,3209,3242,20
Task 3209,Job 1,11,5,4,7,1,15,18,3,4,4,1,3209,3242,14
Task 3210,Job 0,3,9,3,8,0,6,11,5,3,2,0,3210,3244,19
Task 3210,Job 1,8,7,1,10,1,9,18,9,1,3,1,3210,3244,5
Task 3211,Job 0,3,9,3,10,0,6,13,7,3,1,1,3211,3244,20
Task 3211,Job 1,8,9,1,7,0,9,15,6,1,3,2,3211,3244,4
Task 3212,Job 0,5,9,3,11,0,8,16,8,3,2,0,3212,3246,3
Task 3212,Job 1,10,5,2,9,0,12,19,7,2,1,0,3212,3246,14
Task 3213,Job 0,8,10,3,9,1,11,17,6,3,3,2,3213,3247,11
Task 3213,Job 1,13,7,3,7,0,16,20,4,3,2,1,3213,3247,6
Task 3214,Job 0,9,6,2,7,0,11,16,5,2,4,2,3214,3247,19
Task 3214,Job 1,14,9,1,11,0,15,25,10,1,2,1,3214,3247,4
Task 3215,Job 0,6,8,1,8,0,7,14,7,1,2,0,3215,3248,13
Task 3215,Job 1,11,9,2,6,1,13,17,4,2,4,0,3215,3248,12
Task 3216,Job 0,6,10,3,8,1,9,14,5,3,1,0,3216,3249,14
Task 3216,Job 1,11,7,3,9,0,14,20,6,3,2,1,3216,3249,10
Task 3217,Job 0,2,5,4,11,0,6,13,7,4,4,1,3217,3250,3
Task 3217,Job 1,7,8,1,6,1,8,13,5,1,1,1,3217,3250,9
Task 3218,Job 0,6,6,3,6,0,9,12,3,3,2,0,3218,3252,7
Task 3218,Job 1,11,10,3,10,0,14,21,7,3,2,2,3218,3252,17
Task 3219,Job 0,8,7,1,8,0,9,16,7,1,1,0,3219,3252,2
Task 3219,Job 1,13,5,1,9,0,14,22,8,1,3,1,3219,3252,16
Task 3220,Job 0,8,9,4,6,0,12,14,2,4,3,2,3220,3254,11
Task 3220,Job 1,13,8,1,7,0,14,20,6,1,4,0,3220,3254,3
Task 3221,Job 0,10,4,3,12,1,13,22,9,3,3,2,3221,3254,5
Task 3221,Job 1,15,10,3,6,0,18,21,3,3,3,0,3221,3254,7
Task 3222,Job 0,8,7,3,7,0,11,15,4,3,4,1,3222,3256,3
Task 3222,Job 1,13,7,1,9,0,14,22,8,1,1,1,3222,3256,5
Task 3223,Job 0,1,5,3,9,0,4,10,6,3,2,0,3223,3257,9
Task 3223,Job 1,6,7,3,7,0,9,13,4,3,1,1,3223,3257,10
Task 3224,Job 0,4,7,4,10,0,8,14,6,4,1,0,3224,3258,4
Task 3224,Job 1,9,4,2,8,0,11,17,6,2,2,1,3224,3258,17
Task 3225,Job 0,3,5,2,6,0,5,9,4,2,2,0,3225,3258,18
Task 3225,Job 1,8,7,1,12,0,9,20,11,1,2,1,3225,3258,12
Task 3226,Job 0,10,4,4,12,1,14,22,8,4,1,2,3226,3260,9
Task 3226,Job 1,15,7,1,8,0,16,23,7,1,4,0,3226,3260,2
Task 3227,Job 0,6,6,2,11,0,8,17,9,2,3,0,3227,3261,6
Task 3227,Job 1,11,9,3,8,0,14,19,5,3,4,0,3227,3261,16
Task 3228,Job 0,5,4,2,12,1,7,17,10,2,4,1,3228,3261,9
Task 3228,Job 1,10,4,3,6,0,13,16,3,3,4,2,3228,3261,9
Task 3229,Job 0,7,10,3,12,0,10,19,9,3,4,1,3229,3262,17
Task 3229,Job 1,12,9,2,6,0,14,18,4,2,4,0,3229,3262,15
Task 3230,Job 0,10,8,2,6,1,12,16,4,2,1,1,3230,3264,19
Task 3230,Job 1,15,6,4,10,1,19,25,6,4,4,1,3230,3264,14
Task 3231,Job 0,8,9,3,7,0,11,15,4,3,4,1,3231,3265,11
Task 3231,Job 1,13,5,2,9,1,15,22,7,2,3,0,3231,3265,13
Task 3232,Job 0,5,10,4,12,0,9,17,8,4,2,2,3232,3266,10
Task 3232,Job 1,10,9,4,11,0,14,21,7,4,2,0,3232,3266,19
Task 3233,Job 0,3,8,1,12,1,4,15,11,1,2,0,3233,3266,3
Task 3233,Job 1,8,7,3,6,1,11,14,3,3,2,0,3233,3266,14
Task 3234,Job 0,9,5,3,6,0,12,15,3,3,1,0,3234,3268,19
Task 3234,Job 1,14,9,4,8,0,18,22,4,4,3,1,3234,3268,10
Task 3235,Job 0,9,10,1,7,1,10,16,6,1,4,2,3235,3268,8
Task 3235,Job 1,14,6,1,7,0,15,21,6,1,4,0,3235,3268,7
Task 3236,Job 0,2,5,4,7,0,6,9,3,4,4,0,3236,3269,3
Task 3236,Job 1,7,10,3,11,0,10,18,8,3,3,1,3236,3269,19
Task 3237,Job 0,10,9,1,8,0,11,18,7,1,1,1,3237,3271,9
Task 3237,Job 1,15,10,3,6,0,18,21,3,3,2,2,3237,3271,8
Task 3238,Job 0,7,7,2,11,1,9,18,9,2,4,0,3238,3272,5
Task 3238,Job 1,12,4,1,11,0,13,23,10,1,2,2,3238,3272,4
Task 3239,Job 0,1,6,2,6,1,3,7,4,2,3,0,3239,3273,18
Task 3239,Job 1,6,4,4,8,0,10,14,4,4,2,0,3239,3273,19
Task 3240,Job 0,4,8,1,11,0,5,15,10,1,1,0,3240,3273,6
Task 3240,Job 1,9,8,4,12,1,13,21,8,4,1,2,3240,3273,2
Task 3241,Job 0,5,8,1,7,0,6,12,6,1,4,1,3241,3274,12
Task 3241,Job 1,10,8,3,8,0,13,18,5,3,3,0,3241,3274,15
Task 3242,Job 0,7,5,3,6,0,10,13,3,3,4,1,3242,3275,6
Task 3242,Job 1,12,6,3,8,1,15,20,5,3,1,0,3242,3275,12
Task 3243,Job 0,1,6,3,7,0,4,8,4,3,1,2,3243,3277,18
Task 3243,Job 1,6,9,4,7,0,10,13,3,4,2,1,3243,3277,6
Task 3244,Job 0,9,6,2,6,0,11,15,4,2,4,0,3244,3277,12
Task 3244,Job 1,14,10,4,12,0,18,26,8,4,3,1,3244,3277,9
Task 3245,Job 0,8,4,2,6,0,10,14,4,2,1,1,3245,3279,7
Task 3245,Job 1,13,4,4,7,0,17,20,3,4,4,2,3245,3279,9
Task 3246,Job 0,4,4,1,7,0,5,11,6,1,4,2,3246,3279,11
Task 3246,Job 1,9,7,1,12,0,10,21,11,1,4,0,3246,3279,8
Task 3247,Job 0,3,8,3,10,1,6,13,7,3,1,0,3247,3280,4
Task 3247,Job 1,8,5,4,6,0,12,14,2,4,2,1,3247,3280,7
Task 3248,Job 0,1,10,4,8,0,5,9,4,4,2,2,3248,3282,3
Task 3248,Job 1,6,5,4,9,0,10,15,5,4,1,2,3248,3282,17
Task 3249,Job 0,2,7,4,6,0,6,8,2,4,1,2,3249,3282,3
Task 3249,Job 1,7,7,2,7,0,9,14,5,2,4,1,3249,3282,7
Task 3250,Job 0,7,4,2,11,0,9,18,9,2,3,1,3250,3283,17
Task 3250,Job 1,12,10,1,8,0,13,20,7,1,1,0,3250,3283,2
Task 3251,Job 0,4,9,3,7,0,7,11,4,3,3,2,3251,3285,11
Task 3251,Job 1,9,10,1,7,0,10,16,6,1,4,2,3251,3285,12
Task 3252,Job 0,7,7,4,11,0,11,18,7,4,4,1,3252,3285,19
Task 3252,Job 1,12,8,3,12,0,15,24,9,3,1,0,3252,3285,16
Task 3253,Job 0,3,9,2,11,0,5,14,9,2,1,1,3253,3286,9
Task 3253,Job 1,8,7,4,8,0,12,16,4,4,3,1,3253,3286,5
Task 3254,Job 0,8,8,3,7,0,11,15,4,3,3,2,3254,3288,16
Task 3254,Job 1,13,10,4,7,1,17,20,3,4,1,1,3254,3288,16
Task 3255,Job 0,10,4,3,10,1,13,20,7,3,3,1,3255,3289,19
Task 3255,Job 1,15,4,4,11,0,19,26,7,4,1,0,3255,3289,20
Task 3256,Job 0,2,5,3,7,0,5,9,4,3,4,2,3256,3290,19
Task 3256,Job 1,7,8,4,6,0,11,13,2,4,1,1,3256,3290,15
Task 3257,Job 0,7,8,4,11,0,11,18,7,4,2,2,3257,3290,15
Task 3257,Job 1,12,4,3,11,0,15,23,8,3,1,0,3257,3290,5
Task 3258,Job 0,6,4,2,7,0,8,13,5,2,3,2,3258,3292,2
Task 3258,Job 1,11,10,4,9,1,15,20,5,4,4,1,3258,3292,6
Task 3259,Job 0,6,7,2,9,1,8,15,7,2,1,1,3259,3292,3
Task 3259,Job 1,11,8,1,12,0,12,23,11,1,1,2,3259,3292,14
Task 3260,Job 0,3,6,2,9,0,5,12,7,2,1,0,3260,3293,2
Task 3260,Job 1,8,9,2,12,0,10,20,10,2,1,2,3260,3293,5
Task 3261,Job 0,1,8,3,6,0,4,7,3,3,1,2,3261,3295,3
Task 3261,Job 1,6,8,2,10,0,8,16,8,2,4,0,3261,3295,14
Task 3262,Job 0,10,5,3,11,0,13,21,8,3,2,1,3262,3295,16
Task 3262,Job 1,15,10,2,12,0,17,27,10,2,3,1,3262,3295,15
Task 3263,Job 0,10,4,1,6,0,11,16,5,1,4,0,3263,3297,20
Task 3263,Job 1,15,5,4,11,1,19,26,7,4,1,2,3263,3297,8
Task 3264,Job 0,5,10,2,8,1,7,13,6,2,4,2,3264,3298,4
Task 3264,Job 1,10,8,2,6,1,12,16,4,2,4,0,3264,3298,14
Task 3265,Job 0,7,5,1,6,1,8,13,5,1,4,1,3265,3299,3
Task 3265,Job 1,12,10,2,11,0,14,23,9,2,3,1,3265,3299,18
Task 3266,Job 0,5,10,3,11,1,8,16,8,3,3,1,3266,3300,20
Task 3266,Job 1,10,5,2,12,1,12,22,10,2,2,1,3266,3300,20
Task 3267,Job 0,5,8,4,7,0,9,12,3,4,3,2,3267,3300,2
Task 3267,Job 1,10,6,3,12,0,13,22,9,3,3,0,3267,3300,6
Task 3268,Job 0,9,7,4,12,0,13,21,8,4,1,1,3268,3302,2
Task 3268,Job 1,14,7,2,10,1,16,24,8,2,1,2,3268,3302,5
Task 3269,Job 0,6,10,3,6,0,9,12,3,3,3,1,3269,3302,20
Task 3269,Job 1,11,8,4,12,0,15,23,8,4,2,1,3269,3302,9
Task 3270,Job 0,8,6,4,8,1,12,16,4,4,2,1,3270,3303,13
Task 3270,Job 1,13,6,1,11,0,14,24,10,1,3,2,3270,3303,10
Task 3271,Job 0,1,5,2,12,0,3,13,10,2,1,1,3271,3304,15
Task 3271,Job 1,6,5,1,7,0,7,13,6,1,1,1,3271,3304,16
Task 3272,Job 0,9,8,2,10,0,11,19,8,2,3,1,3272,3305,4
Task 3272,Job 1,14,8,4,6,0,18,20,2,4,2,2,3272,3305,11
Task 3273,Job 0,3,4,4,7,0,7,10,3,4,4,1,3273,3307,3
Task 3273,Job 1,8,4,3,6,1,11,14,3,3,3,0,3273,3307,9
Task 3274,Job 0,7,9,2,6,1,9,13,4,2,4,2,3274,3307,20
Task 3274,Job 1,12,5,1,7,0,13,19,6,1,4,0,3274,3307,20
Task 3275,Job 0,3,4,2,12,1,5,15,10,2,2,0,3275,3309,7
Task 3275,Job 1,8,7,1,10,1,9,18,9,1,3,2,3275,3309,4
Task 3276,Job 0,8,6,2,9,1,10,17,7,2,1,2,3276,3310,13
Task 3276,Job 1,13,5,2,7,0,15,20,5,2,3,2,3276,3310,9
Task 3277,Job 0,6,8,4,6,1,10,12,2,4,2,0,3277,3311,4
Task 3277,Job 1,11,10,4,10,0,15,21,6,4,3,1,3277,3311,11
Task 3278,Job 0,1,7,4,10,0,5,11,6,4,1,0,3278,3311,10
Task 3278,Job 1,6,6,1,10,1,7,16,9,1,3,2,3278,3311,12
Task 3279,Job 0,1,9,3,11,0,4,12,8,3,2,0,3279,3313,3
Task 3279,Job 1,6,8,2,12,0,8,18,10,2,2,2,3279,3313,10
Task 3280,Job 0,5,8,2,6,1,7,11,4,2,4,2,3280,3313,16
Task 3280,Job 1,10,8,1,6,0,11,16,5,1,4,2,3280,3313,4
Task 3281,Job 0,9,7,2,8,1,11,17,6,2,3,1,3281,3315,3
Task 3281,Job 1,14,9,1,8,1,15,22,7,1,1,1,3281,3315,15
Task 3282,Job 0,6,5,3,7,1,9,13,4,3,1,0,3282,3316,2
Task 3282,Job 1,11,8,3,7,0,14,18,4,3,2,2,3282,3316,13
Task 3283,Job 0,10,6,4,9,0,14,19,5,4,4,2,3283,3316,14
Task 3283,Job 1,15,8,4,7,0,19,22,3,4,2,2,3283,3316,16
Task 3284,Job 0,5,5,2,10,0,7,15,8,2,2,0,3284,3318,18
Task 3284,Job 1,10,7,1,6,0,11,16,5,1,3,1,3284,3318,11
Task 3285,Job 0,2,9,4,6,1,6,8,2,4,3,0,3285,3318,15
Task 3285,Job 1,7,4,4,7,0,11,14,3,4,2,1,3285,3318,9
Task 3286,Job 0,10,8,4,7,0,14,17,3,4,4,2,3286,3320,3
Task 3286,Job 1,15,8,4,10,0,19,25,6,4,1,2,3286,3320,14
Task 3287,Job 0,3,8,2,11,0,5,14,9,2,3,2,3287,3321,17
Task 3287,Job 1,8,7,2,7,0,10,15,5,2,3,0,3287,3321,2
Task 3288,Job 0,8,8,3,9,1,11,17,6,3,1,2,3288,3321,12
Task 3288,Job 1,13,5,2,6,1,15,19,4,2,1,2,3288,3321,15
Task 3289,Job 0,8,7,3,11,0,11,19,8,3,1,1,3289,3323,14
Task 3289,Job 1,13,9,2,9,0,15,22,7,2,3,0,3289,3323,4
Task 3290,Job 0,4,5,3,9,0,7,13,6,3,4,0,3290,3324,2
Task 3290,Job 1,9,8,4,9,0,13,18,5,4,4,0,3290,3324,19
Task 3291,Job 0,5,9,4,7,1,9,12,3,4,4,0,3291,3325,17
Task 3291,Job 1,10,5,4,6,0,14,16,2,4,3,0,3291,3325,9
Task 3292,Job 0,1,10,3,10,0,4,11,7,3,2,2,3292,3326,6
Task 3292,Job 1,6,5,4,11,0,10,17,7,4,3,1,3292,3326,17
Task 3293,Job 0,6,7,4,9,0,10,15,5,4,3,1,3293,3326,19
Task 3293,Job 1,11,4,4,7,0,15,18,3,4,1,1,3293,3326,8
Task 3294,Job 0,4,10,2,7,0,6,11,5,2,3,0,3294,3328,6
Task 3294,Job 1,9,4,3,8,0,12,17,5,3,1,1,3294,3328,7
Task 3295,Job 0,4,8,4,9,0,8,13,5,4,2,1,3295,3328,11
Task 3295,Job 1,9,5,3,11,0,12,20,8,3,4,0,3295,3328,12
Task 3296,Job 0,1,4,4,9,0,5,10,5,4,4,2,3296,3329,15
Task 3296,Job 1,6,7,1,6,1,7,12,5,1,1,2,3296,3329,2
Task 3297,Job 0,5,4,3,11,1,8,16,8,3,3,1,3297,3330,10
Task 3297,Job 1,10,8,2,9,0,12,19,7,2,3,0,3297,3330,20
Task 3298,Job 0,3,7,4,6,0,7,9,2,4,1,2,3298,3331,11
Task 3298,Job 1,8,8,2,8,1,10,16,6,2,2,0,3298,3331,11
Task 3299,Job 0,6,9,2,12,0,8,18,10,2,3,1,3299,3332,19
Task 3299,Job 1,11,6,4,12,0,15,23,8,4,2,0,3299,3332,19
Task 3300,Job 0,7,6,2,11,0,9,18,9,2,2,1,3300,3333,19
Task 3300,Job 1,12,9,1,8,1,13,20,7,1,4,0,3300,3333,9
Task 3301,Job 0,1,7,2,7,0,3,8,5,2,2,0,3301,3334,12
Task 3301,Job 1,6,4,3,11,1,9,17,8,3,3,1,3301,3334,19
Task 3302,Job 0,2,5,4,12,1,6,14,8,4,3,1,3302,3335,13
Task 3302,Job 1,7,6,2,12,0,9,19,10,2,2,0,3302,3335,17
Task 3303,Job 0,4,5,4,7,0,8,11,3,4,3,1,3303,3336,18
Task 3303,Job 1,9,4,3,10,0,12,19,7,3,4,2,3303,3336,16
Task 3304,Job 0,1,9,4,9,1,5,10,5,4,4,2,3304,3337,12
Task 3304,Job 1,6,6,2,10,0,8,16,8,2,1,2,3304,3337,16
Task 3305,Job 0,5,7,4,9,0,9,14,5,4,4,1,3305,3339,19
Task 3305,Job 1,10,8,1,6,0,11,16,5,1,4,0,3305,3339,13
Task 3306,Job 0,3,10,1,9,1,4,12,8,1,4,2,3306,3339,12
Task 3306,Job 1,8,6,1,8,0,9,16,7,1,4,1,3306,3339,18
Task 3307,Job 0,1,4,4,8,0,5,9,4,4,3,2,3307,3340,12
Task 3307,Job 1,6,10,1,9,1,7,15,8,1,4,2,3307,3340,12
Task 3308,Job 0,10,4,4,6,1,14,16,2,4,3,1,3308,3341,10
Task 3308,Job 1,15,7,3,12,0,18,27,9,3,3,2,3308,3341,7
Task 3309,Job 0,7,8,4,12,0,11,19,8,4,2,0,3309,3343,7
Task 3309,Job 1,12,8,2,10,0,14,22,8,2,1,1,3309,3343,6
Task 3310,Job 0,1,5,1,8,0,2,9,7,1,3,0,3310,3344,14
Task 3310,Job 1,6,9,3,7,0,9,13,4,3,1,1,3310,3344,2
Task 3311,Job 0,6,4,2,10,0,8,16,8,2,2,1,3311,3345,16
Task 3311,Job 1,11,10,2,7,0,13,18,5,2,3,2,3311,3345,15
Task 3312,Job 0,3,9,4,6,0,7,9,2,4,3,2,3312,3345,5
Task 3312,Job 1,8,9,3,8,1,11,16,5,3,1,2,3312,3345,14
Task 3313,Job 0,4,6,2,7,0,6,11,5,2,2,0,3313,3346,3
Task 3313,Job 1,9,5,3,7,0,12,16,4,3,1,0,3313,3346,18
Task 3314,Job 0,2,4,3,9,1,5,11,6,3,2,2,3314,3347,13
Task 3314,Job 1,7,10,1,9,0,8,16,8,1,3,0,3314,3347,2
Task 3315,Job 0,2,9,1,9,0,3,11,8,1,4,0,3315,3348,7
Task 3315,Job 1,7,4,4,11,0,11,18,7,4,4,1,3315,3348,11
Task 3316,Job 0,3,7,2,7,1,5,10,5,2,2,1,3316,3349,4
Task 3316,Job 1,8,4,1,6,0,9,14,5,1,4,2,3316,3349,10
Task 3317,Job 0,1,8,4,9,1,5,10,5,4,1,0,3317,3350,6
Task 3317,Job 1,6,5,3,9,0,9,15,6,3,1,0,3317,3350,14
Task 3318,Job 0,1,4,4,9,1,5,10,5,4,2,0,3318,3352,15
Task 3318,Job 1,6,6,3,9,0,9,15,6,3,3,1,3318,3352,14
Task 3319,Job 0,8,9,4,11,0,12,19,7,4,4,2,3319,3353,20
Task 3319,Job 1,13,5,1,7,0,14,20,6,1,2,2,3319,3353,15
Task 3320,Job 0,6,6,4,11,0,10,17,7,4,1,2,3320,3354,6
Task 3320,Job 1,11,8,2,10,0,13,21,8,2,4,2,3320,3354,9
Task 3321,Job 0,6,4,4,9,1,10,15,5,4,1,2,3321,3354,6
Task 3321,Job 1,11,4,4,11,1,15,22,7,4,3,1,3321,3354,20
Task 3322,Job 0,1,10,2,10,0,3,11,8,2,3,2,3322,3356,18
Task 3322,Job 1,6,4,3,12,0,9,18,9,3,3,0,3322,3356,19
Task 3323,Job 0,4,9,2,12,1,6,16,10,2,3,0,3323,3356,2
Task 3323,Job 1,9,8,4,11,0,13,20,7,4,1,0,3323,3356,11
Task 3324,Job 0,4,4,2,8,0,6,12,6,2,2,0,3324,3358,10
Task 3324,Job 1,9,5,3,9,0,12,18,6,3,2,1,3324,3358,20
Task 3325,Job 0,10,5,4,6,0,14,16,2,4,3,1,3325,3358,10
Task 3325,Job 1,15,9,4,9,1,19,24,5,4,3,2,3325,3358,4
Task 3326,Job 0,4,6,3,6,0,7,10,3,3,3,0,3326,3359,6
Task 3326,Job 1,9,6,4,9,0,13,18,5,4,4,2,3326,3359,19
Task 3327,Job 0,5,10,2,7,0,7,12,5,2,1,2,3327,3360,6
Task 3327,Job 1,10,10,4,10,0,14,20,6,4,2,1,3327,3360,15
Task 3328,Job 0,5,4,2,9,1,7,14,7,2,3,2,3328,3361,14
Task 3328,Job 1,10,4,2,9,1,12,19,7,2,1,0,3328,3361,13
Task 3329,Job 0,6,4,4,12,0,10,18,8,4,4,0,3329,3362,14
Task 3329,Job 1,11,7,2,12,0,13,23,10,2,4,0,3329,3362,20
Task 3330,Job 0,4,9,4,9,0,8,13,5,4,4,0,3330,3363,9
Task 3330,Job 1,9,5,4,7,1,13,16,3,4,4,0,3330,3363,17
Task 3331,Job 0,9,5,2,11,0,11,20,9,2,2,1,3331,3364,2
Task 3331,Job 1,14,5,2,11,0,16,25,9,2,1,2,3331,3364,13
Task 3332,Job 0,1,4,2,12,1,3,13,10,2,2,1,3332,3366,17
Task 3332,Job 1,6,4,2,12,0,8,18,10,2,1,1,3332,3366,8
Task 3333,Job 0,6,9,2,11,0,8,17,9,2,4,1,3333,3366,13
Task 3333,Job 1,11,4,2,8,1,13,19,6,2,1,0,3333,3366,4
Task 3334,Job 0,1,8,4,11,1,5,12,7,4,2,0,3334,3368,15
Task 3334,Job 1,6,10,3,9,0,9,15,6,3,2,1,3334,3368,16
Task 3335,Job 0,10,8,4,6,1,14,16,2,4,2,2,3335,3369,2
Task 3335,Job 1,15,10,1,6,1,16,21,5,1,3,2,3335,3369,12
Task 3336,Job 0,4,6,1,6,0,5,10,5,1,3,0,3336,3369,14
Task 3336,Job 1,9,7,4,12,1,13,21,8,4,2,0,3336,3369,6
Task 3337,Job 0,5,9,3,10,0,8,15,7,3,2,1,3337,3370,13
Task 3337,Job 1,10,4,2,12,0,12,22,10,2,1,2,3337,3370,13
Task 3338,Job 0,2,4,1,6,1,3,8,5,1,3,2,3338,3372,11
Task 3338,Job 1,7,4,4,9,0,11,16,5,4,4,0,3338,3372,20
Task 3339,Job 0,2,9,1,11,0,3,13,10,1,2,0,3339,3372,16
Task 3339,Job 1,7,7,4,9,1,11,16,5,4,3,1,3339,3372,9
Task 3340,Job 0,1,7,4,6,0,5,7,2,4,3,2,3340,3373,4
Task 3340,Job 1,6,10,3,10,0,9,16,7,3,2,1,3340,3373,4
Task 3341,Job 0,6,5,4,11,0,10,17,7,4,3,0,3341,3374,7
Task 3341,Job 1,11,5,3,12,0,14,23,9,3,1,0,3341,3374,17
Task 3342,Job 0,1,6,2,6,1,3,7,4,2,3,2,3342,3376,6
Task 3342,Job 1,6,8,2,8,1,8,14,6,2,4,0,3342,3376,16
Task 3343,Job 0,9,6,1,6,1,10,15,5,1,4,0,3343,3377,14
Task 3343,Job 1,14,6,2,6,1,16,20,4,2,2,0,3343,3377,15
Task 3344,Job 0,5,6,1,11,0,6,16,10,1,1,0,3344,3377,6
Task 3344,Job 1,10,10,4,8,0,14,18,4,4,4,0,3344,3377,5
Task 3345,Job 0,2,6,3,6,0,5,8,3,3,4,1,3345,3378,2
Task 3345,Job 1,7,5,4,9,1,11,16,5,4,3,1,3345,3378,19
Task 3346,Job 0,7,10,2,12,0,9,19,10,2,3,2,3346,3380,7
Task 3346,Job 1,12,10,1,9,0,13,21,8,1,2,0,3346,3380,7
Task 3347,Job 0,3,7,4,9,1,7,12,5,4,1,1,3347,3381,3
Task 3347,Job 1,8,8,4,9,0,12,17,5,4,1,1,3347,3381,19
Task 3348,Job 0,5,9,3,7,0,8,12,4,3,2,2,3348,3381,16
Task 3348,Job 1,10,5,1,11,0,11,21,10,1,4,0,3348,3381,18
Task 3349,Job 0,6,4,4,8,0,10,14,4,4,4,1,3349,3383,11
Task 3349,Job 1,11,7,4,12,0,15,23,8,4,1,2,3349,3383,15
Task 3350,Job 0,4,7,4,11,0,8,15,7,4,1,1,3350,3383,18
Task 3350,Job 1,9,8,3,10,0,12,19,7,3,1,1,3350,3383,16
Task 3351,Job 0,3,10,1,8,0,4,11,7,1,1,0,3351,3385,6
Task 3351,Job 1,8,8,1,8,0,9,16,7,1,2,0,3351,3385,16
Task 3352,Job 0,4,8,3,9,0,7,13,6,3,1,0,3352,3386,13
Task 3352,Job 1,9,10,1,7,0,10,16,6,1,2,2,3352,3386,11
Task 3353,Job 0,5,6,4,7,0,9,12,3,4,3,1,3353,3386,5
Task 3353,Job 1,10,9,3,11,0,13,21,8,3,2,2,3353,3386,13
Task 3354,Job 0,1,5,1,11,0,2,12,10,1,4,2,3354,3388,14
Task 3354,Job 1,6,10,2,12,0,8,18,10,2,2,2,3354,3388,10
Task 3355,Job 0,10,7,1,11,0,11,21,10,1,2,1,3355,3389,19
Task 3355,Job 1,15,4,3,6,0,18,21,3,3,2,1,3355,3389,12
Task 3356,Job 0,8,6,4,11,0,12,19,7,4,3,1,3356,3390,4
Task 3356,Job 1,13,10,1,9,0,14,22,8,1,4,2,3356,3390,18
Task 3357,Job 0,9,7,4,6,1,13,15,2,4,3,1,3357,3390,12
Task 3357,Job 1,14,4,4,11,1,18,25,7,4,4,2,3357,3390,3
Task 3358,Job 0,7,10,2,6,0,9,13,4,2,3,0,3358,3391,20
Task 3358,Job 1,12,4,4,11,0,16,23,7,4,4,2,3358,3391,2
Task 3359,Job 0,7,8,2,7,0,9,14,5,2,2,0,3359,3393,12
Task 3359,Job 1,12,7,4,7,1,16,19,3,4,2,2,3359,3393,7
Task 3360,Job 0,1,9,1,7,0,2,8,6,1,1,1,3360,3393,9
Task 3360,Job 1,6,7,4,6,0,10,12,2,4,1,2,3360,3393,7
Task 3361,Job 0,10,5,3,6,1,13,16,3,3,1,1,3361,3394,11
Task 3361,Job 1,15,5,3,9,0,18,24,6,3,3,2,3361,3394,4
Task 3362,Job 0,8,8,3,6,0,11,14,3,3,2,2,3362,3396,5
Task 3362,Job 1,13,7,4,6,0,17,19,2,4,4,1,3362,3396,6
Task 3363,Job 0,5,6,4,12,0,9,17,8,4,4,2,3363,3397,3
Task 3363,Job 1,10,7,3,6,0,13,16,3,3,4,2,3363,3397,11
Task 3364,Job 0,10,9,2,6,0,12,16,4,2,4,1,3364,3397,8
Task 3364,Job 1,15,7,1,11,0,16,26,10,1,1,0,3364,3397,4
Task 3365,Job 0,6,5,1,7,0,7,13,6,1,4,2,3365,3398,3
Task 3365,Job 1,11,9,2,7,0,13,18,5,2,1,2,3365,3398,4
Task 3366,Job 0,7,10,4,10,0,11,17,6,4,1,2,3366,3399,6
Task 3366,Job 1,12,6,2,9,0,14,21,7,2,4,2,3366,3399,18
Task 3367,Job 0,9,5,2,12,0,11,21,10,2,3,2,3367,3401,10
Task 3367,Job 1,14,9,2,6,1,16,20,4,2,3,0,3367,3401,11
Task 3368,Job 0,3,9,3,6,0,6,9,3,3,4,2,3368,3402,7
Task 3368,Job 1,8,4,4,12,0,12,20,8,4,4,2,3368,3402,8
Task 3369,Job 0,1,7,2,7,1,3,8,5,2,3,2,3369,3402,11
Task 3369,Job 1,6,10,1,8,1,7,14,7,1,3,1,3369,3402,6
Task 3370,Job 0,1,5,1,7,0,2,8,6,1,1,2,3370,3404,4
Task 3370,Job 1,6,9,4,8,0,10,14,4,4,3,1,3370,3404,19
Task 3371,Job 0,7,9,2,9,1,9,16,7,2,2,2,3371,3405,15
Task 3371,Job 1,12,4,2,6,0,14,18,4,2,3,0,3371,3405,12
Task 3372,Job 0,3,8,3,11,0,6,14,8,3,1,1,3372,3405,16
Task 3372,Job 1,8,7,1,7,0,9,15,6,1,1,2,3372,3405,4
Task 3373,Job 0,6,6,4,11,0,10,17,7,4,3,1,3373,3407,5
Task 3373,Job 1,11,8,2,8,0,13,19,6,2,4,0,3373,3407,14
Task 3374,Job 0,4,10,2,8,0,6,12,6,2,4,0,3374,3408,14
Task 3374,Job 1,9,10,2,9,0,11,18,7,2,2,1,3374,3408,9
Task 3375,Job 0,3,5,2,8,0,5,11,6,2,1,0,3375,3409,13
Task 3375,Job 1,8,4,3,8,0,11,16,5,3,4,2,3375,3409,17
Task 3376,Job 0,9,5,4,9,0,13,18,5,4,3,2,3376,3409,6
Task 3376,Job 1,14,6,4,9,0,18,23,5,4,4,0,3376,3409,12
Task 3377,Job 0,8,10,2,9,0,10,17,7,2,4,0,3377,3411,13
Task 3377,Job 1,13,5,2,6,0,15,19,4,2,3,2,3377,3411,13
Task 3378,Job 0,5,6,1,9,0,6,14,8,1,1,2,3378,3412,9
Task 3378,Job 1,10,8,3,6,1,13,16,3,3,2,1,3378,3412,5
Task 3379,Job 0,7,8,2,7,0,9,14,5,2,4,2,3379,3413,11
Task 3379,Job 1,12,5,2,12,0,14,24,10,2,2,2,3379,3413,10
Task 3380,Job 0,5,8,4,11,0,9,16,7,4,3,2,3380,3414,20
Task 3380,Job 1,10,10,1,12,0,11,22,11,1,2,0,3380,3414,18
Task 3381,Job 0,8,7,3,12,0,11,20,9,3,1,0,3381,3415,7
Task 3381,Job 1,13,9,4,6,0,17,19,2,4,3,1,3381,3415,15
Task 3382,Job 0,10,4,4,6,0,14,16,2,4,1,0,3382,3416,20
Task 3382,Job 1,15,7,1,6,1,16,21,5,1,1,2,3382,3416,5
Task 3383,Job 0,10,6,3,6,0,13,16,3,3,1,0,3383,3417,4
Task 3383,Job 1,15,6,3,12,1,18,27,9,3,3,1,3383,3417,4
Task 3384,Job 0,2,7,2,7,0,4,9,5,2,1,2,3384,3417,13
Task 3384,Job 1,7,6,1,12,0,8,19,11,1,4,1,3384,3417,14
Task 3385,Job 0,5,8,4,10,0,9,15,6,4,4,0,3385,3419,14
Task 3385,Job 1,10,9,1,7,0,11,17,6,1,1,2,3385,3419,15
Task 3386,Job 0,6,9,1,6,1,7,12,5,1,2,0,3386,3419,20
Task 3386,Job 1,11,10,3,6,1,14,17,3,3,3,1,3386,3419,10
Task 3387,Job 0,5,6,4,6,0,9,11,2,4,2,0,3387,3421,3
Task 3387,Job 1,10,5,3,9,0,13,19,6,3,3,2,3387,3421,7
Task 3388,Job 0,8,9,3,6,0,11,14,3,3,1,0,3388,3422,5
Task 3388,Job 1,13,7,4,10,0,17,23,6,4,4,2,3388,3422,20
Task 3389,Job 0,9,8,2,10,0,11,19,8,2,4,0,3389,3423,13
Task 3389,Job 1,14,10,1,10,0,15,24,9,1,3,2,3389,3423,16
Task 3390,Job 0,7,10,2,11,0,9,18,9,2,3,1,3390,3423,7
Task 3390,Job 1,12,6,2,12,0,14,24,10,2,1,1,3390,3423,10
Task 3391,Job 0,5,6,2,7,0,7,12,5,2,1,1,3391,3424,20
Task 3391,Job 1,10,6,2,12,0,12,22,10,2,4,0,3391,3424,2
Task 3392,Job 0,6,7,1,6,1,7,12,5,1,3,0,3392,3425,20
Task 3392,Job 1,11,10,4,8,0,15,19,4,4,3,1,3392,3425,2
Task 3393,Job 0,5,8,3,7,0,8,12,4,3,1,2,3393,3427,14
Task 3393,Job 1,10,4,2,11,0,12,21,9,2,1,0,3393,3427,11
Task 3394,Job 0,3,7,1,12,0,4,15,11,1,1,0,3394,3428,11
Task 3394,Job 1,8,8,1,8,0,9,16,7,1,1,1,3394,3428,2
Task 3395,Job 0,8,8,4,11,0,12,19,7,4,2,2,3395,3429,18
Task 3395,Job 1,13,6,3,7,0,16,20,4,3,3,1,3395,3429,2
Task 3396,Job 0,6,7,3,10,1,9,16,7,3,1,1,3396,3430,2
Task 3396,Job 1,11,10,1,8,0,12,19,7,1,2,0,3396,3430,4
Task 3397,Job 0,6,8,2,11,0,8,17,9,2,2,2,3397,3431,3
Task 3397,Job 1,11,7,3,10,0,14,21,7,3,2,0,3397,3431,12
Task 3398,Job 0,8,6,3,8,1,11,16,5,3,2,1,3398,3432,18
Task 3398,Job 1,13,8,3,7,0,16,20,4,3,4,0,3398,3432,10
Task 3399,Job 0,6,9,3,7,0,9,13,4,3,2,0,3399,3433,20
Task 3399,Job 1,11,10,2,11,0,13,22,9,2,2,1,3399,3433,17
Task 3400,Job 0,6,9,3,9,0,9,15,6,3,2,0,3400,3434,2
Task 3400,Job 1,11,8,1,6,0,12,17,5,1,3,1,3400,3434,14
Task 3401,Job 0,2,6,3,11,0,5,13,8,3,4,1,3401,3434,7
Task 3401,Job 1,7,7,2,8,0,9,15,6,2,3,2,3401,3434,15
Task 3402,Job 0,9,8,2,8,0,11,17,6,2,2,1,3402,3436,3
Task 3402,Job 1,14,9,4,9,0,18,23,5,4,1,0,3402,3436,13
Task 3403,Job 0,2,5,3,7,0,5,9,4,3,4,0,3403,3437,9
Task 3403,Job 1,7,7,4,6,0,11,13,2,4,1,2,3403,3437,6
Task 3404,Job 0,2,7,2,11,0,4,13,9,2,1,1,3404,3437,10
Task 3404,Job 1,7,9,1,12,0,8,19,11,1,4,2,3404,3437,14
Task 3405,Job 0,5,8,1,9,1,6,14,8,1,3,2,3405,3438,9
Task 3405,Job 1,10,10,2,6,0,12,16,4,2,1,1,3405,3438,20
Task 3406,Job 0,8,6,3,9,0,11,17,6,3,2,1,3406,3439,20
Task 3406,Job 1,13,6,4,11,1,17,24,7,4,3,1,3406,3439,14
Task 3407,Job 0,4,6,3,9,0,7,13,6,3,2,2,3407,3440,19
Task 3407,Job 1,9,5,4,12,0,13,21,8,4,2,2,3407,3440,5
Task 3408,Job 0,4,6,4,9,0,8,13,5,4,1,1,3408,3442,5
Task 3408,Job 1,9,6,3,9,1,12,18,6,3,4,1,3408,3442,5
Task 3409,Job 0,1,9,4,10,0,5,11,6,4,1,1,3409,3442,16
Task 3409,Job 1,6,8,4,11,0,10,17,7,4,3,2,3409,3442,11
Task 3410,Job 0,1,10,3,6,0,4,7,3,3,4,1,3410,3444,4
Task 3410,Job 1,6,7,2,11,0,8,17,9,2,1,2,3410,3444,4
Task 3411,Job 0,3,7,2,9,0,5,12,7,2,3,0,3411,3445,20
Task 3411,Job 1,8,10,2,6,0,10,14,4,2,3,1,3411,3445,15
Task 3412,Job 0,6,4,3,8,0,9,14,5,3,1,1,3412,3446,7
Task 3412,Job 1,11,9,2,6,0,13,17,4,2,2,2,3412,3446,17
Task 3413,Job 0,4,5,4,6,1,8,10,2,4,4,1,3413,3447,7
Task 3413,Job 1,9,10,4,8,1,13,17,4,4,1,2,3413,3447,13
Task 3414,Job 0,8,6,4,7,0,12,15,3,4,4,1,3414,3447,2
Task 3414,Job 1,13,5,2,10,0,15,23,8,2,2,2,3414,3447,19
Task 3415,Job 0,2,9,3,10,0,5,12,7,3,1,1,3415,3448,19
Task 3415,Job 1,7,5,3,10,0,10,17,7,3,1,0,3415,3448,6
Task 3416,Job 0,9,7,1,11,0,10,20,10,1,1,2,3416,3449,19
Task 3416,Job 1,14,8,3,9,0,17,23,6,3,4,0,3416,3449,17
Task 3417,Job 0,8,5,1,12,0,9,20,11,1,2,1,3417,3450,18
Task 3417,Job 1,13,5,1,8,0,14,21,7,1,4,1,3417,3450,11
Task 3418,Job 0,8,8,4,6,0,12,14,2,4,4,1,3418,3452,13
Task 3418,Job 1,13,8,3,10,0,16,23,7,3,2,0,3418,3452,12
Task 3419,Job 0,4,5,4,7,1,8,11,3,4,3,2,3419,3452,14
Task 3419,Job 1,9,6,3,10,0,12,19,7,3,4,2,3419,3452,13
Task 3420,Job 0,6,7,4,7,0,10,13,3,4,1,2,3420,3453,9
Task 3420,Job 1,11,4,4,11,0,15,22,7,4,4,1,3420,3453,2
Task 3421,Job 0,6,6,4,10,0,10,16,6,4,4,2,3421,3454,9
Task 3421,Job 1,11,5,3,10,0,14,21,7,3,4,1,3421,3454,17
Task 3422,Job 0,5,6,3,6,1,8,11,3,3,2,1,3422,3456,11
Task 3422,Job 1,10,10,1,9,0,11,19,8,1,4,0,3422,3456,8
Task 3423,Job 0,2,5,1,6,0,3,8,5,1,3,2,3423,3457,18
Task 3423,Job 1,7,6,2,7,0,9,14,5,2,3,1,3423,3457,16
Task 3424,Job 0,2,8,3,10,0,5,12,7,3,1,1,3424,3457,19
Task 3424,Job 1,7,8,4,10,0,11,17,6,4,3,0,3424,3457,19
Task 3425,Job 0,6,4,2,10,1,8,16,8,2,2,0,3425,3458,2
Task 3425,Job 1,11,4,2,6,1,13,17,4,2,2,1,3425,3458,16
Task 3426,Job 0,7,5,2,8,0,9,15,6,2,4,0,3426,3460,10
Task 3426,Job 1,12,4,4,12,1,16,24,8,4,1,2,3426,3460,15
Task 3427,Job 0,2,10,2,10,0,4,12,8,2,4,0,3427,3461,9
Task 3427,Job 1,7,7,4,7,0,11,14,3,4,1,2,3427,3461,6
Task 3428,Job 0,10,8,3,12,0,13,22,9,3,1,2,3428,3462,2
Task 3428,Job 1,15,7,4,10,1,19,25,6,4,2,0,3428,3462,16
Task 3429,Job 0,3,10,1,12,1,4,15,11,1,1,0,3429,3463,9
Task 3429,Job 1,8,5,2,10,0,10,18,8,2,4,2,3429,3463,17
Task 3430,Job 0,4,7,1,6,0,5,10,5,1,4,0,3430,3464,3
Task 3430,Job 1,9,9,4,9,1,13,18,5,4,2,0,3430,3464,6
Task 3431,Job 0,5,7,3,8,0,8,13,5,3,4,2,3431,3464,5
Task 3431,Job 1,10,8,3,7,0,13,17,4,3,3,1,3431,3464,12
Task 3432,Job 0,8,10,2,12,0,10,20,10,2,3,2,3432,3465,13
Task 3432,Job 1,13,6,2,8,0,15,21,6,2,2,0,3432,3465,14
Task 3433,Job 0,10,7,3,10,1,13,20,7,3,2,1,3433,3467,14
Task 3433,Job 1,15,5,2,11,0,17,26,9,2,2,2,3433,3467,3
Task 3434,Job 0,4,8,4,8,0,8,12,4,4,3,1,3434,3468,14
Task 3434,Job 1,9,4,3,12,0,12,21,9,3,4,2,3434,3468,8
Task 3435,Job 0,1,7,4,9,0,5,10,5,4,4,1,3435,3468,2
Task 3435,Job 1,6,5,2,10,0,8,16,8,2,3,1,3435,3468,18
Task 3436,Job 0,4,4,3,12,0,7,16,9,3,3,0,3436,3470,3
Task 3436,Job 1,9,5,1,9,0,10,18,8,1,4,2,3436,3470,20
Task 3437,Job 0,8,7,1,9,1,9,17,8,1,1,0,3437,3470,19
Task 3437,Job 1,13,5,1,6,0,14,19,5,1,3,2,3437,3470,7
Task 3438,Job 0,1,10,4,8,0,5,9,4,4,2,1,3438,3472,15
Task 3438,Job 1,6,6,2,10,1,8,16,8,2,2,1,3438,3472,5
Task 3439,Job 0,7,10,3,11,0,10,18,8,3,4,2,3439,3473,18
Task 3439,Job 1,12,4,4,8,0,16,20,4,4,3,2,3439,3473,7
Task 3440,Job 0,4,4,3,12,0,7,16,9,3,2,2,3440,3474,8
Task 3440,Job 1,9,9,1,7,1,10,16,6,1,4,2,3440,3474,10
Task 3441,Job 0,6,6,4,6,0,10,12,2,4,2,0,3441,3474,19
Task 3441,Job 1,11,10,2,8,0,13,19,6,2,1,0,3441,3474,8
Task 3442,Job 0,9,9,2,11,0,11,20,9,2,1,2,3442,3476,20
Task 3442,Job 1,14,10,1,7,1,15,21,6,1,2,0,3442,3476,9
Task 3443,Job 0,5,9,3,6,0,8,11,3,3,2,2,3443,3476,3
Task 3443,Job 1,10,5,3,9,0,13,19,6,3,1,0,3443,3476,12
Task 3444,Job 0,1,6,3,7,1,4,8,4,3,1,0,3444,3478,18
Task 3444,Job 1,6,9,3,6,0,9,12,3,3,2,1,3444,3478,13
Task 3445,Job 0,3,9,3,11,0,6,14,8,3,4,0,3445,3479,15
Task 3445,Job 1,8,10,1,9,1,9,17,8,1,4,0,3445,3479,14
Task 3446,Job 0,2,10,2,11,1,4,13,9,2,2,0,3446,3479,18
Task 3446,Job 1,7,6,2,8,0,9,15,6,2,2,0,3446,3479,6
Task 3447,Job 0,8,8,2,6,1,10,14,4,2,3,1,3447,3480,15
Task 3447,Job 1,13,9,1,6,0,14,19,5,1,1,1,3447,3480,16
Task 3448,Job 0,4,4,2,6,0,6,10,4,2,2,1,3448,3482,6
Task 3448,Job 1,9,8,3,6,0,12,15,3,3,3,2,3448,3482,4
Task 3449,Job 0,4,9,1,6,0,5,10,5,1,3,1,3449,3483,7
Task 3449,Job 1,9,10,2,7,1,11,16,5,2,4,2,3449,3483,16
Task 3450,Job 0,2,7,2,8,0,4,10,6,2,1,1,3450,3484,10
Task 3450,Job 1,7,4,1,10,0,8,17,9,1,4,0,3450,3484,17
Task 3451,Job 0,7,5,1,7,1,8,14,6,1,4,2,3451,3484,12
Task 3451,Job 1,12,8,1,10,0,13,22,9,1,2,1,3451,3484,2
Task 3452,Job 0,10,7,3,11,0,13,21,8,3,4,0,3452,3486,17
Task 3452,Job 1,15,4,3,12,1,18,27,9,3,2,2,3452,3486,16
Task 3453,Job 0,7,6,2,6,1,9,13,4,2,2,2,3453,3487,8
Task 3453,Job 1,12,6,3,7,0,15,19,4,3,4,0,3453,3487,10
Task 3454,Job 0,7,9,4,7,1,11,14,3,4,1,2,3454,3488,3
Task 3454,Job 1,12,4,1,6,0,13,18,5,1,4,0,3454,3488,15
Task 3455,Job 0,10,9,4,8,1,14,18,4,4,3,2,3455,3488,6
Task 3455,Job 1,15,8,4,10,0,19,25,6,4,2,1,3455,3488,8
Task 3456,Job 0,6,9,4,9,1,10,15,5,4,1,1,3456,3489,2
Task 3456,Job 1,11,4,4,9,0,15,20,5,4,4,1,3456,3489,18
Task 3457,Job 0,10,7,2,8,0,12,18,6,2,2,2,3457,3490,6
Task 3457,Job 1,15,5,2,7,0,17,22,5,2,3,0,3457,3490,8
Task 3458,Job 0,8,10,1,10,0,9,18,9,1,2,0,3458,3491,6
Task 3458,Job 1,13,10,3,7,1,16,20,4,3,4,2,3458,3491,8
Task 3459,Job 0,5,6,2,9,0,7,14,7,2,1,2,3459,3492,3
Task 3459,Job 1,10,9,2,12,1,12,22,10,2,3,0,3459,3492,19
Task 3460,Job 0,10,5,1,6,1,11,16,5,1,4,2,3460,3493,14
Task 3460,Job 1,15,7,4,12,1,19,27,8,4,4,2,3460,3493,4
Task 3461,Job 0,2,9,1,11,0,3,13,10,1,3,1,3461,3494,6
Task 3461,Job 1,7,4,2,11,1,9,18,9,2,2,1,3461,3494,13
Task 3462,Job 0,5,8,1,9,1,6,14,8,1,4,1,3462,3496,10
Task 3462,Job 1,10,7,1,12,0,11,22,11,1,3,0,3462,3496,17
Task 3463,Job 0,8,7,1,11,1,9,19,10,1,4,0,3463,3496,2
Task 3463,Job 1,13,9,3,12,1,16,25,9,3,1,0,3463,3496,17
Task 3464,Job 0,9,6,3,6,0,12,15,3,3,4,0,3464,3497,16
Task 3464,Job 1,14,4,2,9,0,16,23,7,2,4,0,3464,3497,5
Task 3465,Job 0,7,6,2,9,0,9,16,7,2,3,1,3465,3499,6
Task 3465,Job 1,12,10,3,6,0,15,18,3,3,2,0,3465,3499,18
Task 3466,Job 0,2,4,4,7,1,6,9,3,4,2,1,3466,3499,6
Task 3466,Job 1,7,10,3,12,0,10,19,9,3,2,2,3466,3499,6
Task 3467,Job 0,2,6,1,11,0,3,13,10,1,1,1,3467,3500,17
Task 3467,Job 1,7,4,4,6,0,11,13,2,4,1,1,3467,3500,2
Task 3468,Job 0,6,6,2,12,0,8,18,10,2,3,2,3468,3502,8
Task 3468,Job 1,11,10,4,9,0,15,20,5,4,3,2,3468,3502,12
Task 3469,Job 0,5,9,3,6,1,8,11,3,3,3,1,3469,3503,20
Task 3469,Job 1,10,10,3,11,0,13,21,8,3,4,1,3469,3503,9
Task 3470,Job 0,8,7,4,11,0,12,19,7,4,2,1,3470,3503,6
Task 3470,Job 1,13,9,4,10,0,17,23,6,4,3,2,3470,3503,7
Task 3471,Job 0,10,8,2,7,0,12,17,5,2,1,0,3471,3505,2
Task 3471,Job 1,15,4,3,10,0,18,25,7,3,2,2,3471,3505,6
Task 3472,Job 0,8,10,3,6,0,11,14,3,3,1,2,3472,3506,16
Task 3472,Job 1,13,10,3,10,1,16,23,7,3,1,1,3472,3506,19
Task 3473,Job 0,10,6,2,6,0,12,16,4,2,1,2,3473,3506,11
Task 3473,Job 1,15,4,2,11,0,17,26,9,2,2,2,3473,3506,13
Task 3474,Job 0,1,7,2,12,1,3,13,10,2,1,1,3474,3507,2
Task 3474,Job 1,6,5,2,7,1,8,13,5,2,2,0,3474,3507,7
Task 3475,Job 0,10,10,2,11,0,12,21,9,2,1,0,3475,3509,8
Task 3475,Job 1,15,5,1,11,1,16,26,10,1,4,2,3475,3509,15
Task 3476,Job 0,4,9,3,6,1,7,10,3,3,4,2,3476,3509,17
Task 3476,Job 1,9,4,2,8,0,11,17,6,2,3,0,3476,3509,3
Task 3477,Job 0,6,4,2,10,0,8,16,8,2,3,0,3477,3511,17
Task 3477,Job 1,11,6,3,9,0,14,20,6,3,3,0,3477,3511,6
Task 3478,Job 0,10,9,3,9,1,13,19,6,3,4,1,3478,3512,6
Task 3478,Job 1,15,10,4,6,0,19,21,2,4,3,1,3478,3512,12
Task 3479,Job 0,9,9,1,7,1,10,16,6,1,3,2,3479,3512,4
Task 3479,Job 1,14,4,3,9,0,17,23,6,3,2,1,3479,3512,18
Task 3480,Job 0,6,8,3,9,0,9,15,6,3,3,1,3480,3513,7
Task 3480,Job 1,11,9,2,6,1,13,17,4,2,2,1,3480,3513,16
Task 3481,Job 0,5,6,1,8,1,6,13,7,1,3,2,3481,3514,18
Task 3481,Job 1,10,6,2,8,0,12,18,6,2,4,1,3481,3514,5
Task 3482,Job 0,5,7,3,10,1,8,15,7,3,3,2,3482,3515,16
Task 3482,Job 1,10,8,4,10,0,14,20,6,4,3,0,3482,3515,3
Task 3483,Job 0,3,10,1,8,0,4,11,7,1,3,0,3483,3517,10
Task 3483,Job 1,8,4,4,10,0,12,18,6,4,2,1,3483,3517,2
Task 3484,Job 0,1,9,3,8,0,4,9,5,3,1,2,3484,3517,11
Task 3484,Job 1,6,7,3,7,0,9,13,4,3,4,0,3484,3517,10
Task 3485,Job 0,1,5,2,9,0,3,10,7,2,3,0,3485,3519,18
Task 3485,Job 1,6,7,4,12,0,10,18,8,4,2,0,3485,3519,13
Task 3486,Job 0,5,9,3,8,0,8,13,5,3,4,0,3486,3520,19
Task 3486,Job 1,10,8,3,11,0,13,21,8,3,4,0,3486,3520,15
Task 3487,Job 0,2,9,4,7,0,6,9,3,4,3,1,3487,3520,6
Task 3487,Job 1,7,10,1,10,1,8,17,9,1,4,2,3487,3520,14
Task 3488,Job 0,3,10,1,12,0,4,15,11,1,3,2,3488,3522,5
Task 3488,Job 1,8,10,1,6,0,9,14,5,1,1,2,3488,3522,18
Task 3489,Job 0,8,10,1,10,0,9,18,9,1,1,0,3489,3523,14
Task 3489,Job 1,13,9,2,10,0,15,23,8,2,2,1,3489,3523,8
Task 3490,Job 0,9,9,4,8,1,13,17,4,4,1,0,3490,3524,18
Task 3490,Job 1,14,6,3,7,0,17,21,4,3,1,1,3490,3524,15
Task 3491,Job 0,7,9,2,9,0,9,16,7,2,2,1,3491,3524,3
Task 3491,Job 1,12,7,4,9,0,16,21,5,4,2,1,3491,3524,11
Task 3492,Job 0,3,8,1,7,1,4,10,6,1,1,2,3492,3526,13
Task 3492,Job 1,8,5,1,11,0,9,19,10,1,2,2,3492,3526,7
Task 3493,Job 0,4,8,1,6,0,5,10,5,1,2,1,3493,3527,3
Task 3493,Job 1,9,8,2,7,1,11,16,5,2,4,0,3493,3527,11
Task 3494,Job 0,3,9,1,12,1,4,15,11,1,4,2,3494,3527,7
Task 3494,Job 1,8,7,3,11,0,11,19,8,3,2,0,3494,3527,7
Task 3495,Job 0,1,8,1,6,0,2,7,5,1,2,1,3495,3528,19
Task 3495,Job 1,6,9,2,6,0,8,12,4,2,3,2,3495,3528,4
Task 3496,Job 0,6,7,3,6,0,9,12,3,3,2,1,3496,3529,3
Task 3496,Job 1,11,4,1,8,0,12,19,7,1,4,2,3496,3529,20
Task 3497,Job 0,2,10,1,10,0,3,12,9,1,1,0,3497,3530,14
Task 3497,Job 1,7,5,4,8,1,11,15,4,4,1,2,3497,3530,15
Task 3498,Job 0,6,10,1,7,1,7,13,6,1,3,1,3498,3531,18
Task 3498,Job 1,11,6,1,6,0,12,17,5,1,4,2,3498,3531,16
Task 3499,Job 0,1,4,3,6,0,4,7,3,3,4,0,3499,3532,4
Task 3499,Job 1,6,10,4,8,0,10,14,4,4,1,1,3499,3532,6
Task 3500,Job 0,9,5,4,9,1,13,18,5,4,1,2,3500,3533,9
Task 3500,Job 1,14,7,2,9,1,16,23,7,2,2,1,3500,3533,16
Task 3501,Job 0,3,4,4,7,0,7,10,3,4,2,0,3501,3534,6
Task 3501,Job 1,8,5,4,12,0,12,20,8,4,3,2,3501,3534,14
Task 3502,Job 0,6,4,3,10,0,9,16,7,3,1,0,3502,3535,4
Task 3502,Job 1,11,7,1,8,0,12,19,7,1,2,0,3502,3535,9
Task 3503,Job 0,2,5,3,10,0,5,12,7,3,4,2,3503,3537,15
Task 3503,Job 1,7,5,4,7,0,11,14,3,4,4,1,3503,3537,12
Task 3504,Job 0,10,9,4,6,1,14,16,2,4,3,2,3504,3538,2
Task 3504,Job 1,15,10,4,6,0,19,21,2,4,4,2,3504,3538,18
Task 3505,Job 0,2,5,2,8,0,4,10,6,2,1,0,3505,3538,6
Task 3505,Job 1,7,5,1,10,0,8,17,9,1,1,0,3505,3538,18
Task 3506,Job 0,3,5,4,7,1,7,10,3,4,3,2,3506,3540,8
Task 3506,Job 1,8,7,1,12,0,9,20,11,1,2,0,3506,3540,13
Task 3507,Job 0,2,6,1,8,0,3,10,7,1,2,1,3507,3541,2
Task 3507,Job 1,7,4,1,7,1,8,14,6,1,4,1,3507,3541,11
Task 3508,Job 0,9,5,1,8,0,10,17,7,1,3,0,3508,3542,4
Task 3508,Job 1,14,10,1,12,0,15,26,11,1,3,0,3508,3542,3
Task 3509,Job 0,10,4,4,8,0,14,18,4,4,3,0,3509,3543,8
Task 3509,Job 1,15,9,1,10,0,16,25,9,1,1,1,3509,3543,18
Task 3510,Job 0,8,8,4,6,0,12,14,2,4,3,2,3510,3543,11
Task 3510,Job 1,13,5,1,10,0,14,23,9,1,4,1,3510,3543,4
Task 3511,Job 0,2,7,2,8,1,4,10,6,2,1,0,3511,3545,17
Task 3511,Job 1,7,9,2,9,0,9,16,7,2,1,2,3511,3545,10
Task 3512,Job 0,1,4,3,12,0,4,13,9,3,1,0,3512,3545,15
Task 3512,Job 1,6,5,3,11,1,9,17,8,3,1,2,3512,3545,2
Task 3513,Job 0,3,5,4,10,0,7,13,6,4,4,0,3513,3547,14
Task 3513,Job 1,8,8,3,8,0,11,16,5,3,2,2,3513,3547,9
Task 3514,Job 0,4,8,3,10,0,7,14,7,3,4,2,3514,3548,11
Task 3514,Job 1,9,7,4,8,0,13,17,4,4,3,0,3514,3548,15
Task 3515,Job 0,9,10,3,8,0,12,17,5,3,3,1,3515,3549,18
Task 3515,Job 1,14,8,3,7,0,17,21,4,3,2,1,3515,3549,9
Task 3516,Job 0,9,5,1,9,0,10,18,8,1,4,2,3516,3550,6
Task 3516,Job 1,14,10,3,10,0,17,24,7,3,4,0,3516,3550,6
Task 3517,Job 0,7,4,1,10,0,8,17,9,1,4,0,3517,3551,8
Task 3517,Job 1,12,9,2,10,0,14,22,8,2,4,0,3517,3551,2
Task 3518,Job 0,6,10,4,8,0,10,14,4,4,3,0,3518,3552,16
Task 3518,Job 1,11,5,4,8,0,15,19,4,4,4,1,3518,3552,6
Task 3519,Job 0,8,5,3,7,0,11,15,4,3,4,2,3519,3553,11
Task 3519,Job 1,13,6,3,11,0,16,24,8,3,1,1,3519,3553,10
Task 3520,Job 0,10,8,4,11,0,14,21,7,4,3,2,3520,3553,14
Task 3520,Job 1,15,10,3,9,0,18,24,6,3,1,2,3520,3553,3
Task 3521,Job 0,4,10,4,12,0,8,16,8,4,2,0,3521,3554,11
Task 3521,Job 1,9,4,2,12,0,11,21,10,2,3,1,3521,3554,5
Task 3522,Job 0,8,9,4,9,0,12,17,5,4,4,1,3522,3556,16
Task 3522,Job 1,13,5,1,6,0,14,19,5,1,4,2,3522,3556,15
Task 3523,Job 0,6,6,1,9,0,7,15,8,1,1,2,3523,3557,4
Task 3523,Job 1,11,4,4,9,0,15,20,5,4,1,1,3523,3557,15
Task 3524,Job 0,5,6,3,10,0,8,15,7,3,4,1,3524,3558,8
Task 3524,Job 1,10,10,1,9,0,11,19,8,1,3,1,3524,3558,17
Task 3525,Job 0,6,5,2,12,0,8,18,10,2,1,2,3525,3559,17
Task 3525,Job 1,11,6,2,7,0,13,18,5,2,2,1,3525,3559,15
Task 3526,Job 0,4,6,4,9,0,8,13,5,4,1,2,3526,3559,7
Task 3526,Job 1,9,6,3,7,0,12,16,4,3,2,0,3526,3559,15
Task 3527,Job 0,10,10,2,9,1,12,19,7,2,3,1,3527,3561,13
Task 3527,Job 1,15,9,1,10,1,16,25,9,1,2,0,3527,3561,16
Task 3528,Job 0,8,6,4,10,0,12,18,6,4,1,0,3528,3562,8
Task 3528,Job 1,13,4,4,10,0,17,23,6,4,4,2,3528,3562,7
Task 3529,Job 0,1,5,2,12,0,3,13,10,2,4,0,3529,3563,9
Task 3529,Job 1,6,9,2,6,0,8,12,4,2,4,1,3529,3563,12
Task 3530,Job 0,4,9,3,7,1,7,11,4,3,2,1,3530,3563,3
Task 3530,Job 1,9,8,3,12,0,12,21,9,3,3,0,3530,3563,13
Task 3531,Job 0,1,8,3,11,1,4,12,8,3,2,2,3531,3565,20
Task 3531,Job 1,6,9,3,12,0,9,18,9,3,4,1,3531,3565,8
Task 3532,Job 0,1,10,3,8,0,4,9,5,3,4,0,3532,3566,5
Task 3532,Job 1,6,7,2,6,1,8,12,4,2,4,2,3532,3566,19
Task 3533,Job 0,6,7,4,8,0,10,14,4,4,3,2,3533,3566,14
Task 3533,Job 1,11,10,3,9,0,14,20,6,3,4,1,3533,3566,7
Task 3534,Job 0,2,6,2,9,0,4,11,7,2,3,2,3534,3567,17
Task 3534,Job 1,7,9,2,6,0,9,13,4,2,3,0,3534,3567,14
Task 3535,Job 0,5,5,3,11,0,8,16,8,3,3,1,3535,3568,2
Task 3535,Job 1,10,9,1,7,0,11,17,6,1,2,1,3535,3568,8
Task 3536,Job 0,10,6,4,6,0,14,16,2,4,1,2,3536,3569,17
Task 3536,Job 1,15,10,2,12,1,17,27,10,2,2,2,3536,3569,5
Task 3537,Job 0,3,4,1,8,0,4,11,7,1,4,0,3537,3571,16
Task 3537,Job 1,8,10,1,10,0,9,18,9,1,4,1,3537,3571,20
Task 3538,Job 0,3,5,3,8,0,6,11,5,3,4,0,3538,3571,5
Task 3538,Job 1,8,8,1,12,0,9,20,11,1,4,0,3538,3571,13
Task 3539,Job 0,9,6,1,10,0,10,19,9,1,1,2,3539,3572,5
Task 3539,Job 1,14,7,3,7,0,17,21,4,3,3,0,3539,3572,11
Task 3540,Job 0,9,8,3,9,0,12,18,6,3,1,2,3540,3573,4
Task 3540,Job 1,14,5,4,6,0,18,20,2,4,4,1,3540,3573,12
Task 3541,Job 0,3,7,1,7,1,4,10,6,1,2,0,3541,3575,11
Task 3541,Job 1,8,6,2,6,0,10,14,4,2,4,0,3541,3575,19
Task 3542,Job 0,3,10,4,10,0,7,13,6,4,3,0,3542,3576,20
Task 3542,Job 1,8,7,1,8,0,9,16,7,1,4,1,3542,3576,17
Task 3543,Job 0,10,4,2,8,1,12,18,6,2,4,2,3543,3577,14
Task 3543,Job 1,15,9,3,7,0,18,22,4,3,2,0,3543,3577,2
Task 3544,Job 0,1,6,2,9,1,3,10,7,2,3,0,3544,3578,15
Task 3544,Job 1,6,5,1,7,0,7,13,6,1,3,2,3544,3578,14
Task 3545,Job 0,9,6,3,6,0,12,15,3,3,1,1,3545,3578,19
Task 3545,Job 1,14,8,4,9,0,18,23,5,4,3,0,3545,3578,6
Task 3546,Job 0,1,5,2,11,0,3,12,9,2,2,1,3546,3579,16
Task 3546,Job 1,6,5,3,10,0,9,16,7,3,4,0,3546,3579,14
Task 3547,Job 0,1,9,1,8,0,2,9,7,1,2,1,3547,3580,17
Task 3547,Job 1,6,8,2,11,0,8,17,9,2,2,1,3547,3580,16
Task 3548,Job 0,8,5,3,6,0,11,14,3,3,2,2,3548,3582,16
Task 3548,Job 1,13,10,2,9,1,15,22,7,2,2,2,3548,3582,8
Task 3549,Job 0,7,7,4,6,0,11,13,2,4,1,1,3549,3583,20
Task 3549,Job 1,12,8,4,7,1,16,19,3,4,3,1,3549,3583,16
Task 3550,Job 0,1,10,1,10,0,2,11,9,1,1,2,3550,3583,8
Task 3550,Job 1,6,5,2,8,0,8,14,6,2,3,2,3550,3583,16
Task 3551,Job 0,6,9,3,9,1,9,15,6,3,4,0,3551,3585,16
Task 3551,Job 1,11,6,4,7,1,15,18,3,4,1,0,3551,3585,14
Task 3552,Job 0,9,8,2,6,1,11,15,4,2,3,1,3552,3586,2
Task 3552,Job 1,14,6,3,8,0,17,22,5,3,3,2,3552,3586,3
Task 3553,Job 0,10,4,1,6,0,11,16,5,1,1,2,3553,3586,5
Task 3553,Job 1,15,10,1,8,0,16,23,7,1,3,0,3553,3586,20
Task 3554,Job 0,6,5,3,11,0,9,17,8,3,1,1,3554,3587,19
Task 3554,Job 1,11,8,2,10,1,13,21,8,2,3,1,3554,3587,17
Task 3555,Job 0,4,8,1,8,0,5,12,7,1,4,2,3555,3588,2
Task 3555,Job 1,9,9,2,10,0,11,19,8,2,4,2,3555,3588,8
Task 3556,Job 0,4,10,2,8,0,6,12,6,2,2,2,3556,3590,11
Task 3556,Job 1,9,7,2,11,1,11,20,9,2,1,2,3556,3590,7
Task 3557,Job 0,4,5,2,12,1,6,16,10,2,2,0,3557,3590,9
Task 3557,Job 1,9,7,1,9,0,10,18,8,1,2,0,3557,3590,12
Task 3558,Job 0,3,6,1,12,0,4,15,11,1,4,2,3558,3592,3
Task 3558,Job 1,8,7,1,6,0,9,14,5,1,1,0,3558,3592,17
Task 3559,Job 0,7,8,3,12,0,10,19,9,3,1,1,3559,3592,15
Task 3559,Job 1,12,8,3,10,0,15,22,7,3,3,2,3559,3592,10
Task 3560,Job 0,2,8,4,11,0,6,13,7,4,3,1,3560,3594,13
Task 3560,Job 1,7,8,2,12,0,9,19,10,2,2,2,3560,3594,17
Task 3561,Job 0,3,9,2,7,1,5,10,5,2,2,0,3561,3595,7
Task 3561,Job 1,8,6,1,7,0,9,15,6,1,4,1,3561,3595,18
Task 3562,Job 0,5,9,4,6,0,9,11,2,4,1,0,3562,3596,12
Task 3562,Job 1,10,6,3,10,0,13,20,7,3,2,2,3562,3596,4
Task 3563,Job 0,7,8,2,7,0,9,14,5,2,1,0,3563,3596,2
Task 3563,Job 1,12,10,4,12,0,16,24,8,4,2,0,3563,3596,8
Task 3564,Job 0,1,10,4,6,1,5,7,2,4,1,2,3564,3597,14
Task 3564,Job 1,6,7,2,8,0,8,14,6,2,4,0,3564,3597,10
Task 3565,Job 0,1,8,2,6,0,3,7,4,2,1,0,3565,3599,17
Task 3565,Job 1,6,7,1,8,0,7,14,7,1,2,1,3565,3599,11
Task 3566,Job 0,8,7,3,12,1,11,20,9,3,2,2,3566,3600,19
Task 3566,Job 1,13,4,4,9,0,17,22,5,4,4,1,3566,3600,8
Task 3567,Job 0,6,9,4,10,1,10,16,6,4,3,0,3567,3600,3
Task 3567,Job 1,11,8,2,7,0,13,18,5,2,3,2,3567,3600,14
Task 3568,Job 0,2,7,4,9,0,6,11,5,4,2,1,3568,3601,17
Task 3568,Job 1,7,8,1,7,0,8,14,6,1,1,0,3568,3601,15
Task 3569,Job 0,5,4,4,12,0,9,17,8,4,3,2,3569,3603,6
Task 3569,Job 1,10,7,1,9,0,11,19,8,1,4,1,3569,3603,12
Task 3570,Job 0,7,6,2,6,1,9,13,4,2,3,0,3570,3604,8
Task 3570,Job 1,12,5,3,7,0,15,19,4,3,2,1,3570,3604,4
Task 3571,Job 0,9,4,3,12,1,12,21,9,3,1,2,3571,3604,8
Task 3571,Job 1,14,9,4,7,0,18,21,3,4,1,0,3571,3604,11
Task 3572,Job 0,8,9,3,10,0,11,18,7,3,4,1,3572,3606,5
Task 3572,Job 1,13,4,3,7,1,16,20,4,3,4,1,3572,3606,8
Task 3573,Job 0,10,4,1,8,0,11,18,7,1,4,2,3573,3606,14
Task 3573,Job 1,15,9,1,7,0,16,22,6,1,4,0,3573,3606,20
Task 3574,Job 0,1,4,2,7,0,3,8,5,2,2,2,3574,3608,19
Task 3574,Job 1,6,7,2,9,0,8,15,7,2,2,1,3574,3608,9
Task 3575,Job 0,8,10,3,11,1,11,19,8,3,3,2,3575,3608,3
Task 3575,Job 1,13,4,3,10,0,16,23,7,3,1,2,3575,3608,13
Task 3576,Job 0,1,5,4,12,0,5,13,8,4,4,1,3576,3609,15
Task 3576,Job 1,6,7,3,10,0,9,16,7,3,2,0,3576,3609,15
Task 3577,Job 0,5,4,3,8,0,8,13,5,3,3,0,3577,3611,19
Task 3577,Job 1,10,7,4,12,0,14,22,8,4,3,0,3577,3611,18
Task 3578,Job 0,9,10,1,6,0,10,15,5,1,3,0,3578,3612,11
Task 3578,Job 1,14,6,1,8,0,15,22,7,1,1,0,3578,3612,18
Task 3579,Job 0,3,4,3,11,0,6,14,8,3,4,0,3579,3613,10
Task 3579,Job 1,8,8,4,6,0,12,14,2,4,1,0,3579,3613,17
Task 3580,Job 0,8,6,3,9,0,11,17,6,3,2,1,3580,3613,13
Task 3580,Job 1,13,10,3,11,0,16,24,8,3,3,1,3580,3613,17
Task 3581,Job 0,4,9,2,9,1,6,13,7,2,1,2,3581,3614,4
Task 3581,Job 1,9,9,1,12,0,10,21,11,1,2,2,3581,3614,6
Task 3582,Job 0,5,9,4,8,0,9,13,4,4,4,1,3582,3616,6
Task 3582,Job 1,10,7,2,11,0,12,21,9,2,1,1,3582,3616,16
Task 3583,Job 0,3,4,3,12,1,6,15,9,3,2,2,3583,3617,17
Task 3583,Job 1,8,4,2,11,0,10,19,9,2,3,1,3583,3617,2
Task 3584,Job 0,3,6,4,9,0,7,12,5,4,3,2,3584,3618,3
Task 3584,Job 1,8,9,4,6,1,12,14,2,4,1,0,3584,3618,11
Task 3585,Job 0,5,8,1,11,1,6,16,10,1,3,2,3585,3619,2
Task 3585,Job 1,10,6,2,11,0,12,21,9,2,1,2,3585,3619,15
Task 3586,Job 0,9,5,4,11,0,13,20,7,4,1,1,3586,3620,7
Task 3586,Job 1,14,4,4,11,0,18,25,7,4,1,2,3586,3620,12
Task 3587,Job 0,9,7,4,10,0,13,19,6,4,1,2,3587,3621,18
Task 3587,Job 1,14,8,1,7,0,15,21,6,1,1,0,3587,3621,7
Task 3588,Job 0,1,8,3,8,0,4,9,5,3,3,1,3588,3621,7
Task 3588,Job 1,6,9,4,6,1,10,12,2,4,3,1,3588,3621,15
Task 3589,Job 0,4,4,2,7,0,6,11,5,2,4,1,3589,3622,11
Task 3589,Job 1,9,8,1,9,0,10,18,8,1,4,0,3589,3622,18
Task 3590,Job 0,8,10,1,11,0,9,19,10,1,1,1,3590,3623,12
Task 3590,Job 1,13,9,4,10,0,17,23,6,4,3,0,3590,3623,14
Task 3591,Job 0,6,10,2,9,0,8,15,7,2,4,0,3591,3625,9
Task 3591,Job 1,11,6,2,6,1,13,17,4,2,2,0,3591,3625,3
Task 3592,Job 0,3,10,1,10,0,4,13,9,1,2,2,3592,3626,14
Task 3592,Job 1,8,6,4,6,0,12,14,2,4,1,1,3592,3626,11
Task 3593,Job 0,1,9,1,8,0,2,9,7,1,3,0,3593,3626,13
Task 3593,Job 1,6,4,4,6,1,10,12,2,4,4,0,3593,3626,10
Task 3594,Job 0,7,6,1,6,0,8,13,5,1,4,1,3594,3628,12
Task 3594,Job 1,12,8,1,6,0,13,18,5,1,4,1,3594,3628,18
Task 3595,Job 0,8,4,2,12,0,10,20,10,2,4,0,3595,3628,12
Task 3595,Job 1,13,7,3,12,0,16,25,9,3,4,1,3595,3628,10
Task 3596,Job 0,5,9,2,9,0,7,14,7,2,3,1,3596,3629,5
Task 3596,Job 1,10,5,1,11,0,11,21,10,1,4,1,3596,3629,11
Task 3597,Job 0,4,5,2,9,1,6,13,7,2,2,0,3597,3630,17
Task 3597,Job 1,9,8,1,10,0,10,19,9,1,3,2,3597,3630,4
Task 3598,Job 0,9,10,4,9,0,13,18,5,4,3,0,3598,3632,4
Task 3598,Job 1,14,9,4,9,0,18,23,5,4,3,2,3598,3632,10
Task 3599,Job 0,10,5,1,8,1,11,18,7,1,2,2,3599,3633,2
Task 3599,Job 1,15,4,4,8,1,19,23,4,4,1,2,3599,3633,11
Task 3600,Job 0,2,9,1,9,0,3,11,8,1,1,0,3600,3633,2
Task 3600,Job 1,7,10,3,9,0,10,16,6,3,2,0,3600,3633,8
Task 3601,Job 0,5,5,1,7,0,6,12,6,1,4,2,3601,3634,7
Task 3601,Job 1,10,7,2,10,0,12,20,8,2,1,0,3601,3634,5
Task 3602,Job 0,1,9,4,11,1,5,12,7,4,1,2,3602,3635,12
Task 3602,Job 1,6,9,3,7,0,9,13,4,3,1,1,3602,3635,3
Task 3603,Job 0,5,4,2,9,0,7,14,7,2,2,2,3603,3636,15
Task 3603,Job 1,10,6,3,7,0,13,17,4,3,1,2,3603,3636,6
Task 3604,Job 0,3,7,1,8,1,4,11,7,1,4,1,3604,3637,4
Task 3604,Job 1,8,8,2,11,0,10,19,9,2,4,2,3604,3637,2
Task 3605,Job 0,10,5,2,10,0,12,20,8,2,2,0,3605,3638,14
Task 3605,Job 1,15,9,4,12,0,19,27,8,4,1,2,3605,3638,17
Task 3606,Job 0,9,9,1,9,0,10,18,8,1,4,0,3606,3640,14
Task 3606,Job 1,14,10,2,7,1,16,21,5,2,4,0,3606,3640,5
Task 3607,Job 0,1,5,2,12,1,3,13,10,2,3,2,3607,3641,14
Task 3607,Job 1,6,7,2,12,0,8,18,10,2,3,2,3607,3641,5
Task 3608,Job 0,1,6,3,7,1,4,8,4,3,3,2,3608,3642,17
Task 3608,Job 1,6,4,2,7,0,8,13,5,2,3,2,3608,3642,19
Task 3609,Job 0,1,10,2,9,0,3,10,7,2,3,0,3609,3643,13
Task 3609,Job 1,6,5,4,11,0,10,17,7,4,1,0,3609,3643,4
Task 3610,Job 0,8,4,3,12,0,11,20,9,3,4,2,3610,3644,11
Task 3610,Job 1,13,10,1,9,0,14,22,8,1,4,0,3610,3644,18
Task 3611,Job 0,1,6,2,10,0,3,11,8,2,1,0,3611,3645,4
Task 3611,Job 1,6,4,2,6,0,8,12,4,2,2,1,3611,3645,15
Task 3612,Job 0,10,8,1,8,0,11,18,7,1,1,2,3612,3645,8
Task 3612,Job 1,15,4,4,7,0,19,22,3,4,4,1,3612,3645,20
Task 3613,Job 0,1,4,3,12,0,4,13,9,3,4,1,3613,3647,18
Task 3613,Job 1,6,4,2,8,0,8,14,6,2,1,2,3613,3647,6
Task 3614,Job 0,5,5,4,8,0,9,13,4,4,4,1,3614,3647,13
Task 3614,Job 1,10,6,3,10,1,13,20,7,3,2,1,3614,3647,14
Task 3615,Job 0,8,7,2,9,0,10,17,7,2,1,1,3615,3649,17
Task 3615,Job 1,13,9,1,12,1,14,25,11,1,4,2,3615,3649,15
Task 3616,Job 0,9,8,4,8,1,13,17,4,4,4,1,3616,3649,3
Task 3616,Job 1,14,6,1,7,0,15,21,6,1,1,1,3616,3649,6
Task 3617,Job 0,4,7,2,10,0,6,14,8,2,3,0,3617,3650,2
Task 3617,Job 1,9,4,3,11,0,12,20,8,3,1,1,3617,3650,17
Task 3618,Job 0,6,6,2,11,0,8,17,9,2,2,1,3618,3652,11
Task 3618,Job 1,11,5,1,11,0,12,22,10,1,3,1,3618,3652,14
Task 3619,Job 0,6,9,2,11,0,8,17,9,2,1,0,3619,3653,15
Task 3619,Job 1,11,6,3,7,1,14,18,4,3,4,0,3619,3653,9
Task 3620,Job 0,9,6,4,11,0,13,20,7,4,2,2,3620,3653,5
Task 3620,Job 1,14,10,2,6,1,16,20,4,2,2,1,3620,3653,14
Task 3621,Job 0,9,8,4,6,0,13,15,2,4,4,0,3621,3654,9
Task 3621,Job 1,14,10,2,9,0,16,23,7,2,4,0,3621,3654,14
Task 3622,Job 0,8,8,1,8,0,9,16,7,1,2,2,3622,3656,3
Task 3622,Job 1,13,8,3,12,1,16,25,9,3,3,2,3622,3656,2
Task 3623,Job 0,5,4,3,12,0,8,17,9,3,1,2,3623,3656,12
Task 3623,Job 1,10,8,4,6,0,14,16,2,4,4,0,3623,3656,9
Task 3624,Job 0,3,10,1,11,0,4,14,10,1,1,1,3624,3657,5
Task 3624,Job 1,8,4,2,6,1,10,14,4,2,1,0,3624,3657,9
Task 3625,Job 0,4,6,2,10,0,6,14,8,2,1,0,3625,3658,11
Task 3625,Job 1,9,10,3,12,0,12,21,9,3,3,2,3625,3658,14
Task 3626,Job 0,1,8,4,9,1,5,10,5,4,2,2,3626,3660,11
Task 3626,Job 1,6,4,1,8,0,7,14,7,1,3,1,3626,3660,10
Task 3627,Job 0,1,7,1,12,1,2,13,11,1,1,0,3627,3660,17
Task 3627,Job 1,6,6,1,9,1,7,15,8,1,1,0,3627,3660,14
Task 3628,Job 0,4,7,4,12,0,8,16,8,4,2,1,3628,3662,15
Task 3628,Job 1,9,5,1,6,0,10,15,5,1,1,0,3628,3662,15
Task 3629,Job 0,6,7,2,10,0,8,16,8,2,1,0,3629,3662,2
Task 3629,Job 1,11,7,1,11,0,12,22,10,1,1,2,3629,3662,17
Task 3630,Job 0,5,4,4,12,0,9,17,8,4,2,2,3630,3664,7
Task 3630,Job 1,10,7,2,7,1,12,17,5,2,4,0,3630,3664,13
Task 3631,Job 0,8,10,1,11,0,9,19,10,1,4,1,3631,3665,13
Task 3631,Job 1,13,8,2,11,1,15,24,9,2,2,0,3631,3665,9
Task 3632,Job 0,4,10,4,9,1,8,13,5,4,3,0,3632,3665,2
Task 3632,Job 1,9,8,1,7,1,10,16,6,1,3,1,3632,3665,14
Task 3633,Job 0,9,5,1,6,0,10,15,5,1,3,1,3633,3667,18
Task 3633,Job 1,14,10,2,8,0,16,22,6,2,3,2,3633,3667,12
Task 3634,Job 0,2,6,3,9,0,5,11,6,3,4,0,3634,3668,16
Task 3634,Job 1,7,7,4,6,0,11,13,2,4,1,0,3634,3668,14
Task 3635,Job 0,2,9,3,11,0,5,13,8,3,3,1,3635,3669,4
Task 3635,Job 1,7,10,2,10,0,9,17,8,2,1,0,3635,3669,3
Task 3636,Job 0,3,7,2,9,0,5,12,7,2,2,2,3636,3669,17
Task 3636,Job 1,8,7,2,6,0,10,14,4,2,3,1,3636,3669,18
Task 3637,Job 0,5,9,2,10,0,7,15,8,2,2,2,3637,3670,15
Task 3637,Job 1,10,7,1,12,1,11,22,11,1,3,0,3637,3670,18
Task 3638,Job 0,5,5,1,11,1,6,16,10,1,4,1,3638,3672,14
Task 3638,Job 1,10,4,1,6,0,11,16,5,1,2,2,3638,3672,17
Task 3639,Job 0,6,8,1,9,0,7,15,8,1,4,1,3639,3673,13
Task 3639,Job 1,11,8,1,9,0,12,20,8,1,3,0,3639,3673,6
Task 3640,Job 0,6,10,3,10,0,9,16,7,3,4,1,3640,3673,10
Task 3640,Job 1,11,7,1,11,0,12,22,10,1,2,1,3640,3673,7
Task 3641,Job 0,10,6,3,11,0,13,21,8,3,3,1,3641,3675,12
Task 3641,Job 1,15,6,4,12,1,19,27,8,4,3,1,3641,3675,14
Task 3642,Job 0,2,10,2,8,0,4,10,6,2,4,0,3642,3676,12
Task 3642,Job 1,7,8,4,6,0,11,13,2,4,4,1,3642,3676,16
Task 3643,Job 0,8,4,1,7,1,9,15,6,1,3,1,3643,3677,19
Task 3643,Job 1,13,4,4,10,0,17,23,6,4,3,2,3643,3677,3
Task 3644,Job 0,10,4,1,11,0,11,21,10,1,1,1,3644,3678,19
Task 3644,Job 1,15,10,2,10,0,17,25,8,2,2,1,3644,3678,18
Task 3645,Job 0,9,9,4,12,0,13,21,8,4,3,2,3645,3679,19
Task 3645,Job 1,14,4,1,9,0,15,23,8,1,3,0,3645,3679,11
Task 3646,Job 0,1,8,1,10,0,2,11,9,1,1,1,3646,3679,17
Task 3646,Job 1,6,7,3,7,0,9,13,4,3,1,2,3646,3679,19
Task 3647,Job 0,9,7,1,7,1,10,16,6,1,3,0,3647,3680,4
Task 3647,Job 1,14,10,4,9,0,18,23,5,4,3,0,3647,3680,8
Task 3648,Job 0,10,4,4,8,1,14,18,4,4,3,1,3648,3681,7
Task 3648,Job 1,15,6,1,11,0,16,26,10,1,2,2,3648,3681,3
Task 3649,Job 0,4,10,4,6,0,8,10,2,4,1,0,3649,3682,9
Task 3649,Job 1,9,6,1,10,0,10,19,9,1,1,2,3649,3682,10
Task 3650,Job 0,6,5,4,11,0,10,17,7,4,4,0,3650,3683,12
Task 3650,Job 1,11,4,1,10,0,12,21,9,1,1,2,3650,3683,14
Task 3651,Job 0,4,7,1,9,1,5,13,8,1,3,0,3651,3684,5
Task 3651,Job 1,9,5,2,12,0,11,21,10,2,4,0,3651,3684,8
Task 3652,Job 0,2,7,2,9,0,4,11,7,2,1,1,3652,3685,18
Task 3652,Job 1,7,7,3,7,0,10,14,4,3,1,0,3652,3685,4
Task 3653,Job 0,1,7,3,10,0,4,11,7,3,4,2,3653,3687,19
Task 3653,Job 1,6,7,2,12,0,8,18,10,2,2,0,3653,3687,20
Task 3654,Job 0,9,8,4,7,0,13,16,3,4,2,0,3654,3687,12
Task 3654,Job 1,14,10,2,7,0,16,21,5,2,4,0,3654,3687,9
Task 3655,Job 0,7,5,3,10,1,10,17,7,3,1,2,3655,3688,20
Task 3655,Job 1,12,6,1,12,1,13,24,11,1,4,1,3655,3688,4
Task 3656,Job 0,3,4,4,12,0,7,15,8,4,1,1,3656,3689,3
Task 3656,Job 1,8,8,4,12,0,12,20,8,4,4,1,3656,3689,17
Task 3657,Job 0,1,7,4,9,1,5,10,5,4,2,0,3657,3690,10
Task 3657,Job 1,6,4,3,10,0,9,16,7,3,1,1,3657,3690,18
Task 3658,Job 0,3,6,4,11,0,7,14,7,4,2,2,3658,3692,18
Task 3658,Job 1,8,5,3,9,0,11,17,6,3,2,1,3658,3692,3
Task 3659,Job 0,1,8,1,6,0,2,7,5,1,2,1,3659,3692,20
Task 3659,Job 1,6,7,3,8,0,9,14,5,3,4,1,3659,3692,11
Task 3660,Job 0,3,6,1,10,0,4,13,9,1,4,2,3660,3693,16
Task 3660,Job 1,8,6,1,12,0,9,20,11,1,1,1,3660,3693,17
Task 3661,Job 0,5,8,2,10,0,7,15,8,2,2,1,3661,3695,2
Task 3661,Job 1,10,8,4,6,1,14,16,2,4,3,1,3661,3695,11
Task 3662,Job 0,2,9,1,7,0,3,9,6,1,2,1,3662,3695,15
Task 3662,Job 1,7,6,4,6,1,11,13,2,4,1,0,3662,3695,15
Task 3663,Job 0,4,5,2,10,0,6,14,8,2,4,2,3663,3696,13
Task 3663,Job 1,9,5,3,7,0,12,16,4,3,1,0,3663,3696,15
Task 3664,Job 0,5,8,4,11,0,9,16,7,4,4,1,3664,3698,12
Task 3664,Job 1,10,6,3,8,0,13,18,5,3,4,2,3664,3698,2
Task 3665,Job 0,10,8,2,6,0,12,16,4,2,1,2,3665,3698,20
Task 3665,Job 1,15,4,1,8,0,16,23,7,1,2,0,3665,3698,10
Task 3666,Job 0,2,10,2,6,0,4,8,4,2,3,0,3666,3700,11
Task 3666,Job 1,7,10,3,7,0,10,14,4,3,4,1,3666,3700,20
Task 3667,Job 0,9,9,1,10,0,10,19,9,1,4,2,3667,3700,19
Task 3667,Job 1,14,4,3,12,1,17,26,9,3,4,0,3667,3700,10
Task 3668,Job 0,8,5,1,8,0,9,16,7,1,2,2,3668,3702,4
Task 3668,Job 1,13,8,2,7,0,15,20,5,2,1,1,3668,3702,14
Task 3669,Job 0,10,5,2,6,0,12,16,4,2,1,0,3669,3702,3
Task 3669,Job 1,15,8,2,11,0,17,26,9,2,4,0,3669,3702,20
Task 3670,Job 0,9,8,2,7,0,11,16,5,2,4,0,3670,3703,7
Task 3670,Job 1,14,7,2,6,0,16,20,4,2,4,1,3670,3703,9
Task 3671,Job 0,4,7,3,11,1,7,15,8,3,2,2,3671,3705,12
Task 3671,Job 1,9,8,2,7,0,11,16,5,2,3,2,3671,3705,12
Task 3672,Job 0,4,6,3,10,0,7,14,7,3,1,0,3672,3706,3
Task 3672,Job 1,9,6,3,10,0,12,19,7,3,1,1,3672,3706,15
Task 3673,Job 0,1,8,1,6,0,2,7,5,1,1,2,3673,3706,11
Task 3673,Job 1,6,8,3,10,0,9,16,7,3,2,0,3673,3706,12
Task 3674,Job 0,2,9,4,11,0,6,13,7,4,3,1,3674,3708,4
Task 3674,Job 1,7,6,3,11,0,10,18,8,3,1,0,3674,3708,7
Task 3675,Job 0,2,8,3,7,0,5,9,4,3,1,0,3675,3709,16
Task 3675,Job 1,7,6,3,8,0,10,15,5,3,1,0,3675,3709,14
Task 3676,Job 0,10,6,2,10,0,12,20,8,2,3,1,3676,3709,6
Task 3676,Job 1,15,5,4,10,0,19,25,6,4,4,1,3676,3709,13
Task 3677,Job 0,6,4,2,8,0,8,14,6,2,3,2,3677,3711,18
Task 3677,Job 1,11,8,1,6,0,12,17,5,1,4,0,3677,3711,16
Task 3678,Job 0,5,10,1,12,0,6,17,11,1,2,1,3678,3711,3
Task 3678,Job 1,10,5,4,12,1,14,22,8,4,1,1,3678,3711,12
Task 3679,Job 0,6,6,3,11,0,9,17,8,3,1,2,3679,3713,16
Task 3679,Job 1,11,7,1,10,0,12,21,9,1,1,1,3679,3713,12
Task 3680,Job 0,3,10,2,7,0,5,10,5,2,1,1,3680,3713,2
Task 3680,Job 1,8,7,2,9,1,10,17,7,2,4,1,3680,3713,16
Task 3681,Job 0,8,5,4,10,1,12,18,6,4,1,0,3681,3715,10
Task 3681,Job 1,13,5,1,10,1,14,23,9,1,1,1,3681,3715,18
Task 3682,Job 0,4,8,1,8,1,5,12,7,1,3,2,3682,3715,17
Task 3682,Job 1,9,9,3,7,0,12,16,4,3,4,0,3682,3715,19
Task 3683,Job 0,5,6,3,7,0,8,12,4,3,4,0,3683,3717,20
Task 3683,Job 1,10,8,1,7,0,11,17,6,1,1,2,3683,3717,8
Task 3684,Job 0,7,4,4,9,0,11,16,5,4,2,1,3684,3718,14
Task 3684,Job 1,12,7,1,10,0,13,22,9,1,4,0,3684,3718,15
Task 3685,Job 0,5,10,1,8,1,6,13,7,1,4,0,3685,3718,11
Task 3685,Job 1,10,10,4,10,1,14,20,6,4,1,1,3685,3718,4
Task 3686,Job 0,4,4,2,11,0,6,15,9,2,3,2,3686,3720,11
Task 3686,Job 1,9,7,1,11,0,10,20,10,1,4,2,3686,3720,2
Task 3687,Job 0,7,8,1,11,0,8,18,10,1,3,1,3687,3721,5
Task 3687,Job 1,12,7,3,12,0,15,24,9,3,4,0,3687,3721,18
Task 3688,Job 0,10,6,1,8,0,11,18,7,1,3,0,3688,3722,12
Task 3688,Job 1,15,7,3,12,1,18,27,9,3,4,2,3688,3722,9
Task 3689,Job 0,9,8,2,7,0,11,16,5,2,3,0,3689,3723,6
Task 3689,Job 1,14,10,4,7,0,18,21,3,4,2,1,3689,3723,8
Task 3690,Job 0,7,6,3,11,0,10,18,8,3,3,1,3690,3723,10
Task 3690,Job 1,12,7,2,7,0,14,19,5,2,3,2,3690,3723,2
Task 3691,Job 0,5,4,3,11,1,8,16,8,3,3,0,3691,3725,20
Task 3691,Job 1,10,8,3,8,1,13,18,5,3,3,1,3691,3725,2
Task 3692,Job 0,9,9,1,12,0,10,21,11,1,3,0,3692,3725,5
Task 3692,Job 1,14,6,1,8,0,15,22,7,1,3,2,3692,3725,18
Task 3693,Job 0,8,7,1,12,1,9,20,11,1,2,1,3693,3727,19
Task 3693,Job 1,13,10,2,11,0,15,24,9,2,2,0,3693,3727,7
Task 3694,Job 0,5,10,3,10,0,8,15,7,3,4,2,3694,3728,7
Task 3694,Job 1,10,6,3,10,1,13,20,7,3,2,0,3694,3728,2
Task 3695,Job 0,8,10,1,9,0,9,17,8,1,4,0,3695,3729,7
Task 3695,Job 1,13,7,1,12,0,14,25,11,1,4,1,3695,3729,11
Task 3696,Job 0,3,6,4,8,0,7,11,4,4,4,0,3696,3729,2
Task 3696,Job 1,8,7,3,7,0,11,15,4,3,3,2,3696,3729,10
Task 3697,Job 0,6,5,3,9,0,9,15,6,3,1,2,3697,3730,5
Task 3697,Job 1,11,7,4,8,0,15,19,4,4,1,1,3697,3730,14
Task 3698,Job 0,2,5,2,7,0,4,9,5,2,2,1,3698,3731,15
Task 3698,Job 1,7,5,2,9,0,9,16,7,2,4,1,3698,3731,15
Task 3699,Job 0,10,7,2,9,0,12,19,7,2,1,2,3699,3732,9
Task 3699,Job 1,15,6,1,6,0,16,21,5,1,3,1,3699,3732,20
Task 3700,Job 0,2,10,4,6,0,6,8,2,4,4,1,3700,3734,17
Task 3700,Job 1,7,10,4,8,0,11,15,4,4,3,2,3700,3734,15
Task 3701,Job 0,7,4,1,11,0,8,18,10,1,4,1,3701,3734,6
Task 3701,Job 1,12,6,1,6,0,13,18,5,1,1,2,3701,3734,5
Task 3702,Job 0,9,5,2,7,0,11,16,5,2,2,0,3702,3735,19
Task 3702,Job 1,14,6,2,10,1,16,24,8,2,3,1,3702,3735,20
Task 3703,Job 0,10,4,3,7,1,13,17,4,3,4,0,3703,3736,13
Task 3703,Job 1,15,6,4,10,0,19,25,6,4,3,0,3703,3736,12
Task 3704,Job 0,4,7,1,11,1,5,15,10,1,2,0,3704,3737,13
Task 3704,Job 1,9,7,3,7,0,12,16,4,3,1,0,3704,3737,8
Task 3705,Job 0,10,10,3,11,0,13,21,8,3,2,1,3705,3739,5
Task 3705,Job 1,15,10,4,10,0,19,25,6,4,1,1,3705,3739,12
Task 3706,Job 0,4,4,2,7,0,6,11,5,2,2,2,3706,3740,18
Task 3706,Job 1,9,4,3,12,1,12,21,9,3,3,2,3706,3740,17
Task 3707,Job 0,8,4,1,7,0,9,15,6,1,3,2,3707,3741,12
Task 3707,Job 1,13,4,3,9,0,16,22,6,3,3,1,3707,3741,4
Task 3708,Job 0,4,5,1,6,1,5,10,5,1,1,2,3708,3742,10
Task 3708,Job 1,9,5,3,8,0,12,17,5,3,3,1,3708,3742,20
Task 3709,Job 0,4,8,4,8,1,8,12,4,4,2,0,3709,3743,4
Task 3709,Job 1,9,9,3,6,1,12,15,3,3,3,2,3709,3743,4
Task 3710,Job 0,3,4,4,10,0,7,13,6,4,2,0,3710,3743,13
Task 3710,Job 1,8,4,3,9,0,11,17,6,3,1,0,3710,3743,2
Task 3711,Job 0,6,7,3,10,0,9,16,7,3,1,0,3711,3744,15
Task 3711,Job 1,11,5,1,11,1,12,22,10,1,2,1,3711,3744,9
Task 3712,Job 0,4,10,4,6,0,8,10,2,4,1,2,3712,3745,14
Task 3712,Job 1,9,10,4,12,0,13,21,8,4,2,2,3712,3745,16
Task 3713,Job 0,2,8,3,11,0,5,13,8,3,3,2,3713,3746,6
Task 3713,Job 1,7,4,4,7,1,11,14,3,4,2,2,3713,3746,14
Task 3714,Job 0,10,4,4,11,0,14,21,7,4,4,2,3714,3747,15
Task 3714,Job 1,15,7,4,9,1,19,24,5,4,3,0,3714,3747,4
Task 3715,Job 0,2,7,3,6,1,5,8,3,3,2,1,3715,3748,13
Task 3715,Job 1,7,6,1,6,1,8,13,5,1,3,2,3715,3748,13
Task 3716,Job 0,4,4,1,7,0,5,11,6,1,2,2,3716,3749,15
Task 3716,Job 1,9,6,1,6,1,10,15,5,1,2,0,3716,3749,13
Task 3717,Job 0,5,7,4,7,0,9,12,3,4,3,1,3717,3751,18
Task 3717,Job 1,10,9,2,8,0,12,18,6,2,1,0,3717,3751,18
Task 3718,Job 0,9,5,4,8,0,13,17,4,4,2,1,3718,3752,17
Task 3718,Job 1,14,6,3,9,0,17,23,6,3,3,2,3718,3752,17
Task 3719,Job 0,9,8,1,6,0,10,15,5,1,2,1,3719,3753,13
Task 3719,Job 1,14,4,1,7,0,15,21,6,1,1,1,3719,3753,12
Task 3720,Job 0,3,4,1,6,0,4,9,5,1,1,2,3720,3754,19
Task 3720,Job 1,8,5,3,7,1,11,15,4,3,4,2,3720,3754,9
Task 3721,Job 0,6,7,3,6,1,9,12,3,3,2,2,3721,3754,3
Task 3721,Job 1,11,4,1,9,1,12,20,8,1,2,1,3721,3754,14
Task 3722,Job 0,2,9,2,11,1,4,13,9,2,2,0,3722,3755,14
Task 3722,Job 1,7,7,2,11,0,9,18,9,2,2,0,3722,3755,20
Task 3723,Job 0,6,10,2,12,0,8,18,10,2,4,2,3723,3756,4
Task 3723,Job 1,11,9,3,9,0,14,20,6,3,4,0,3723,3756,17
Task 3724,Job 0,8,5,4,10,0,12,18,6,4,4,2,3724,3757,19
Task 3724,Job 1,13,8,4,9,0,17,22,5,4,4,2,3724,3757,14
Task 3725,Job 0,6,10,2,7,0,8,13,5,2,3,2,3725,3758,11
Task 3725,Job 1,11,7,4,9,1,15,20,5,4,2,0,3725,3758,11
Task 3726,Job 0,2,6,3,6,1,5,8,3,3,2,1,3726,3760,18
Task 3726,Job 1,7,10,3,9,0,10,16,6,3,1,0,3726,3760,16
Task 3727,Job 0,9,5,2,6,0,11,15,4,2,2,0,3727,3760,7
Task 3727,Job 1,14,10,4,12,1,18,26,8,4,3,0,3727,3760,4
Task 3728,Job 0,1,4,4,10,0,5,11,6,4,3,1,3728,3762,3
Task 3728,Job 1,6,7,3,9,0,9,15,6,3,4,1,3728,3762,20
Task 3729,Job 0,2,5,2,9,1,4,11,7,2,4,1,3729,3763,10
Task 3729,Job 1,7,9,2,7,0,9,14,5,2,3,0,3729,3763,5
Task 3730,Job 0,8,5,3,11,1,11,19,8,3,2,1,3730,3764,10
Task 3730,Job 1,13,6,2,6,0,15,19,4,2,2,1,3730,3764,3
Task 3731,Job 0,1,4,1,6,0,2,7,5,1,4,0,3731,3765,17
Task 3731,Job 1,6,7,2,12,1,8,18,10,2,2,2,3731,3765,10
Task 3732,Job 0,2,8,1,8,0,3,10,7,1,3,0,3732,3765,8
Task 3732,Job 1,7,7,1,12,0,8,19,11,1,2,1,3732,3765,9
Task 3733,Job 0,3,9,2,8,0,5,11,6,2,1,1,3733,3766,12
Task 3733,Job 1,8,5,4,7,0,12,15,3,4,3,1,3733,3766,18
Task 3734,Job 0,8,7,1,7,0,9,15,6,1,1,0,3734,3768,17
Task 3734,Job 1,13,5,1,6,1,14,19,5,1,2,1,3734,3768,14
Task 3735,Job 0,4,5,4,7,0,8,11,3,4,1,1,3735,3769,2
Task 3735,Job 1,9,4,2,10,0,11,19,8,2,4,2,3735,3769,17
Task 3736,Job 0,4,9,4,9,0,8,13,5,4,3,2,3736,3769,17
Task 3736,Job 1,9,5,4,7,0,13,16,3,4,3,1,3736,3769,9
Task 3737,Job 0,6,8,1,7,0,7,13,6,1,3,0,3737,3771,11
Task 3737,Job 1,11,9,1,9,0,12,20,8,1,1,0,3737,3771,16
Task 3738,Job 0,2,5,4,9,0,6,11,5,4,4,0,3738,3771,6
Task 3738,Job 1,7,10,4,12,0,11,19,8,4,1,1,3738,3771,7
Task 3739,Job 0,5,6,2,10,0,7,15,8,2,4,2,3739,3773,17
Task 3739,Job 1,10,5,4,11,1,14,21,7,4,2,1,3739,3773,9
Task 3740,Job 0,3,7,2,7,0,5,10,5,2,2,2,3740,3773,12
Task 3740,Job 1,8,8,1,7,0,9,15,6,1,4,2,3740,3773,17
Task 3741,Job 0,2,9,4,7,1,6,9,3,4,1,0,3741,3774,9
Task 3741,Job 1,7,7,1,10,1,8,17,9,1,1,2,3741,3774,17
Task 3742,Job 0,6,6,1,10,0,7,16,9,1,3,0,3742,3775,14
Task 3742,Job 1,11,9,1,12,0,12,23,11,1,2,0,3742,3775,16
Task 3743,Job 0,8,7,2,6,0,10,14,4,2,4,2,3743,3776,13
Task 3743,Job 1,13,9,1,7,1,14,20,6,1,3,1,3743,3776,8
Task 3744,Job 0,8,5,4,12,0,12,20,8,4,3,0,3744,3778,17
Task 3744,Job 1,13,5,2,12,0,15,25,10,2,2,0,3744,3778,8
Task 3745,Job 0,4,7,4,11,0,8,15,7,4,1,1,3745,3778,4
Task 3745,Job 1,9,10,2,8,1,11,17,6,2,3,1,3745,3778,15
Task 3746,Job 0,2,9,2,10,1,4,12,8,2,4,1,3746,3779,8
Task 3746,Job 1,7,4,2,11,0,9,18,9,2,4,1,3746,3779,3
Task 3747,Job 0,6,5,2,12,0,8,18,10,2,3,1,3747,3780,19
Task 3747,Job 1,11,4,1,7,0,12,18,6,1,1,2,3747,3780,6
Task 3748,Job 0,1,6,2,8,0,3,9,6,2,1,0,3748,3781,17
Task 3748,Job 1,6,5,3,9,0,9,15,6,3,3,2,3748,3781,13
Task 3749,Job 0,4,6,4,10,0,8,14,6,4,4,2,3749,3782,16
Task 3749,Job 1,9,10,1,7,0,10,16,6,1,3,0,3749,3782,5
Task 3750,Job 0,10,7,3,12,0,13,22,9,3,2,2,3750,3784,7
Task 3750,Job 1,15,5,3,10,0,18,25,7,3,3,2,3750,3784,12
Task 3751,Job 0,2,6,2,11,0,4,13,9,2,1,0,3751,3785,5
Task 3751,Job 1,7,8,3,8,0,10,15,5,3,4,2,3751,3785,11
Task 3752,Job 0,7,4,3,6,0,10,13,3,3,2,1,3752,3785,12
Task 3752,Job 1,12,7,3,11,0,15,23,8,3,1,0,3752,3785,3
Task 3753,Job 0,10,7,4,10,0,14,20,6,4,1,2,3753,3787,2
Task 3753,Job 1,15,6,2,11,0,17,26,9,2,3,1,3753,3787,10
Task 3754,Job 0,1,9,4,8,0,5,9,4,4,3,1,3754,3787,16
Task 3754,Job 1,6,5,4,9,0,10,15,5,4,3,1,3754,3787,7
Task 3755,Job 0,4,10,1,10,0,5,14,9,1,3,2,3755,3788,18
Task 3755,Job 1,9,10,2,6,0,11,15,4,2,4,2,3755,3788,13
Task 3756,Job 0,6,10,3,11,1,9,17,8,3,4,1,3756,3789,4
Task 3756,Job 1,11,6,2,6,0,13,17,4,2,2,2,3756,3789,4
Task 3757,Job 0,9,6,3,11,0,12,20,8,3,2,0,3757,3790,17
Task 3757,Job 1,14,4,1,10,0,15,24,9,1,4,0,3757,3790,3
Task 3758,Job 0,8,7,4,12,0,12,20,8,4,3,0,3758,3791,8
Task 3758,Job 1,13,7,1,10,0,14,23,9,1,1,1,3758,3791,20
Task 3759,Job 0,6,8,1,9,1,7,15,8,1,4,2,3759,3792,15
Task 3759,Job 1,11,10,2,10,0,13,21,8,2,4,0,3759,3792,6
Task 3760,Job 0,8,10,4,8,1,12,16,4,4,3,0,3760,3793,7
Task 3760,Job 1,13,8,4,6,0,17,19,2,4,3,2,3760,3793,12
Task 3761,Job 0,10,9,1,9,0,11,19,8,1,2,0,3761,3794,7
Task 3761,Job 1,15,9,4,8,1,19,23,4,4,4,1,3761,3794,14
Task 3762,Job 0,6,5,1,7,0,7,13,6,1,4,2,3762,3796,3
Task 3762,Job 1,11,5,2,8,0,13,19,6,2,1,2,3762,3796,13
Task 3763,Job 0,2,8,4,6,0,6,8,2,4,4,1,3763,3796,6
Task 3763,Job 1,7,5,4,9,1,11,16,5,4,2,2,3763,3796,5
Task 3764,Job 0,2,7,3,6,0,5,8,3,3,2,0,3764,3797,8
Task 3764,Job 1,7,7,4,11,0,11,18,7,4,1,0,3764,3797,10
Task 3765,Job 0,4,7,2,6,0,6,10,4,2,1,1,3765,3798,14
Task 3765,Job 1,9,5,3,9,1,12,18,6,3,3,0,3765,3798,9
Task 3766,Job 0,10,9,3,11,0,13,21,8,3,4,0,3766,3799,2
Task 3766,Job 1,15,5,4,9,0,19,24,5,4,3,1,3766,3799,14
Task 3767,Job 0,1,10,4,11,1,5,12,7,4,3,2,3767,3801,16
Task 3767,Job 1,6,9,2,9,0,8,15,7,2,4,1,3767,3801,7
Task 3768,Job 0,9,5,1,11,0,10,20,10,1,1,1,3768,3802,13
Task 3768,Job 1,14,9,4,11,0,18,25,7,4,4,2,3768,3802,19
Task 3769,Job 0,6,7,1,7,1,7,13,6,1,2,1,3769,3802,8
Task 3769,Job 1,11,9,4,6,0,15,17,2,4,2,1,3769,3802,12
Task 3770,Job 0,6,7,4,11,0,10,17,7,4,2,1,3770,3804,9
Task 3770,Job 1,11,8,3,11,1,14,22,8,3,4,0,3770,3804,19
Task 3771,Job 0,10,6,4,8,0,14,18,4,4,2,0,3771,3804,16
Task 3771,Job 1,15,6,4,6,0,19,21,2,4,1,2,3771,3804,10
Task 3772,Job 0,1,8,3,10,0,4,11,7,3,4,0,3772,3805,7
Task 3772,Job 1,6,6,2,12,0,8,18,10,2,4,0,3772,3805,12
Task 3773,Job 0,10,4,3,12,1,13,22,9,3,2,2,3773,3806,12
Task 3773,Job 1,15,5,2,9,0,17,24,7,2,2,2,3773,3806,20
Task 3774,Job 0,10,9,1,10,0,11,20,9,1,4,1,3774,3807,18
Task 3774,Job 1,15,9,2,11,1,17,26,9,2,2,2,3774,3807,18
Task 3775,Job 0,3,9,2,10,0,5,13,8,2,3,1,3775,3809,19
Task 3775,Job 1,8,4,1,10,0,9,18,9,1,3,1,3775,3809,5
Task 3776,Job 0,10,9,3,11,0,13,21,8,3,2,2,3776,3810,20
Task 3776,Job 1,15,10,3,9,1,18,24,6,3,4,2,3776,3810,14
Task 3777,Job 0,8,5,3,11,0,11,19,8,3,3,2,3777,3810,16
Task 3777,Job 1,13,4,1,6,1,14,19,5,1,1,1,3777,3810,12
Task 3778,Job 0,6,8,4,12,0,10,18,8,4,1,0,3778,3812,11
Task 3778,Job 1,11,8,2,11,1,13,22,9,2,3,2,3778,3812,7
Task 3779,Job 0,7,8,3,6,0,10,13,3,3,2,1,3779,3812,19
Task 3779,Job 1,12,5,4,7,0,16,19,3,4,4,0,3779,3812,11
Task 3780,Job 0,9,8,1,12,0,10,21,11,1,3,0,3780,3813,5
Task 3780,Job 1,14,7,4,8,1,18,22,4,4,1,0,3780,3813,6
Task 3781,Job 0,3,8,4,11,0,7,14,7,4,1,0,3781,3815,8
Task 3781,Job 1,8,8,4,12,0,12,20,8,4,4,2,3781,3815,4
Task 3782,Job 0,1,8,1,9,0,2,10,8,1,3,2,3782,3815,15
Task 3782,Job 1,6,10,2,12,0,8,18,10,2,1,0,3782,3815,9
Task 3783,Job 0,1,8,4,11,0,5,12,7,4,4,2,3783,3817,16
Task 3783,Job 1,6,9,2,8,0,8,14,6,2,2,1,3783,3817,20
Task 3784,Job 0,7,7,3,11,0,10,18,8,3,2,2,3784,3817,4
Task 3784,Job 1,12,8,2,9,0,14,21,7,2,2,2,3784,3817,17
Task 3785,Job 0,9,10,4,8,0,13,17,4,4,2,2,3785,3818,6
Task 3785,Job 1,14,7,1,7,1,15,21,6,1,3,1,3785,3818,4
Task 3786,Job 0,3,8,4,8,1,7,11,4,4,2,2,3786,3819,3
Task 3786,Job 1,8,5,1,9,0,9,17,8,1,3,1,3786,3819,14
Task 3787,Job 0,7,9,1,8,0,8,15,7,1,4,2,3787,3821,11
Task 3787,Job 1,12,7,4,9,0,16,21,5,4,4,0,3787,3821,15
Task 3788,Job 0,10,9,3,7,0,13,17,4,3,1,2,3788,3821,19
Task 3788,Job 1,15,8,2,6,0,17,21,4,2,3,2,3788,3821,2
Task 3789,Job 0,10,7,2,7,0,12,17,5,2,4,1,3789,3822,9
Task 3789,Job 1,15,4,3,6,0,18,21,3,3,4,0,3789,3822,8
Task 3790,Job 0,9,5,1,8,0,10,17,7,1,2,2,3790,3823,12
Task 3790,Job 1,14,6,4,11,1,18,25,7,4,2,2,3790,3823,19
Task 3791,Job 0,7,6,4,6,0,11,13,2,4,1,1,3791,3825,2
Task 3791,Job 1,12,9,1,9,0,13,21,8,1,2,0,3791,3825,14
Task 3792,Job 0,3,8,3,6,0,6,9,3,3,2,0,3792,3825,19
Task 3792,Job 1,8,7,1,11,1,9,19,10,1,1,2,3792,3825,18
Task 3793,Job 0,7,9,4,8,1,11,15,4,4,4,1,3793,3827,12
Task 3793,Job 1,12,9,2,8,1,14,20,6,2,1,0,3793,3827,9
Task 3794,Job 0,2,4,3,10,0,5,12,7,3,3,1,3794,3828,11
Task 3794,Job 1,7,8,1,11,0,8,18,10,1,3,1,3794,3828,4
Task 3795,Job 0,9,10,3,11,0,12,20,8,3,2,2,3795,3828,6
Task 3795,Job 1,14,4,2,10,0,16,24,8,2,4,2,3795,3828,3
Task 3796,Job 0,10,5,2,8,0,12,18,6,2,2,1,3796,3830,13
Task 3796,Job 1,15,9,1,11,0,16,26,10,1,2,1,3796,3830,4
Task 3797,Job 0,8,10,2,6,0,10,14,4,2,3,2,3797,3831,18
Task 3797,Job 1,13,10,2,9,1,15,22,7,2,1,1,3797,3831,7
Task 3798,Job 0,8,4,3,7,0,11,15,4,3,3,0,3798,3832,14
Task 3798,Job 1,13,10,2,11,1,15,24,9,2,3,2,3798,3832,6
Task 3799,Job 0,8,10,1,9,0,9,17,8,1,3,0,3799,3832,8
Task 3799,Job 1,13,7,1,10,0,14,23,9,1,1,2,3799,3832,20
Task 3800,Job 0,2,4,4,10,1,6,12,6,4,2,0,3800,3833,17
Task 3800,Job 1,7,6,3,10,1,10,17,7,3,1,0,3800,3833,9
Task 3801,Job 0,5,9,3,10,1,8,15,7,3,3,1,3801,3834,13
Task 3801,Job 1,10,5,2,9,0,12,19,7,2,3,2,3801,3834,10
Task 3802,Job 0,8,4,1,6,0,9,14,5,1,3,0,3802,3836,19
Task 3802,Job 1,13,6,3,7,0,16,20,4,3,3,2,3802,3836,18
Task 3803,Job 0,6,7,3,6,1,9,12,3,3,4,1,3803,3837,14
Task 3803,Job 1,11,5,3,7,0,14,18,4,3,1,2,3803,3837,7
Task 3804,Job 0,4,4,1,12,1,5,16,11,1,2,1,3804,3838,9
Task 3804,Job 1,9,9,4,11,0,13,20,7,4,3,0,3804,3838,4
Task 3805,Job 0,7,9,4,9,0,11,16,5,4,3,1,3805,3838,19
Task 3805,Job 1,12,5,1,6,0,13,18,5,1,3,2,3805,3838,7
Task 3806,Job 0,8,8,2,8,0,10,16,6,2,1,1,3806,3839,13
Task 3806,Job 1,13,6,3,6,0,16,19,3,3,4,0,3806,3839,2
Task 3807,Job 0,9,7,4,7,0,13,16,3,4,1,1,3807,3840,19
Task 3807,Job 1,14,5,4,10,0,18,24,6,4,1,1,3807,3840,9
Task 3808,Job 0,7,7,4,6,1,11,13,2,4,4,1,3808,3842,19
Task 3808,Job 1,12,8,3,9,0,15,21,6,3,4,2,3808,3842,7
Task 3809,Job 0,7,8,3,10,0,10,17,7,3,4,2,3809,3843,9
Task 3809,Job 1,12,4,1,9,0,13,21,8,1,1,2,3809,3843,5
Task 3810,Job 0,3,7,2,8,0,5,11,6,2,1,0,3810,3843,9
Task 3810,Job 1,8,4,3,12,0,11,20,9,3,3,1,3810,3843,9
Task 3811,Job 0,10,10,4,11,0,14,21,7,4,4,2,3811,3844,2
Task 3811,Job 1,15,9,4,7,0,19,22,3,4,3,1,3811,3844,2
Task 3812,Job 0,2,8,1,6,0,3,8,5,1,4,0,3812,3846,12
Task 3812,Job 1,7,4,3,7,0,10,14,4,3,3,2,3812,3846,5
Task 3813,Job 0,8,5,2,7,0,10,15,5,2,1,2,3813,3846,8
Task 3813,Job 1,13,9,1,7,0,14,20,6,1,2,0,3813,3846,17
Task 3814,Job 0,10,7,4,10,0,14,20,6,4,4,1,3814,3847,10
Task 3814,Job 1,15,9,4,7,0,19,22,3,4,1,2,3814,3847,2
Task 3815,Job 0,1,8,1,12,0,2,13,11,1,2,2,3815,3848,20
Task 3815,Job 1,6,6,3,8,1,9,14,5,3,4,0,3815,3848,15
Task 3816,Job 0,6,10,4,12,0,10,18,8,4,1,0,3816,3850,5
Task 3816,Job 1,11,5,1,11,0,12,22,10,1,1,1,3816,3850,16
Task 3817,Job 0,7,6,2,12,1,9,19,10,2,2,1,3817,3851,12
Task 3817,Job 1,12,6,4,9,0,16,21,5,4,2,0,3817,3851,7
Task 3818,Job 0,2,5,3,11,1,5,13,8,3,4,2,3818,3851,5
Task 3818,Job 1,7,5,1,6,0,8,13,5,1,1,2,3818,3851,19
Task 3819,Job 0,6,4,2,6,0,8,12,4,2,2,2,3819,3853,19
Task 3819,Job 1,11,4,1,9,1,12,20,8,1,4,0,3819,3853,16
Task 3820,Job 0,5,7,3,12,0,8,17,9,3,4,2,3820,3854,16
Task 3820,Job 1,10,5,2,11,0,12,21,9,2,1,1,3820,3854,7
Task 3821,Job 0,9,5,1,11,0,10,20,10,1,1,2,3821,3855,2
Task 3821,Job 1,14,10,4,6,0,18,20,2,4,4,2,3821,3855,15
Task 3822,Job 0,5,4,2,9,0,7,14,7,2,4,0,3822,3855,10
Task 3822,Job 1,10,4,1,9,1,11,19,8,1,1,1,3822,3855,11
Task 3823,Job 0,3,4,3,12,0,6,15,9,3,2,0,3823,3856,3
Task 3823,Job 1,8,5,3,12,0,11,20,9,3,3,1,3823,3856,6
Task 3824,Job 0,2,6,4,9,0,6,11,5,4,2,1,3824,3858,4
Task 3824,Job 1,7,10,4,7,0,11,14,3,4,2,1,3824,3858,8
Task 3825,Job 0,9,10,4,8,0,13,17,4,4,1,2,3825,3858,9
Task 3825,Job 1,14,9,2,8,0,16,22,6,2,4,2,3825,3858,13
Task 3826,Job 0,7,7,3,10,0,10,17,7,3,2,1,3826,3860,14
Task 3826,Job 1,12,4,2,10,0,14,22,8,2,1,2,3826,3860,15
Task 3827,Job 0,9,7,4,7,0,13,16,3,4,1,0,3827,3861,8
Task 3827,Job 1,14,6,2,11,0,16,25,9,2,4,2,3827,3861,6
Task 3828,Job 0,2,6,3,10,0,5,12,7,3,1,2,3828,3861,15
Task 3828,Job 1,7,4,3,7,1,10,14,4,3,4,0,3828,3861,9
Task 3829,Job 0,1,6,4,11,1,5,12,7,4,1,2,3829,3863,16
Task 3829,Job 1,6,10,1,12,0,7,18,11,1,1,0,3829,3863,17
Task 3830,Job 0,9,5,4,7,0,13,16,3,4,1,1,3830,3863,8
Task 3830,Job 1,14,7,3,8,0,17,22,5,3,4,0,3830,3863,20
Task 3831,Job 0,1,7,2,12,0,3,13,10,2,4,1,3831,3865,13
Task 3831,Job 1,6,7,1,6,1,7,12,5,1,3,1,3831,3865,12
Task 3832,Job 0,10,9,3,10,0,13,20,7,3,1,1,3832,3866,14
Task 3832,Job 1,15,7,3,11,1,18,26,8,3,1,2,3832,3866,17
Task 3833,Job 0,2,7,1,12,1,3,14,11,1,4,1,3833,3867,18
Task 3833,Job 1,7,5,2,12,1,9,19,10,2,4,2,3833,3867,17
Task 3834,Job 0,7,10,3,9,0,10,16,6,3,4,0,3834,3867,5
Task 3834,Job 1,12,4,4,10,0,16,22,6,4,4,2,3834,3867,10
Task 3835,Job 0,8,7,1,7,0,9,15,6,1,2,1,3835,3869,11
Task 3835,Job 1,13,9,4,7,0,17,20,3,4,2,2,3835,3869,2
Task 3836,Job 0,10,10,1,9,1,11,19,8,1,2,0,3836,3870,15
Task 3836,Job 1,15,8,2,9,0,17,24,7,2,4,0,3836,3870,5
Task 3837,Job 0,3,8,3,6,0,6,9,3,3,3,2,3837,3871,8
Task 3837,Job 1,8,10,3,11,0,11,19,8,3,1,2,3837,3871,10
Task 3838,Job 0,4,4,3,6,0,7,10,3,3,3,2,3838,3872,11
Task 3838,Job 1,9,10,4,6,0,13,15,2,4,2,0,3838,3872,7
Task 3839,Job 0,4,6,4,11,0,8,15,7,4,1,1,3839,3873,13
Task 3839,Job 1,9,5,2,9,0,11,18,7,2,2,2,3839,3873,18
Task 3840,Job 0,9,9,1,10,1,10,19,9,1,2,2,3840,3874,18
Task 3840,Job 1,14,5,4,11,0,18,25,7,4,3,0,3840,3874,5
Task 3841,Job 0,6,4,1,6,1,7,12,5,1,4,2,3841,3875,4
Task 3841,Job 1,11,6,3,6,1,14,17,3,3,4,1,3841,3875,10
Task 3842,Job 0,4,8,1,9,0,5,13,8,1,4,2,3842,3875,2
Task 3842,Job 1,9,6,2,10,0,11,19,8,2,4,1,3842,3875,17
Task 3843,Job 0,2,9,3,7,0,5,9,4,3,1,2,3843,3877,8
Task 3843,Job 1,7,9,1,11,0,8,18,10,1,1,1,3843,3877,4
Task 3844,Job 0,2,6,4,12,1,6,14,8,4,3,2,3844,3877,12
Task 3844,Job 1,7,9,2,6,1,9,13,4,2,1,1,3844,3877,12
Task 3845,Job 0,3,9,2,7,0,5,10,5,2,3,0,3845,3878,12
Task 3845,Job 1,8,9,4,6,0,12,14,2,4,1,0,3845,3878,8
Task 3846,Job 0,9,8,3,11,0,12,20,8,3,4,1,3846,3879,2
Task 3846,Job 1,14,7,3,12,0,17,26,9,3,4,0,3846,3879,9
Task 3847,Job 0,9,6,3,7,0,12,16,4,3,2,2,3847,3881,12
Task 3847,Job 1,14,7,2,10,0,16,24,8,2,2,0,3847,3881,9
Task 3848,Job 0,6,7,1,7,0,7,13,6,1,3,1,3848,3882,13
Task 3848,Job 1,11,5,4,6,0,15,17,2,4,1,2,3848,3882,9
Task 3849,Job 0,10,5,3,8,0,13,18,5,3,4,1,3849,3882,17
Task 3849,Job 1,15,9,2,10,0,17,25,8,2,4,0,3849,3882,13
Task 3850,Job 0,4,9,4,12,1,8,16,8,4,3,0,3850,3884,15
Task 3850,Job 1,9,6,1,9,0,10,18,8,1,1,1,3850,3884,4
Task 3851,Job 0,4,6,1,9,0,5,13,8,1,4,2,3851,3885,10
Task 3851,Job 1,9,4,1,7,0,10,16,6,1,3,0,3851,3885,8
Task 3852,Job 0,2,4,4,10,0,6,12,6,4,1,0,3852,3886,19
Task 3852,Job 1,7,9,2,7,1,9,14,5,2,4,1,3852,3886,19
Task 3853,Job 0,1,7,3,11,1,4,12,8,3,4,0,3853,3886,15
Task 3853,Job 1,6,6,2,10,0,8,16,8,2,2,1,3853,3886,16
Task 3854,Job 0,6,7,2,12,0,8,18,10,2,1,1,3854,3888,10
Task 3854,Job 1,11,5,3,10,1,14,21,7,3,3,0,3854,3888,19
Task 3855,Job 0,9,7,3,9,0,12,18,6,3,1,2,3855,3888,18
Task 3855,Job 1,14,8,4,6,0,18,20,2,4,2,1,3855,3888,17
Task 3856,Job 0,2,5,2,7,1,4,9,5,2,1,1,3856,3890,13
Task 3856,Job 1,7,5,2,9,0,9,16,7,2,1,0,3856,3890,16
Task 3857,Job 0,6,5,2,6,1,8,12,4,2,1,2,3857,3890,5
Task 3857,Job 1,11,7,2,6,0,13,17,4,2,1,2,3857,3890,11
Task 3858,Job 0,1,5,4,9,0,5,10,5,4,4,0,3858,3892,9
Task 3858,Job 1,6,4,3,12,1,9,18,9,3,1,0,3858,3892,17
Task 3859,Job 0,2,5,1,9,0,3,11,8,1,1,0,3859,3892,9
Task 3859,Job 1,7,5,1,9,0,8,16,8,1,1,1,3859,3892,14
Task 3860,Job 0,10,6,3,11,0,13,21,8,3,4,0,3860,3893,5
Task 3860,Job 1,15,4,2,6,0,17,21,4,2,4,1,3860,3893,13
Task 3861,Job 0,6,9,1,8,0,7,14,7,1,3,2,3861,3894,11
Task 3861,Job 1,11,5,2,11,1,13,22,9,2,3,0,3861,3894,4
Task 3862,Job 0,8,7,3,8,0,11,16,5,3,1,2,3862,3895,19
Task 3862,Job 1,13,4,2,7,0,15,20,5,2,2,0,3862,3895,2
Task 3863,Job 0,8,5,2,12,1,10,20,10,2,2,2,3863,3897,7
Task 3863,Job 1,13,8,4,10,0,17,23,6,4,3,2,3863,3897,7
Task 3864,Job 0,2,8,1,8,0,3,10,7,1,1,1,3864,3897,20
Task 3864,Job 1,7,9,1,9,0,8,16,8,1,2,0,3864,3897,4
Task 3865,Job 0,1,4,4,7,0,5,8,3,4,4,2,3865,3898,20
Task 3865,Job 1,6,7,2,10,0,8,16,8,2,4,0,3865,3898,3
Task 3866,Job 0,5,4,3,12,0,8,17,9,3,1,1,3866,3899,12
Task 3866,Job 1,10,5,3,6,1,13,16,3,3,3,2,3866,3899,3
Task 3867,Job 0,4,8,1,12,0,5,16,11,1,3,2,3867,3900,20
Task 3867,Job 1,9,6,1,8,0,10,17,7,1,1,2,3867,3900,16
Task 3868,Job 0,4,6,2,12,0,6,16,10,2,1,2,3868,3902,15
Task 3868,Job 1,9,5,4,10,0,13,19,6,4,1,1,3868,3902,13
Task 3869,Job 0,5,7,2,12,1,7,17,10,2,1,2,3869,3902,11
Task 3869,Job 1,10,4,2,6,0,12,16,4,2,1,0,3869,3902,20
Task 3870,Job 0,9,10,4,8,0,13,17,4,4,4,1,3870,3903,18
Task 3870,Job 1,14,8,2,9,0,16,23,7,2,4,1,3870,3903,7
Task 3871,Job 0,1,6,2,12,0,3,13,10,2,2,0,3871,3904,19
Task 3871,Job 1,6,5,3,8,0,9,14,5,3,1,2,3871,3904,14
Task 3872,Job 0,9,7,3,12,0,12,21,9,3,2,1,3872,3905,3
Task 3872,Job 1,14,9,2,7,0,16,21,5,2,4,1,3872,3905,5
Task 3873,Job 0,6,5,4,11,0,10,17,7,4,3,0,3873,3906,19
Task 3873,Job 1,11,8,3,11,0,14,22,8,3,3,1,3873,3906,11
Task 3874,Job 0,7,6,3,12,0,10,19,9,3,2,0,3874,3908,15
Task 3874,Job 1,12,5,4,9,0,16,21,5,4,2,0,3874,3908,17
Task 3875,Job 0,2,10,3,11,1,5,13,8,3,2,1,3875,3909,14
Task 3875,Job 1,7,8,2,10,1,9,17,8,2,4,2,3875,3909,12
Task 3876,Job 0,5,9,2,12,0,7,17,10,2,4,0,3876,3909,12
Task 3876,Job 1,10,6,1,10,1,11,20,9,1,4,0,3876,3909,19
Task 3877,Job 0,6,6,3,12,0,9,18,9,3,4,0,3877,3910,12
Task 3877,Job 1,11,8,1,7,0,12,18,6,1,2,0,3877,3910,14
Task 3878,Job 0,6,4,2,9,0,8,15,7,2,3,2,3878,3911,8
Task 3878,Job 1,11,9,3,6,0,14,17,3,3,1,1,3878,3911,2
Task 3879,Job 0,7,10,2,8,0,9,15,6,2,3,1,3879,3912,18
Task 3879,Job 1,12,8,3,10,0,15,22,7,3,2,2,3879,3912,8
Task 3880,Job 0,6,5,4,10,0,10,16,6,4,3,2,3880,3913,10
Task 3880,Job 1,11,10,2,7,0,13,18,5,2,4,0,3880,3913,15
Task 3881,Job 0,5,4,1,7,0,6,12,6,1,3,2,3881,3915,18
Task 3881,Job 1,10,6,1,12,0,11,22,11,1,1,1,3881,3915,15
Task 3882,Job 0,8,4,1,11,0,9,19,10,1,1,0,3882,3915,7
Task 3882,Job 1,13,6,2,9,0,15,22,7,2,2,0,3882,3915,3
Task 3883,Job 0,10,7,4,11,0,14,21,7,4,2,1,3883,3917,13
Task 3883,Job 1,15,7,2,9,1,17,24,7,2,4,1,3883,3917,8
Task 3884,Job 0,9,8,3,8,0,12,17,5,3,3,2,3884,3918,14
Task 3884,Job 1,14,8,4,10,0,18,24,6,4,4,1,3884,3918,18
Task 3885,Job 0,8,5,3,12,0,11,20,9,3,2,2,3885,3918,6
Task 3885,Job 1,13,6,2,10,0,15,23,8,2,1,1,3885,3918,12
Task 3886,Job 0,10,10,1,10,0,11,20,9,1,2,2,3886,3920,15
Task 3886,Job 1,15,6,3,6,0,18,21,3,3,3,1,3886,3920,15
Task 3887,Job 0,4,8,1,7,0,5,11,6,1,1,2,3887,3920,5
Task 3887,Job 1,9,5,1,10,0,10,19,9,1,2,0,3887,3920,10
Task 3888,Job 0,7,4,2,11,1,9,18,9,2,1,2,3888,3921,4
Task 3888,Job 1,12,10,1,9,0,13,21,8,1,4,0,3888,3921,8
Task 3889,Job 0,7,7,4,9,0,11,16,5,4,3,0,3889,3922,12
Task 3889,Job 1,12,9,4,7,1,16,19,3,4,2,0,3889,3922,15
Task 3890,Job 0,5,5,4,10,0,9,15,6,4,4,1,3890,3923,19
Task 3890,Job 1,10,8,4,8,0,14,18,4,4,1,0,3890,3923,6
Task 3891,Job 0,10,9,4,10,0,14,20,6,4,2,2,3891,3925,2
Task 3891,Job 1,15,10,4,11,0,19,26,7,4,3,2,3891,3925,6
Task 3892,Job 0,9,5,2,10,0,11,19,8,2,4,2,3892,3925,3
Task 3892,Job 1,14,8,4,8,1,18,22,4,4,4,2,3892,3925,4
Task 3893,Job 0,6,8,2,10,1,8,16,8,2,1,1,3893,3927,13
Task 3893,Job 1,11,10,4,7,0,15,18,3,4,3,0,3893,3927,20
Task 3894,Job 0,6,6,3,10,0,9,16,7,3,4,0,3894,3927,19
Task 3894,Job 1,11,8,2,12,0,13,23,10,2,3,2,3894,3927,16
Task 3895,Job 0,5,5,4,8,1,9,13,4,4,2,0,3895,3929,5
Task 3895,Job 1,10,9,3,7,0,13,17,4,3,3,2,3895,3929,2
Task 3896,Job 0,9,4,2,9,0,11,18,7,2,2,2,3896,3930,9
Task 3896,Job 1,14,4,1,10,1,15,24,9,1,4,1,3896,3930,12
Task 3897,Job 0,3,10,3,11,0,6,14,8,3,4,2,3897,3930,19
Task 3897,Job 1,8,6,4,11,0,12,19,7,4,3,2,3897,3930,2
Task 3898,Job 0,8,6,1,7,1,9,15,6,1,2,0,3898,3931,20
Task 3898,Job 1,13,7,2,6,0,15,19,4,2,1,0,3898,3931,11
Task 3899,Job 0,3,6,4,12,1,7,15,8,4,4,0,3899,3933,15
Task 3899,Job 1,8,8,4,10,0,12,18,6,4,1,2,3899,3933,19
Task 3900,Job 0,5,5,3,8,1,8,13,5,3,1,2,3900,3934,15
Task 3900,Job 1,10,9,2,6,0,12,16,4,2,2,2,3900,3934,15
Task 3901,Job 0,1,10,2,8,1,3,9,6,2,3,1,3901,3934,20
Task 3901,Job 1,6,4,2,7,1,8,13,5,2,2,2,3901,3934,6
Task 3902,Job 0,2,5,1,11,0,3,13,10,1,1,0,3902,3935,14
Task 3902,Job 1,7,4,4,12,1,11,19,8,4,3,2,3902,3935,10
Task 3903,Job 0,7,5,1,11,0,8,18,10,1,3,2,3903,3937,10
Task 3903,Job 1,12,10,1,7,0,13,19,6,1,4,1,3903,3937,14
Task 3904,Job 0,9,7,1,12,0,10,21,11,1,3,1,3904,3938,12
Task 3904,Job 1,14,10,3,8,0,17,22,5,3,1,2,3904,3938,16
Task 3905,Job 0,1,8,4,7,0,5,8,3,4,2,1,3905,3938,9
Task 3905,Job 1,6,5,2,7,0,8,13,5,2,4,2,3905,3938,10
Task 3906,Job 0,9,10,3,9,0,12,18,6,3,4,1,3906,3940,11
Task 3906,Job 1,14,9,3,8,0,17,22,5,3,1,2,3906,3940,19
Task 3907,Job 0,8,10,2,8,0,10,16,6,2,4,0,3907,3941,12
Task 3907,Job 1,13,6,4,6,1,17,19,2,4,4,2,3907,3941,2
Task 3908,Job 0,8,5,4,9,1,12,17,5,4,1,2,3908,3941,14
Task 3908,Job 1,13,10,2,11,0,15,24,9,2,4,0,3908,3941,13
Task 3909,Job 0,2,5,2,9,0,4,11,7,2,4,2,3909,3942,4
Task 3909,Job 1,7,8,4,7,0,11,14,3,4,3,2,3909,3942,13
Task 3910,Job 0,10,7,2,7,1,12,17,5,2,4,1,3910,3943,12
Task 3910,Job 1,15,8,1,7,0,16,22,6,1,3,0,3910,3943,13
Task 3911,Job 0,8,9,2,6,0,10,14,4,2,2,2,3911,3944,16
Task 3911,Job 1,13,4,3,12,0,16,25,9,3,4,1,3911,3944,3
Task 3912,Job 0,10,6,2,10,1,12,20,8,2,1,1,3912,3945,8
Task 3912,Job 1,15,9,1,7,1,16,22,6,1,1,0,3912,3945,19
Task 3913,Job 0,9,9,1,10,0,10,19,9,1,2,0,3913,3946,8
Task 3913,Job 1,14,10,1,10,0,15,24,9,1,1,2,3913,3946,19
Task 3914,Job 0,2,5,2,6,0,4,8,4,2,4,0,3914,3947,19
Task 3914,Job 1,7,7,1,12,0,8,19,11,1,3,0,3914,3947,3
Task 3915,Job 0,5,10,3,6,1,8,11,3,3,3,1,3915,3948,11
Task 3915,Job 1,10,5,4,11,1,14,21,7,4,1,0,3915,3948,9
Task 3916,Job 0,1,5,2,11,0,3,12,9,2,1,2,3916,3950,10
Task 3916,Job 1,6,8,1,9,1,7,15,8,1,2,0,3916,3950,10
Task 3917,Job 0,4,10,4,10,0,8,14,6,4,4,0,3917,3951,13
Task 3917,Job 1,9,8,3,6,0,12,15,3,3,3,2,3917,3951,15
Task 3918,Job 0,3,10,3,10,0,6,13,7,3,1,1,3918,3951,4
Task 3918,Job 1,8,10,1,9,0,9,17,8,1,4,1,3918,3951,11
Task 3919,Job 0,1,8,2,7,0,3,8,5,2,2,2,3919,3952,5
Task 3919,Job 1,6,10,4,6,1,10,12,2,4,4,2,3919,3952,5
Task 3920,Job 0,7,10,4,12,0,11,19,8,4,2,1,3920,3954,19
Task 3920,Job 1,12,8,3,6,0,15,18,3,3,3,1,3920,3954,3
Task 3921,Job 0,9,5,3,9,1,12,18,6,3,3,1,3921,3954,7
Task 3921,Job 1,14,4,1,12,1,15,26,11,1,3,2,3921,3954,7
Task 3922,Job 0,7,7,2,10,0,9,17,8,2,4,0,3922,3956,5
Task 3922,Job 1,12,10,4,10,1,16,22,6,4,3,1,3922,3956,2
Task 3923,Job 0,1,4,2,11,0,3,12,9,2,3,0,3923,3957,12
Task 3923,Job 1,6,7,2,7,0,8,13,5,2,1,0,3923,3957,20
Task 3924,Job 0,8,8,3,6,0,11,14,3,3,1,2,3924,3957,13
Task 3924,Job 1,13,5,4,8,0,17,21,4,4,4,2,3924,3957,6
Task 3925,Job 0,6,9,3,12,0,9,18,9,3,2,0,3925,3958,6
Task 3925,Job 1,11,5,3,8,0,14,19,5,3,4,0,3925,3958,8
Task 3926,Job 0,10,9,2,7,0,12,17,5,2,3,1,3926,3959,14
Task 3926,Job 1,15,6,1,6,0,16,21,5,1,3,1,3926,3959,17
Task 3927,Job 0,4,6,1,7,0,5,11,6,1,1,2,3927,3961,2
Task 3927,Job 1,9,6,3,6,0,12,15,3,3,3,0,3927,3961,4
Task 3928,Job 0,2,4,4,10,0,6,12,6,4,3,2,3928,3962,18
Task 3928,Job 1,7,10,3,11,0,10,18,8,3,1,2,3928,3962,18
Task 3929,Job 0,3,4,1,11,0,4,14,10,1,3,2,3929,3963,18
Task 3929,Job 1,8,10,2,11,1,10,19,9,2,2,2,3929,3963,18
Task 3930,Job 0,3,5,3,9,1,6,12,6,3,3,2,3930,3964,5
Task 3930,Job 1,8,4,4,8,0,12,16,4,4,3,2,3930,3964,14
Task 3931,Job 0,8,7,2,7,0,10,15,5,2,3,1,3931,3964,20
Task 3931,Job 1,13,8,1,10,1,14,23,9,1,1,1,3931,3964,2
Task 3932,Job 0,8,10,1,9,0,9,17,8,1,4,1,3932,3966,14
Task 3932,Job 1,13,4,3,6,0,16,19,3,3,3,2,3932,3966,9
Task 3933,Job 0,7,6,1,11,0,8,18,10,1,3,2,3933,3966,15
Task 3933,Job 1,12,7,4,10,0,16,22,6,4,4,0,3933,3966,4
Task 3934,Job 0,10,9,4,6,0,14,16,2,4,1,1,3934,3967,20
Task 3934,Job 1,15,9,4,10,1,19,25,6,4,2,1,3934,3967,10
Task 3935,Job 0,7,8,2,10,0,9,17,8,2,2,0,3935,3969,12
Task 3935,Job 1,12,7,4,7,0,16,19,3,4,3,2,3935,3969,10
Task 3936,Job 0,2,6,1,10,0,3,12,9,1,2,1,3936,3969,4
Task 3936,Job 1,7,8,3,6,1,10,13,3,3,1,1,3936,3969,15
Task 3937,Job 0,6,10,2,10,0,8,16,8,2,3,2,3937,3971,10
Task 3937,Job 1,11,9,3,11,0,14,22,8,3,3,2,3937,3971,19
Task 3938,Job 0,3,9,2,7,0,5,10,5,2,3,2,3938,3971,14
Task 3938,Job 1,8,6,2,9,0,10,17,7,2,3,0,3938,3971,4
Task 3939,Job 0,6,10,2,12,0,8,18,10,2,3,0,3939,3972,14
Task 3939,Job 1,11,5,1,8,1,12,19,7,1,3,0,3939,3972,3
Task 3940,Job 0,10,5,4,7,1,14,17,3,4,3,0,3940,3973,9
Task 3940,Job 1,15,8,1,6,1,16,21,5,1,4,0,3940,3973,11
Task 3941,Job 0,10,5,1,8,0,11,18,7,1,2,0,3941,3975,13
Task 3941,Job 1,15,9,3,10,0,18,25,7,3,4,1,3941,3975,3
Task 3942,Job 0,8,8,2,12,1,10,20,10,2,3,1,3942,3976,6
Task 3942,Job 1,13,6,3,7,0,16,20,4,3,2,1,3942,3976,18
Task 3943,Job 0,2,5,1,7,0,3,9,6,1,2,1,3943,3976,18
Task 3943,Job 1,7,5,1,10,0,8,17,9,1,3,2,3943,3976,3
Task 3944,Job 0,3,4,3,6,0,6,9,3,3,4,0,3944,3978,2
Task 3944,Job 1,8,4,2,10,0,10,18,8,2,2,2,3944,3978,18
Task 3945,Job 0,7,4,1,12,0,8,19,11,1,4,0,3945,3979,17
Task 3945,Job 1,12,5,1,7,0,13,19,6,1,2,0,3945,3979,8
Task 3946,Job 0,10,4,2,8,0,12,18,6,2,4,0,3946,3980,12
Task 3946,Job 1,15,4,2,8,0,17,23,6,2,1,1,3946,3980,12
Task 3947,Job 0,9,9,1,10,1,10,19,9,1,2,1,3947,3980,13
Task 3947,Job 1,14,9,1,9,0,15,23,8,1,1,1,3947,3980,17
Task 3948,Job 0,1,8,4,6,0,5,7,2,4,1,0,3948,3981,20
Task 3948,Job 1,6,4,2,6,1,8,12,4,2,1,0,3948,3981,11
Task 3949,Job 0,9,10,4,9,0,13,18,5,4,3,2,3949,3982,18
Task 3949,Job 1,14,8,4,6,0,18,20,2,4,2,1,3949,3982,18
Task 3950,Job 0,5,4,4,7,1,9,12,3,4,1,1,3950,3983,15
Task 3950,Job 1,10,4,4,6,0,14,16,2,4,4,1,3950,3983,8
Task 3951,Job 0,3,10,1,6,0,4,9,5,1,1,0,3951,3984,19
Task 3951,Job 1,8,8,4,10,0,12,18,6,4,1,0,3951,3984,6
Task 3952,Job 0,7,8,1,12,0,8,19,11,1,4,2,3952,3985,19
Task 3952,Job 1,12,6,3,9,1,15,21,6,3,3,0,3952,3985,15
Task 3953,Job 0,1,6,1,11,0,2,12,10,1,1,1,3953,3986,17
Task 3953,Job 1,6,6,2,11,0,8,17,9,2,3,2,3953,3986,10
Task 3954,Job 0,6,7,2,12,1,8,18,10,2,4,2,3954,3987,13
Task 3954,Job 1,11,10,4,6,1,15,17,2,4,3,1,3954,3987,2
Task 3955,Job 0,7,10,4,10,0,11,17,6,4,4,0,3955,3988,11
Task 3955,Job 1,12,7,2,12,0,14,24,10,2,2,2,3955,3988,12
Task 3956,Job 0,6,9,1,6,0,7,12,5,1,4,1,3956,3989,17
Task 3956,Job 1,11,8,4,11,0,15,22,7,4,2,0,3956,3989,2
Task 3957,Job 0,4,9,4,9,0,8,13,5,4,1,2,3957,3990,3
Task 3957,Job 1,9,8,2,9,0,11,18,7,2,2,0,3957,3990,17
Task 3958,Job 0,4,9,1,6,0,5,10,5,1,4,2,3958,3992,11
Task 3958,Job 1,9,9,1,11,0,10,20,10,1,2,2,3958,3992,4
Task 3959,Job 0,2,8,4,6,0,6,8,2,4,4,0,3959,3993,20
Task 3959,Job 1,7,8,3,11,0,10,18,8,3,4,2,3959,3993,3
Task 3960,Job 0,5,4,4,7,0,9,12,3,4,4,1,3960,3993,18
Task 3960,Job 1,10,8,3,10,1,13,20,7,3,3,2,3960,3993,18
Task 3961,Job 0,9,9,2,12,0,11,21,10,2,2,2,3961,3995,15
Task 3961,Job 1,14,9,4,6,1,18,20,2,4,4,1,3961,3995,5
Task 3962,Job 0,9,10,1,11,0,10,20,10,1,3,1,3962,3995,10
Task 3962,Job 1,14,6,4,12,0,18,26,8,4,4,0,3962,3995,14
Task 3963,Job 0,10,7,1,10,1,11,20,9,1,3,2,3963,3996,9
Task 3963,Job 1,15,7,3,9,1,18,24,6,3,2,1,3963,3996,20
Task 3964,Job 0,10,9,1,9,0,11,19,8,1,3,1,3964,3997,17
Task 3964,Job 1,15,10,4,7,1,19,22,3,4,4,2,3964,3997,3
Task 3965,Job 0,8,5,2,9,0,10,17,7,2,2,1,3965,3998,15
Task 3965,Job 1,13,10,2,6,0,15,19,4,2,4,0,3965,3998,13
Task 3966,Job 0,2,8,1,10,1,3,12,9,1,3,1,3966,4000,8
Task 3966,Job 1,7,10,3,10,0,10,17,7,3,2,1,3966,4000,7
Task 3967,Job 0,3,6,2,7,1,5,10,5,2,3,0,3967,4001,12
Task 3967,Job 1,8,7,4,11,0,12,19,7,4,1,2,3967,4001,10
Task 3968,Job 0,8,8,4,10,0,12,18,6,4,2,2,3968,4001,2
Task 3968,Job 1,13,4,3,9,0,16,22,6,3,4,0,3968,4001,6
Task 3969,Job 0,3,9,2,11,0,5,14,9,2,2,0,3969,4002,17
Task 3969,Job 1,8,8,4,10,0,12,18,6,4,3,0,3969,4002,2
Task 3970,Job 0,2,7,3,12,1,5,14,9,3,2,0,3970,4004,7
Task 3970,Job 1,7,7,3,9,0,10,16,6,3,3,1,3970,4004,10
Task 3971,Job 0,3,8,1,8,0,4,11,7,1,4,1,3971,4004,8
Task 3971,Job 1,8,9,4,10,0,12,18,6,4,3,0,3971,4004,9
Task 3972,Job 0,9,10,1,7,0,10,16,6,1,2,2,3972,4006,12
Task 3972,Job 1,14,7,2,8,1,16,22,6,2,1,0,3972,4006,16
Task 3973,Job 0,1,5,1,6,0,2,7,5,1,1,0,3973,4007,7
Task 3973,Job 1,6,4,2,9,0,8,15,7,2,2,1,3973,4007,6
Task 3974,Job 0,1,4,2,6,1,3,7,4,2,4,1,3974,4008,9
Task 3974,Job 1,6,7,4,12,0,10,18,8,4,4,2,3974,4008,17
Task 3975,Job 0,4,7,1,10,1,5,14,9,1,4,0,3975,4008,9
Task 3975,Job 1,9,5,2,11,0,11,20,9,2,3,0,3975,4008,4
Task 3976,Job 0,4,9,4,10,0,8,14,6,4,4,1,3976,4009,5
Task 3976,Job 1,9,5,1,6,0,10,15,5,1,3,2,3976,4009,16
Task 3977,Job 0,4,10,2,10,0,6,14,8,2,1,1,3977,4010,4
Task 3977,Job 1,9,8,1,9,0,10,18,8,1,3,1,3977,4010,8
Task 3978,Job 0,9,10,3,10,0,12,19,7,3,2,1,3978,4011,17
Task 3978,Job 1,14,9,1,11,0,15,25,10,1,1,0,3978,4011,10
Task 3979,Job 0,2,10,2,8,1,4,10,6,2,1,2,3979,4012,6
Task 3979,Job 1,7,6,2,9,1,9,16,7,2,4,2,3979,4012,9
Task 3980,Job 0,1,8,2,10,0,3,11,8,2,3,1,3980,4014,15
Task 3980,Job 1,6,5,3,12,0,9,18,9,3,3,0,3980,4014,16
Task 3981,Job 0,1,6,2,7,0,3,8,5,2,1,0,3981,4014,20
Task 3981,Job 1,6,10,2,9,0,8,15,7,2,3,2,3981,4014,12
Task 3982,Job 0,5,4,1,10,1,6,15,9,1,2,1,3982,4015,15
Task 3982,Job 1,10,9,2,11,1,12,21,9,2,2,2,3982,4015,9
Task 3983,Job 0,10,5,1,9,0,11,19,8,1,3,2,3983,4016,19
Task 3983,Job 1,15,10,2,10,0,17,25,8,2,3,2,3983,4016,4
Task 3984,Job 0,8,4,1,10,0,9,18,9,1,1,0,3984,4018,5
Task 3984,Job 1,13,8,2,11,1,15,24,9,2,2,0,3984,4018,18
Task 3985,Job 0,7,5,1,7,0,8,14,6,1,1,2,3985,4018,15
Task 3985,Job 1,12,9,3,8,0,15,20,5,3,3,1,3985,4018,6
Task 3986,Job 0,9,8,3,10,0,12,19,7,3,1,1,3986,4019,10
Task 3986,Job 1,14,9,4,9,0,18,23,5,4,1,2,3986,4019,8
Task 3987,Job 0,5,10,4,10,0,9,15,6,4,4,2,3987,4020,4
Task 3987,Job 1,10,7,4,6,1,14,16,2,4,2,2,3987,4020,4
Task 3988,Job 0,7,5,1,9,0,8,16,8,1,1,1,3988,4021,4
Task 3988,Job 1,12,4,2,6,0,14,18,4,2,1,0,3988,4021,7
Task 3989,Job 0,1,10,1,8,0,2,9,7,1,1,1,3989,4022,16
Task 3989,Job 1,6,8,2,12,1,8,18,10,2,2,0,3989,4022,4
Task 3990,Job 0,4,9,3,7,1,7,11,4,3,1,0,3990,4024,10
Task 3990,Job 1,9,7,4,12,1,13,21,8,4,1,2,3990,4024,7
Task 3991,Job 0,10,7,4,7,0,14,17,3,4,1,2,3991,4025,10
Task 3991,Job 1,15,8,4,6,0,19,21,2,4,4,1,3991,4025,12
Task 3992,Job 0,7,7,1,11,0,8,18,10,1,4,0,3992,4026,8
Task 3992,Job 1,12,10,3,8,1,15,20,5,3,1,2,3992,4026,19
Task 3993,Job 0,10,9,3,12,0,13,22,9,3,3,0,3993,4027,8
Task 3993,Job 1,15,9,1,10,1,16,25,9,1,4,0,3993,4027,2
Task 3994,Job 0,1,6,2,8,1,3,9,6,2,4,0,3994,4028,17
Task 3994,Job 1,6,6,1,9,1,7,15,8,1,1,1,3994,4028,16
Task 3995,Job 0,7,5,1,6,0,8,13,5,1,4,1,3995,4029,18
Task 3995,Job 1,12,4,4,9,0,16,21,5,4,3,2,3995,4029,20
Task 3996,Job 0,9,10,3,6,1,12,15,3,3,3,1,3996,4029,9
Task 3996,Job 1,14,6,1,6,0,15,20,5,1,2,1,3996,4029,12
Task 3997,Job 0,5,9,4,9,0,9,14,5,4,2,1,3997,4030,4
Task 3997,Job 1,10,5,3,7,0,13,17,4,3,3,2,3997,4030,7
Task 3998,Job 0,4,5,3,6,0,7,10,3,3,4,2,3998,4032,4
Task 3998,Job 1,9,9,3,7,0,12,16,4,3,3,0,3998,4032,6
Task 3999,Job 0,7,10,1,9,0,8,16,8,1,1,1,3999,4032,8
Task 3999,Job 1,12,9,3,11,0,15,23,8,3,2,2,3999,4032,9
Task 4000,Job 0,6,10,2,10,1,8,16,8,2,4,1,4000,4033,12
Task 4000,Job 1,11,9,3,10,0,14,21,7,3,3,1,4000,4033,17
Task 4001,Job 0,2,7,3,7,1,5,9,4,3,4,0,4001,4034,14
Task 4001,Job 1,7,6,3,9,1,10,16,6,3,2,2,4001,4034,17
Task 4002,Job 0,5,6,1,8,1,6,13,7,1,1,0,4002,4036,3
Task 4002,Job 1,10,8,1,11,0,11,21,10,1,2,1,4002,4036,19
Task 4003,Job 0,8,9,2,12,0,10,20,10,2,2,1,4003,4036,12
Task 4003,Job 1,13,10,2,6,0,15,19,4,2,1,0,4003,4036,11
Task 4004,Job 0,10,4,2,11,0,12,21,9,2,1,0,4004,4037,12
Task 4004,Job 1,15,6,2,10,1,17,25,8,2,1,0,4004,4037,7
Task 4005,Job 0,3,4,4,9,0,7,12,5,4,4,2,4005,4039,11
Task 4005,Job 1,8,5,3,8,0,11,16,5,3,1,0,4005,4039,14
Task 4006,Job 0,3,9,1,6,0,4,9,5,1,4,2,4006,4040,11
Task 4006,Job 1,8,9,2,8,0,10,16,6,2,4,1,4006,4040,17
Task 4007,Job 0,1,4,3,6,1,4,7,3,3,1,2,4007,4040,5
Task 4007,Job 1,6,8,3,10,0,9,16,7,3,1,0,4007,4040,9
Task 4008,Job 0,3,9,2,7,0,5,10,5,2,2,1,4008,4042,17
Task 4008,Job 1,8,10,1,6,0,9,14,5,1,2,2,4008,4042,15
Task 4009,Job 0,8,10,1,8,1,9,16,7,1,2,2,4009,4042,18
Task 4009,Job 1,13,7,2,6,0,15,19,4,2,1,2,4009,4042,8
Task 4010,Job 0,10,8,4,12,0,14,22,8,4,1,0,4010,4043,12
Task 4010,Job 1,15,9,2,10,0,17,25,8,2,1,0,4010,4043,20
Task 4011,Job 0,3,10,1,8,0,4,11,7,1,1,1,4011,4045,17
Task 4011,Job 1,8,8,2,12,1,10,20,10,2,3,0,4011,4045,12
Task 4012,Job 0,3,6,4,12,1,7,15,8,4,4,2,4012,4046,5
Task 4012,Job 1,8,4,4,10,0,12,18,6,4,4,0,4012,4046,4
Task 4013,Job 0,5,4,1,10,0,6,15,9,1,3,1,4013,4046,8
Task 4013,Job 1,10,9,3,11,1,13,21,8,3,2,2,4013,4046,14
Task 4014,Job 0,2,10,1,12,1,3,14,11,1,3,2,4014,4047,18
Task 4014,Job 1,7,5,3,9,0,10,16,6,3,3,2,4014,4047,18
Task 4015,Job 0,3,8,1,9,0,4,12,8,1,1,2,4015,4048,20
Task 4015,Job 1,8,10,1,8,1,9,16,7,1,4,1,4015,4048,4
Task 4016,Job 0,2,5,4,9,0,6,11,5,4,3,0,4016,4049,5
Task 4016,Job 1,7,4,3,8,1,10,15,5,3,3,1,4016,4049,15
Task 4017,Job 0,6,8,4,9,0,10,15,5,4,3,0,4017,4051,17
Task 4017,Job 1,11,7,4,6,0,15,17,2,4,3,1,4017,4051,13
Task 4018,Job 0,8,10,4,11,0,12,19,7,4,1,1,4018,4052,8
Task 4018,Job 1,13,4,4,7,1,17,20,3,4,3,2,4018,4052,12
Task 4019,Job 0,2,5,3,7,0,5,9,4,3,4,1,4019,4052,10
Task 4019,Job 1,7,8,3,6,1,10,13,3,3,2,0,4019,4052,3
Task 4020,Job 0,7,6,2,7,0,9,14,5,2,1,0,4020,4054,17
Task 4020,Job 1,12,5,3,9,0,15,21,6,3,1,2,4020,4054,11
Task 4021,Job 0,4,4,1,10,0,5,14,9,1,2,2,4021,4054,10
Task 4021,Job 1,9,9,2,10,0,11,19,8,2,3,0,4021,4054,7
Task 4022,Job 0,7,7,2,11,1,9,18,9,2,4,2,4022,4055,4
Task 4022,Job 1,12,7,2,9,1,14,21,7,2,2,0,4022,4055,20
Task 4023,Job 0,7,4,2,9,0,9,16,7,2,3,0,4023,4057,7
Task 4023,Job 1,12,10,2,8,0,14,20,6,2,3,2,4023,4057,19
Task 4024,Job 0,1,7,3,11,0,4,12,8,3,4,0,4024,4057,20
Task 4024,Job 1,6,8,4,11,0,10,17,7,4,2,0,4024,4057,13
Task 4025,Job 0,2,7,4,11,0,6,13,7,4,1,1,4025,4058,19
Task 4025,Job 1,7,4,4,12,0,11,19,8,4,3,1,4025,4058,3
Task 4026,Job 0,3,10,1,8,0,4,11,7,1,2,1,4026,4060,5
Task 4026,Job 1,8,8,2,6,0,10,14,4,2,3,2,4026,4060,5
Task 4027,Job 0,4,4,3,10,0,7,14,7,3,2,2,4027,4061,16
Task 4027,Job 1,9,10,2,6,0,11,15,4,2,3,1,4027,4061,8
Task 4028,Job 0,4,7,4,11,1,8,15,7,4,3,1,4028,4061,15
Task 4028,Job 1,9,9,3,10,0,12,19,7,3,3,2,4028,4061,6
Task 4029,Job 0,2,4,1,9,1,3,11,8,1,3,2,4029,4063,15
Task 4029,Job 1,7,8,1,7,1,8,14,6,1,1,0,4029,4063,17
Task 4030,Job 0,3,10,2,11,1,5,14,9,2,2,1,4030,4063,3
Task 4030,Job 1,8,10,2,6,0,10,14,4,2,4,2,4030,4063,19
Task 4031,Job 0,6,10,1,7,0,7,13,6,1,1,2,4031,4065,16
Task 4031,Job 1,11,10,4,10,0,15,21,6,4,4,2,4031,4065,7
Task 4032,Job 0,1,4,3,8,0,4,9,5,3,3,1,4032,4066,12
Task 4032,Job 1,6,4,1,12,0,7,18,11,1,4,1,4032,4066,12
Task 4033,Job 0,7,4,2,12,1,9,19,10,2,2,1,4033,4067,20
Task 4033,Job 1,12,8,4,6,1,16,18,2,4,2,2,4033,4067,19
Task 4034,Job 0,2,10,3,7,1,5,9,4,3,3,2,4034,4068,14
Task 4034,Job 1,7,9,3,12,0,10,19,9,3,1,1,4034,4068,15
Task 4035,Job 0,6,10,1,11,0,7,17,10,1,1,1,4035,4068,20
Task 4035,Job 1,11,4,4,6,0,15,17,2,4,2,0,4035,4068,10
Task 4036,Job 0,10,6,1,6,0,11,16,5,1,4,1,4036,4070,3
Task 4036,Job 1,15,10,3,6,0,18,21,3,3,4,1,4036,4070,16
Task 4037,Job 0,4,7,4,11,1,8,15,7,4,1,2,4037,4070,15
Task 4037,Job 1,9,8,2,8,1,11,17,6,2,1,0,4037,4070,8
Task 4038,Job 0,6,4,2,6,0,8,12,4,2,1,0,4038,4071,9
Task 4038,Job 1,11,8,4,6,0,15,17,2,4,2,2,4038,4071,7
Task 4039,Job 0,4,8,3,10,1,7,14,7,3,4,1,4039,4072,6
Task 4039,Job 1,9,10,3,8,0,12,17,5,3,4,1,4039,4072,9
Task 4040,Job 0,5,5,3,7,0,8,12,4,3,4,1,4040,4074,16
Task 4040,Job 1,10,6,3,6,0,13,16,3,3,4,0,4040,4074,8
Task 4041,Job 0,7,8,4,11,1,11,18,7,4,1,1,4041,4074,5
Task 4041,Job 1,12,8,2,8,0,14,20,6,2,3,2,4041,4074,15
Task 4042,Job 0,8,4,3,12,0,11,20,9,3,3,0,4042,4076,13
Task 4042,Job 1,13,8,3,10,0,16,23,7,3,3,0,4042,4076,9
Task 4043,Job 0,10,7,4,7,0,14,17,3,4,3,0,4043,4076,3
Task 4043,Job 1,15,10,3,12,0,18,27,9,3,3,0,4043,4076,16
Task 4044,Job 0,10,5,3,10,0,13,20,7,3,2,0,4044,4077,18
Task 4044,Job 1,15,8,3,7,0,18,22,4,3,3,1,4044,4077,10
Task 4045,Job 0,2,6,3,6,0,5,8,3,3,4,1,4045,4078,13
Task 4045,Job 1,7,7,3,9,0,10,16,6,3,3,1,4045,4078,20
Task 4046,Job 0,8,10,1,9,0,9,17,8,1,1,1,4046,4080,17
Task 4046,Job 1,13,7,2,7,1,15,20,5,2,3,2,4046,4080,11
Task 4047,Job 0,4,9,1,11,0,5,15,10,1,3,2,4047,4080,3
Task 4047,Job 1,9,6,1,6,0,10,15,5,1,2,1,4047,4080,4
Task 4048,Job 0,6,5,1,11,1,7,17,10,1,2,0,4048,4081,5
Task 4048,Job 1,11,8,3,11,1,14,22,8,3,4,0,4048,4081,9
Task 4049,Job 0,4,4,2,8,0,6,12,6,2,4,1,4049,4082,16
Task 4049,Job 1,9,4,4,8,1,13,17,4,4,4,0,4049,4082,7
Task 4050,Job 0,5,9,4,11,0,9,16,7,4,1,0,4050,4084,7
Task 4050,Job 1,10,5,2,6,1,12,16,4,2,4,0,4050,4084,7
Task 4051,Job 0,5,5,3,12,0,8,17,9,3,2,2,4051,4084,13
Task 4051,Job 1,10,9,3,11,0,13,21,8,3,1,2,4051,4084,13
Task 4052,Job 0,8,5,4,8,0,12,16,4,4,3,2,4052,4086,13
Task 4052,Job 1,13,6,3,6,0,16,19,3,3,4,2,4052,4086,4
Task 4053,Job 0,5,5,3,8,0,8,13,5,3,1,0,4053,4086,2
Task 4053,Job 1,10,9,3,10,1,13,20,7,3,4,1,4053,4086,13
Task 4054,Job 0,8,7,1,8,1,9,16,7,1,1,0,4054,4088,15
Task 4054,Job 1,13,7,3,8,0,16,21,5,3,3,2,4054,4088,2
Task 4055,Job 0,1,5,1,8,1,2,9,7,1,3,0,4055,4088,8
Task 4055,Job 1,6,8,2,8,0,8,14,6,2,2,1,4055,4088,13
Task 4056,Job 0,2,8,2,8,0,4,10,6,2,3,2,4056,4090,14
Task 4056,Job 1,7,7,1,6,0,8,13,5,1,4,1,4056,4090,3
Task 4057,Job 0,10,4,4,10,1,14,20,6,4,3,1,4057,4091,3
Task 4057,Job 1,15,6,1,12,0,16,27,11,1,2,1,4057,4091,16
Task 4058,Job 0,1,6,3,8,0,4,9,5,3,2,2,4058,4092,16
Task 4058,Job 1,6,10,3,7,0,9,13,4,3,4,0,4058,4092,9
Task 4059,Job 0,10,7,2,7,0,12,17,5,2,2,2,4059,4093,13
Task 4059,Job 1,15,4,2,12,1,17,27,10,2,1,1,4059,4093,19
Task 4060,Job 0,3,9,2,12,1,5,15,10,2,4,0,4060,4094,6
Task 4060,Job 1,8,7,3,10,1,11,18,7,3,3,0,4060,4094,4
Task 4061,Job 0,5,4,3,12,0,8,17,9,3,2,1,4061,4094,7
Task 4061,Job 1,10,6,4,6,0,14,16,2,4,2,2,4061,4094,10
Task 4062,Job 0,3,4,2,10,0,5,13,8,2,4,0,4062,4096,20
Task 4062,Job 1,8,8,3,8,0,11,16,5,3,1,2,4062,4096,13
Task 4063,Job 0,7,5,3,7,0,10,14,4,3,1,0,4063,4097,16
Task 4063,Job 1,12,4,3,12,0,15,24,9,3,2,1,4063,4097,9
Task 4064,Job 0,10,7,2,12,0,12,22,10,2,3,2,4064,4098,8
Task 4064,Job 1,15,5,4,8,0,19,23,4,4,3,0,4064,4098,3
Task 4065,Job 0,8,8,4,12,1,12,20,8,4,2,1,4065,4099,9
Task 4065,Job 1,13,5,1,8,0,14,21,7,1,2,1,4065,4099,14
Task 4066,Job 0,10,6,3,8,0,13,18,5,3,4,1,4066,4099,19
Task 4066,Job 1,15,8,2,10,0,17,25,8,2,2,0,4066,4099,18
Task 4067,Job 0,9,4,4,12,0,13,21,8,4,2,1,4067,4101,4
Task 4067,Job 1,14,10,3,12,0,17,26,9,3,4,1,4067,4101,17
Task 4068,Job 0,1,5,3,9,1,4,10,6,3,3,1,4068,4101,10
Task 4068,Job 1,6,10,2,10,0,8,16,8,2,4,0,4068,4101,14
Task 4069,Job 0,5,8,1,9,1,6,14,8,1,4,2,4069,4102,7
Task 4069,Job 1,10,8,3,10,0,13,20,7,3,4,0,4069,4102,8
Task 4070,Job 0,4,5,4,9,1,8,13,5,4,3,0,4070,4103,4
Task 4070,Job 1,9,5,2,12,0,11,21,10,2,4,1,4070,4103,9
Task 4071,Job 0,4,5,3,12,0,7,16,9,3,4,2,4071,4104,3
Task 4071,Job 1,9,6,2,6,0,11,15,4,2,3,2,4071,4104,9
Task 4072,Job 0,10,6,3,6,0,13,16,3,3,1,0,4072,4105,17
Task 4072,Job 1,15,5,3,8,1,18,23,5,3,1,0,4072,4105,3
Task 4073,Job 0,9,9,2,9,1,11,18,7,2,4,0,4073,4107,2
Task 4073,Job 1,14,10,1,8,0,15,22,7,1,4,1,4073,4107,4
Task 4074,Job 0,7,5,1,8,0,8,15,7,1,1,0,4074,4108,14
Task 4074,Job 1,12,5,2,10,0,14,22,8,2,3,1,4074,4108,16
Task 4075,Job 0,1,7,3,9,1,4,10,6,3,1,2,4075,4109,6
Task 4075,Job 1,6,10,4,11,0,10,17,7,4,3,1,4075,4109,3
Task 4076,Job 0,10,7,3,9,0,13,19,6,3,1,2,4076,4110,20
Task 4076,Job 1,15,6,4,12,0,19,27,8,4,2,2,4076,4110,14
Task 4077,Job 0,1,5,3,11,0,4,12,8,3,2,1,4077,4111,2
Task 4077,Job 1,6,7,1,11,1,7,17,10,1,1,1,4077,4111,19
Task 4078,Job 0,6,9,3,9,0,9,15,6,3,2,0,4078,4111,14
Task 4078,Job 1,11,6,3,12,0,14,23,9,3,1,0,4078,4111,15
Task 4079,Job 0,10,8,4,9,1,14,19,5,4,2,2,4079,4112,2
Task 4079,Job 1,15,5,4,11,0,19,26,7,4,2,0,4079,4112,10
Task 4080,Job 0,7,9,1,10,0,8,17,9,1,4,2,4080,4114,17
Task 4080,Job 1,12,7,4,8,0,16,20,4,4,2,1,4080,4114,3
Task 4081,Job 0,3,10,2,9,1,5,12,7,2,4,1,4081,4115,10
Task 4081,Job 1,8,7,1,6,0,9,14,5,1,2,1,4081,4115,16
Task 4082,Job 0,6,5,4,12,0,10,18,8,4,4,1,4082,4116,20
Task 4082,Job 1,11,6,3,8,0,14,19,5,3,4,1,4082,4116,13
Task 4083,Job 0,3,7,3,10,0,6,13,7,3,2,2,4083,4116,16
Task 4083,Job 1,8,9,1,11,0,9,19,10,1,1,0,4083,4116,15
Task 4084,Job 0,3,9,2,11,0,5,14,9,2,3,2,4084,4118,4
Task 4084,Job 1,8,5,1,6,0,9,14,5,1,1,2,4084,4118,5
Task 4085,Job 0,2,5,1,11,1,3,13,10,1,1,2,4085,4119,6
Task 4085,Job 1,7,8,3,9,1,10,16,6,3,3,1,4085,4119,16
Task 4086,Job 0,8,9,4,10,0,12,18,6,4,3,2,4086,4120,5
Task 4086,Job 1,13,4,3,10,0,16,23,7,3,1,0,4086,4120,5
Task 4087,Job 0,1,5,2,10,0,3,11,8,2,3,2,4087,4120,10
Task 4087,Job 1,6,9,4,10,0,10,16,6,4,3,0,4087,4120,20
Task 4088,Job 0,1,6,2,12,0,3,13,10,2,2,2,4088,4121,2
Task 4088,Job 1,6,5,2,7,0,8,13,5,2,4,2,4088,4121,4
Task 4089,Job 0,10,4,4,11,0,14,21,7,4,4,2,4089,4123,4
Task 4089,Job 1,15,7,2,10,0,17,25,8,2,3,2,4089,4123,16
Task 4090,Job 0,3,4,4,7,0,7,10,3,4,4,2,4090,4123,5
Task 4090,Job 1,8,6,2,9,0,10,17,7,2,2,1,4090,4123,13
Task 4091,Job 0,5,5,4,10,0,9,15,6,4,4,2,4091,4125,3
Task 4091,Job 1,10,7,2,9,0,12,19,7,2,2,1,4091,4125,18
Task 4092,Job 0,3,5,1,12,0,4,15,11,1,3,0,4092,4125,9
Task 4092,Job 1,8,7,4,9,0,12,17,5,4,2,1,4092,4125,6
Task 4093,Job 0,6,7,4,10,0,10,16,6,4,3,1,4093,4127,14
Task 4093,Job 1,11,5,3,10,0,14,21,7,3,4,2,4093,4127,8
Task 4094,Job 0,4,7,4,7,0,8,11,3,4,2,1,4094,4127,6
Task 4094,Job 1,9,9,2,11,0,11,20,9,2,4,0,4094,4127,18
Task 4095,Job 0,9,10,1,10,1,10,19,9,1,4,1,4095,4128,6
Task 4095,Job 1,14,8,1,10,0,15,24,9,1,2,1,4095,4128,16
Task 4096,Job 0,3,6,3,7,1,6,10,4,3,1,0,4096,4130,13
Task 4096,Job 1,8,8,1,12,1,9,20,11,1,2,2,4096,4130,20
Task 4097,Job 0,10,10,2,12,0,12,22,10,2,1,2,4097,4131,7
Task 4097,Job 1,15,9,3,12,0,18,27,9,3,2,1,4097,4131,4
Task 4098,Job 0,5,8,3,8,0,8,13,5,3,2,2,4098,4131,17
Task 4098,Job 1,10,4,1,8,0,11,18,7,1,1,2,4098,4131,4
Task 4099,Job 0,4,9,4,9,0,8,13,5,4,1,2,4099,4133,19
Task 4099,Job 1,9,6,1,9,0,10,18,8,1,4,2,4099,4133,2
Task 4100,Job 0,5,5,2,9,0,7,14,7,2,2,1,4100,4134,2
Task 4100,Job 1,10,6,1,6,0,11,16,5,1,1,2,4100,4134,18
Task 4101,Job 0,1,10,2,8,0,3,9,6,2,3,0,4101,4134,15
Task 4101,Job 1,6,9,4,7,0,10,13,3,4,2,0,4101,4134,12
Task 4102,Job 0,3,9,4,9,0,7,12,5,4,3,1,4102,4135,11
Task 4102,Job 1,8,5,1,12,0,9,20,11,1,1,1,4102,4135,7
Task 4103,Job 0,3,7,2,12,0,5,15,10,2,1,2,4103,4137,9
Task 4103,Job 1,8,6,3,12,0,11,20,9,3,3,0,4103,4137,4
Task 4104,Job 0,7,5,1,9,0,8,16,8,1,2,0,4104,4137,4
Task 4104,Job 1,12,9,1,10,0,13,22,9,1,3,1,4104,4137,7
Task 4105,Job 0,8,9,4,7,0,12,15,3,4,1,2,4105,4138,12
Task 4105,Job 1,13,9,2,8,0,15,21,6,2,2,0,4105,4138,10
Task 4106,Job 0,2,6,2,9,1,4,11,7,2,3,2,4106,4140,2
Task 4106,Job 1,7,7,4,8,0,11,15,4,4,3,2,4106,4140,11
Task 4107,Job 0,2,9,1,10,0,3,12,9,1,1,1,4107,4140,13
Task 4107,Job 1,7,9,3,10,0,10,17,7,3,4,2,4107,4140,3
Task 4108,Job 0,3,6,3,11,0,6,14,8,3,2,0,4108,4141,15
Task 4108,Job 1,8,7,4,6,0,12,14,2,4,4,2,4108,4141,9
Task 4109,Job 0,3,4,1,6,1,4,9,5,1,4,1,4109,4143,10
Task 4109,Job 1,8,5,2,7,0,10,15,5,2,3,2,4109,4143,6
Task 4110,Job 0,6,8,1,10,0,7,16,9,1,3,1,4110,4143,20
Task 4110,Job 1,11,5,2,11,0,13,22,9,2,2,0,4110,4143,2
Task 4111,Job 0,7,9,1,9,0,8,16,8,1,1,2,4111,4144,6
Task 4111,Job 1,12,4,2,6,0,14,18,4,2,3,2,4111,4144,5
Task 4112,Job 0,10,8,2,7,0,12,17,5,2,3,0,4112,4146,14
Task 4112,Job 1,15,6,1,7,0,16,22,6,1,3,1,4112,4146,5
Task 4113,Job 0,9,7,4,11,0,13,20,7,4,2,2,4113,4147,20
Task 4113,Job 1,14,7,3,7,1,17,21,4,3,4,0,4113,4147,15
Task 4114,Job 0,6,8,4,6,0,10,12,2,4,2,1,4114,4147,16
Task 4114,Job 1,11,5,4,9,0,15,20,5,4,2,2,4114,4147,17
Task 4115,Job 0,1,4,1,10,0,2,11,9,1,2,1,4115,4149,5
Task 4115,Job 1,6,8,4,11,0,10,17,7,4,3,2,4115,4149,6
Task 4116,Job 0,5,5,1,8,0,6,13,7,1,2,2,4116,4149,14
Task 4116,Job 1,10,9,2,6,1,12,16,4,2,4,0,4116,4149,16
Task 4117,Job 0,5,6,1,6,0,6,11,5,1,3,2,4117,4151,14
Task 4117,Job 1,10,8,3,9,0,13,19,6,3,1,1,4117,4151,15
Task 4118,Job 0,7,4,4,10,0,11,17,6,4,1,1,4118,4151,8
Task 4118,Job 1,12,6,1,11,0,13,23,10,1,1,1,4118,4151,15
Task 4119,Job 0,1,4,2,7,1,3,8,5,2,2,2,4119,4153,6
Task 4119,Job 1,6,8,4,9,0,10,15,5,4,1,0,4119,4153,19
Task 4120,Job 0,7,9,4,11,0,11,18,7,4,1,0,4120,4153,12
Task 4120,Job 1,12,8,2,8,0,14,20,6,2,3,0,4120,4153,5
Task 4121,Job 0,1,9,3,10,0,4,11,7,3,3,0,4121,4155,16
Task 4121,Job 1,6,5,1,9,0,7,15,8,1,3,1,4121,4155,2
Task 4122,Job 0,4,5,3,11,0,7,15,8,3,3,1,4122,4156,18
Task 4122,Job 1,9,10,4,12,1,13,21,8,4,3,1,4122,4156,10
Task 4123,Job 0,10,6,1,9,0,11,19,8,1,3,2,4123,4156,4
Task 4123,Job 1,15,10,3,9,1,18,24,6,3,1,0,4123,4156,11
Task 4124,Job 0,10,8,3,11,0,13,21,8,3,4,1,4124,4158,13
Task 4124,Job 1,15,8,1,10,0,16,25,9,1,3,2,4124,4158,18
Task 4125,Job 0,6,4,4,9,1,10,15,5,4,1,1,4125,4159,15
Task 4125,Job 1,11,9,3,11,1,14,22,8,3,3,1,4125,4159,8
Task 4126,Job 0,1,8,3,11,1,4,12,8,3,4,1,4126,4159,7
Task 4126,Job 1,6,8,4,11,1,10,17,7,4,1,2,4126,4159,12
Task 4127,Job 0,4,7,3,9,0,7,13,6,3,1,1,4127,4160,12
Task 4127,Job 1,9,4,3,8,0,12,17,5,3,3,2,4127,4160,14
Task 4128,Job 0,3,10,1,8,0,4,11,7,1,1,2,4128,4161,9
Task 4128,Job 1,8,7,2,7,0,10,15,5,2,1,0,4128,4161,4
Task 4129,Job 0,1,8,3,6,0,4,7,3,3,4,1,4129,4162,16
Task 4129,Job 1,6,8,1,12,0,7,18,11,1,1,2,4129,4162,17
Task 4130,Job 0,4,5,1,12,0,5,16,11,1,1,2,4130,4164,15
Task 4130,Job 1,9,8,2,6,0,11,15,4,2,4,1,4130,4164,3
Task 4131,Job 0,6,10,2,7,0,8,13,5,2,3,1,4131,4164,11
Task 4131,Job 1,11,7,1,10,1,12,21,9,1,2,2,4131,4164,2
Task 4132,Job 0,1,7,4,12,1,5,13,8,4,1,1,4132,4166,20
Task 4132,Job 1,6,6,3,8,0,9,14,5,3,3,1,4132,4166,14
Task 4133,Job 0,9,7,2,6,0,11,15,4,2,1,0,4133,4167,2
Task 4133,Job 1,14,6,3,7,0,17,21,4,3,1,2,4133,4167,14
Task 4134,Job 0,10,6,2,11,0,12,21,9,2,4,0,4134,4168,18
Task 4134,Job 1,15,9,2,6,0,17,21,4,2,3,1,4134,4168,16
Task 4135,Job 0,6,8,3,9,1,9,15,6,3,2,1,4135,4169,12
Task 4135,Job 1,11,4,2,10,0,13,21,8,2,1,2,4135,4169,19
Task 4136,Job 0,8,7,4,6,1,12,14,2,4,2,0,4136,4169,13
Task 4136,Job 1,13,10,2,6,0,15,19,4,2,2,0,4136,4169,11
Task 4137,Job 0,4,9,4,6,0,8,10,2,4,3,2,4137,4171,9
Task 4137,Job 1,9,6,2,6,0,11,15,4,2,1,2,4137,4171,9
Task 4138,Job 0,7,9,2,11,0,9,18,9,2,4,0,4138,4171,2
Task 4138,Job 1,12,8,3,8,0,15,20,5,3,1,2,4138,4171,3
Task 4139,Job 0,10,9,3,8,0,13,18,5,3,3,1,4139,4172,15
Task 4139,Job 1,15,5,1,11,0,16,26,10,1,3,2,4139,4172,10
Task 4140,Job 0,1,7,2,12,1,3,13,10,2,2,0,4140,4173,11
Task 4140,Job 1,6,6,2,9,0,8,15,7,2,4,1,4140,4173,17
Task 4141,Job 0,2,4,4,10,0,6,12,6,4,1,2,4141,4175,16
Task 4141,Job 1,7,10,4,12,0,11,19,8,4,1,0,4141,4175,2
Task 4142,Job 0,5,10,1,8,1,6,13,7,1,1,0,4142,4176,20
Task 4142,Job 1,10,7,3,12,0,13,22,9,3,1,1,4142,4176,4
Task 4143,Job 0,10,7,4,6,0,14,16,2,4,4,2,4143,4177,6
Task 4143,Job 1,15,8,3,12,1,18,27,9,3,3,2,4143,4177,13
Task 4144,Job 0,3,9,2,8,0,5,11,6,2,2,0,4144,4178,4
Task 4144,Job 1,8,10,2,7,0,10,15,5,2,1,2,4144,4178,7
Task 4145,Job 0,1,5,4,7,0,5,8,3,4,4,2,4145,4179,8
Task 4145,Job 1,6,4,4,8,0,10,14,4,4,2,1,4145,4179,20
Task 4146,Job 0,10,6,1,9,0,11,19,8,1,1,0,4146,4179,14
Task 4146,Job 1,15,5,1,10,0,16,25,9,1,3,1,4146,4179,5
Task 4147,Job 0,10,5,2,6,1,12,16,4,2,2,0,4147,4181,14
Task 4147,Job 1,15,4,1,7,0,16,22,6,1,1,1,4147,4181,16
Task 4148,Job 0,2,6,3,9,0,5,11,6,3,1,0,4148,4182,4
Task 4148,Job 1,7,10,1,11,0,8,18,10,1,3,0,4148,4182,3
Task 4149,Job 0,7,8,1,6,1,8,13,5,1,3,2,4149,4182,12
Task 4149,Job 1,12,8,3,12,0,15,24,9,3,2,0,4149,4182,15
Task 4150,Job 0,9,9,3,9,1,12,18,6,3,4,1,4150,4183,14
Task 4150,Job 1,14,9,1,10,1,15,24,9,1,2,1,4150,4183,16
Task 4151,Job 0,9,4,1,8,0,10,17,7,1,1,2,4151,4184,3
Task 4151,Job 1,14,4,3,7,1,17,21,4,3,2,1,4151,4184,9
Task 4152,Job 0,3,4,1,11,0,4,14,10,1,2,0,4152,4185,6
Task 4152,Job 1,8,6,2,10,0,10,18,8,2,1,1,4152,4185,4
Task 4153,Job 0,6,7,2,9,1,8,15,7,2,3,2,4153,4187,10
Task 4153,Job 1,11,7,4,7,0,15,18,3,4,4,0,4153,4187,20
Task 4154,Job 0,3,5,2,7,0,5,10,5,2,2,1,4154,4188,10
Task 4154,Job 1,8,10,2,8,1,10,16,6,2,3,0,4154,4188,3
Task 4155,Job 0,2,8,2,9,1,4,11,7,2,1,1,4155,4189,19
Task 4155,Job 1,7,8,2,8,0,9,15,6,2,4,0,4155,4189,10
Task 4156,Job 0,10,4,2,6,0,12,16,4,2,4,1,4156,4190,14
Task 4156,Job 1,15,7,3,8,0,18,23,5,3,4,0,4156,4190,15
Task 4157,Job 0,7,10,4,6,0,11,13,2,4,1,2,4157,4191,8
Task 4157,Job 1,12,8,1,7,0,13,19,6,1,1,1,4157,4191,8
Task 4158,Job 0,10,6,4,9,0,14,19,5,4,3,0,4158,4191,12
Task 4158,Job 1,15,8,1,9,0,16,24,8,1,1,0,4158,4191,15
Task 4159,Job 0,5,5,1,10,0,6,15,9,1,1,1,4159,4192,4
Task 4159,Job 1,10,9,2,8,0,12,18,6,2,1,2,4159,4192,9
Task 4160,Job 0,4,8,1,10,0,5,14,9,1,2,0,4160,4193,14
Task 4160,Job 1,9,4,1,9,0,10,18,8,1,2,1,4160,4193,11
Task 4161,Job 0,7,4,1,9,1,8,16,8,1,3,2,4161,4195,6
Task 4161,Job 1,12,4,2,11,0,14,23,9,2,4,0,4161,4195,2
Task 4162,Job 0,2,8,1,10,0,3,12,9,1,4,2,4162,4196,11
Task 4162,Job 1,7,8,3,6,0,10,13,3,3,4,0,4162,4196,12
Task 4163,Job 0,9,8,3,6,0,12,15,3,3,4,0,4163,4197,8
Task 4163,Job 1,14,10,1,8,0,15,22,7,1,4,2,4163,4197,20
Task 4164,Job 0,8,10,4,11,1,12,19,7,4,2,0,4164,4197,7
Task 4164,Job 1,13,8,2,8,0,15,21,6,2,1,0,4164,4197,16
Task 4165,Job 0,10,9,1,7,0,11,17,6,1,2,2,4165,4198,12
Task 4165,Job 1,15,7,2,12,0,17,27,10,2,1,0,4165,4198,3
Task 4166,Job 0,7,8,4,12,1,11,19,8,4,1,2,4166,4200,7
Task 4166,Job 1,12,5,1,9,0,13,21,8,1,2,1,4166,4200,15
Task 4167,Job 0,9,9,4,12,1,13,21,8,4,1,1,4167,4200,14
Task 4167,Job 1,14,6,4,9,0,18,23,5,4,3,2,4167,4200,16
Task 4168,Job 0,10,5,1,7,0,11,17,6,1,2,2,4168,4201,5
Task 4168,Job 1,15,6,2,7,0,17,22,5,2,3,2,4168,4201,10
Task 4169,Job 0,9,10,1,12,0,10,21,11,1,2,0,4169,4202,10
Task 4169,Job 1,14,7,4,8,1,18,22,4,4,3,0,4169,4202,6
Task 4170,Job 0,7,6,2,12,1,9,19,10,2,2,0,4170,4204,19
Task 4170,Job 1,12,7,3,8,0,15,20,5,3,4,1,4170,4204,15
Task 4171,Job 0,7,9,4,7,0,11,14,3,4,3,1,4171,4205,15
Task 4171,Job 1,12,10,2,11,0,14,23,9,2,2,2,4171,4205,8
Task 4172,Job 0,2,7,4,12,0,6,14,8,4,2,2,4172,4205,9
Task 4172,Job 1,7,7,4,7,0,11,14,3,4,4,2,4172,4205,13
Task 4173,Job 0,4,4,1,9,0,5,13,8,1,2,1,4173,4206,4
Task 4173,Job 1,9,4,3,11,1,12,20,8,3,1,0,4173,4206,12
Task 4174,Job 0,10,10,3,8,0,13,18,5,3,1,1,4174,4208,4
Task 4174,Job 1,15,6,4,10,0,19,25,6,4,1,1,4174,4208,11
Task 4175,Job 0,2,6,3,7,0,5,9,4,3,2,1,4175,4209,5
Task 4175,Job 1,7,4,1,9,1,8,16,8,1,4,0,4175,4209,9
Task 4176,Job 0,9,4,3,11,0,12,20,8,3,2,1,4176,4210,7
Task 4176,Job 1,14,5,4,6,0,18,20,2,4,1,1,4176,4210,16
Task 4177,Job 0,5,10,3,10,0,8,15,7,3,4,0,4177,4210,10
Task 4177,Job 1,10,7,4,9,0,14,19,5,4,4,2,4177,4210,14
Task 4178,Job 0,5,6,1,12,0,6,17,11,1,1,1,4178,4212,7
Task 4178,Job 1,10,5,2,10,0,12,20,8,2,4,2,4178,4212,5
Task 4179,Job 0,3,7,2,10,0,5,13,8,2,4,1,4179,4212,2
Task 4179,Job 1,8,8,2,11,1,10,19,9,2,2,2,4179,4212,10
Task 4180,Job 0,8,8,1,6,0,9,14,5,1,3,1,4180,4214,6
Task 4180,Job 1,13,9,4,10,0,17,23,6,4,4,1,4180,4214,18
Task 4181,Job 0,10,5,3,9,0,13,19,6,3,2,1,4181,4215,9
Task 4181,Job 1,15,6,3,7,0,18,22,4,3,3,2,4181,4215,9
Task 4182,Job 0,8,4,3,10,1,11,18,7,3,1,2,4182,4215,4
Task 4182,Job 1,13,8,4,7,0,17,20,3,4,4,1,4182,4215,3
Task 4183,Job 0,10,6,3,6,0,13,16,3,3,3,2,4183,4216,9
Task 4183,Job 1,15,9,4,6,1,19,21,2,4,4,0,4183,4216,13
Task 4184,Job 0,3,9,2,12,1,5,15,10,2,2,1,4184,4218,11
Task 4184,Job 1,8,4,2,9,0,10,17,7,2,4,0,4184,4218,9
Task 4185,Job 0,8,5,1,11,0,9,19,10,1,1,2,4185,4219,9
Task 4185,Job 1,13,8,4,12,0,17,25,8,4,3,1,4185,4219,7
Task 4186,Job 0,1,10,4,10,0,5,11,6,4,4,1,4186,4219,6
Task 4186,Job 1,6,5,1,9,0,7,15,8,1,2,1,4186,4219,19
Task 4187,Job 0,7,6,3,10,1,10,17,7,3,1,2,4187,4221,19
Task 4187,Job 1,12,9,2,11,0,14,23,9,2,1,1,4187,4221,11
Task 4188,Job 0,5,8,4,12,0,9,17,8,4,4,2,4188,4222,11
Task 4188,Job 1,10,4,1,12,0,11,22,11,1,1,2,4188,4222,4
Task 4189,Job 0,5,6,4,12,0,9,17,8,4,3,1,4189,4223,20
Task 4189,Job 1,10,10,2,9,0,12,19,7,2,2,0,4189,4223,12
Task 4190,Job 0,10,6,4,6,0,14,16,2,4,2,1,4190,4224,9
Task 4190,Job 1,15,8,4,12,0,19,27,8,4,3,1,4190,4224,16
Task 4191,Job 0,8,6,4,7,0,12,15,3,4,1,1,4191,4225,10
Task 4191,Job 1,13,8,2,11,0,15,24,9,2,1,1,4191,4225,9
Task 4192,Job 0,8,8,2,10,0,10,18,8,2,3,0,4192,4226,19
Task 4192,Job 1,13,6,2,12,0,15,25,10,2,3,0,4192,4226,16
Task 4193,Job 0,2,4,1,11,1,3,13,10,1,2,2,4193,4226,10
Task 4193,Job 1,7,9,4,8,0,11,15,4,4,2,0,4193,4226,5
Task 4194,Job 0,10,7,1,12,0,11,22,11,1,3,1,4194,4227,14
Task 4194,Job 1,15,8,4,10,0,19,25,6,4,2,1,4194,4227,3
Task 4195,Job 0,10,8,2,8,0,12,18,6,2,2,1,4195,4228,6
Task 4195,Job 1,15,4,3,6,1,18,21,3,3,1,1,4195,4228,8
Task 4196,Job 0,1,4,4,7,0,5,8,3,4,1,2,4196,4229,7
Task 4196,Job 1,6,9,4,6,0,10,12,2,4,2,0,4196,4229,14
Task 4197,Job 0,10,8,3,11,0,13,21,8,3,3,1,4197,4231,19
Task 4197,Job 1,15,7,3,9,0,18,24,6,3,4,1,4197,4231,16
Task 4198,Job 0,6,4,2,12,0,8,18,10,2,2,2,4198,4232,17
Task 4198,Job 1,11,5,1,12,0,12,23,11,1,2,0,4198,4232,9
Task 4199,Job 0,10,8,2,12,0,12,22,10,2,4,2,4199,4233,18
Task 4199,Job 1,15,7,2,11,1,17,26,9,2,4,1,4199,4233,11
Task 4200,Job 0,4,10,3,8,1,7,12,5,3,2,1,4200,4233,19
Task 4200,Job 1,9,8,2,12,0,11,21,10,2,1,0,4200,4233,13
Task 4201,Job 0,5,10,1,12,0,6,17,11,1,3,1,4201,4234,19
Task 4201,Job 1,10,10,1,11,0,11,21,10,1,2,2,4201,4234,3
Task 4202,Job 0,4,6,2,10,1,6,14,8,2,1,2,4202,4235,15
Task 4202,Job 1,9,10,1,12,0,10,21,11,1,3,1,4202,4235,9
Task 4203,Job 0,10,8,1,8,0,11,18,7,1,1,1,4203,4237,12
Task 4203,Job 1,15,8,4,7,0,19,22,3,4,2,1,4203,4237,16
Task 4204,Job 0,4,10,3,10,0,7,14,7,3,1,0,4204,4238,14
Task 4204,Job 1,9,10,2,7,0,11,16,5,2,3,0,4204,4238,2
Task 4205,Job 0,9,8,3,12,0,12,21,9,3,1,1,4205,4239,5
Task 4205,Job 1,14,4,2,12,0,16,26,10,2,4,0,4205,4239,17
Task 4206,Job 0,6,10,4,7,0,10,13,3,4,3,1,4206,4239,5
Task 4206,Job 1,11,10,4,7,1,15,18,3,4,3,0,4206,4239,12
Task 4207,Job 0,8,7,2,8,0,10,16,6,2,4,0,4207,4240,2
Task 4207,Job 1,13,9,4,10,0,17,23,6,4,1,1,4207,4240,2
Task 4208,Job 0,7,6,3,10,0,10,17,7,3,4,0,4208,4241,6
Task 4208,Job 1,12,6,4,10,1,16,22,6,4,3,2,4208,4241,13
Task 4209,Job 0,4,6,1,6,0,5,10,5,1,4,0,4209,4243,9
Task 4209,Job 1,9,9,2,12,0,11,21,10,2,2,2,4209,4243,6
Task 4210,Job 0,6,5,1,7,0,7,13,6,1,1,0,4210,4244,3
Task 4210,Job 1,11,7,4,11,0,15,22,7,4,4,2,4210,4244,10
Task 4211,Job 0,8,4,1,10,1,9,18,9,1,3,2,4211,4244,14
Task 4211,Job 1,13,8,4,6,0,17,19,2,4,4,0,4211,4244,18
Task 4212,Job 0,2,6,4,9,0,6,11,5,4,4,2,4212,4245,2
Task 4212,Job 1,7,8,2,6,0,9,13,4,2,4,2,4212,4245,6
Task 4213,Job 0,3,8,2,8,0,5,11,6,2,2,1,4213,4246,19
Task 4213,Job 1,8,8,2,8,0,10,16,6,2,3,2,4213,4246,16
Task 4214,Job 0,5,6,1,10,0,6,15,9,1,4,2,4214,4248,17
Task 4214,Job 1,10,10,4,6,1,14,16,2,4,3,2,4214,4248,13
Task 4215,Job 0,4,5,4,6,0,8,10,2,4,1,0,4215,4248,15
Task 4215,Job 1,9,6,1,12,0,10,21,11,1,4,1,4215,4248,7
Task 4216,Job 0,8,6,3,12,0,11,20,9,3,2,1,4216,4249,14
Task 4216,Job 1,13,5,2,6,1,15,19,4,2,3,0,4216,4249,13
Task 4217,Job 0,6,6,2,8,1,8,14,6,2,2,2,4217,4250,11
Task 4217,Job 1,11,5,2,11,0,13,22,9,2,1,0,4217,4250,13
Task 4218,Job 0,2,6,3,10,0,5,12,7,3,1,1,4218,4252,20
Task 4218,Job 1,7,5,1,6,0,8,13,5,1,4,0,4218,4252,11
Task 4219,Job 0,2,8,2,9,0,4,11,7,2,2,0,4219,4252,8
Task 4219,Job 1,7,6,1,9,1,8,16,8,1,4,2,4219,4252,13
Task 4220,Job 0,9,7,1,9,1,10,18,8,1,2,0,4220,4253,20
Task 4220,Job 1,14,6,4,10,1,18,24,6,4,2,0,4220,4253,12
Task 4221,Job 0,8,10,3,6,1,11,14,3,3,3,0,4221,4255,14
Task 4221,Job 1,13,7,2,6,0,15,19,4,2,1,0,4221,4255,15
Task 4222,Job 0,5,7,2,6,0,7,11,4,2,2,2,4222,4255,6
Task 4222,Job 1,10,5,3,10,0,13,20,7,3,3,2,4222,4255,16
Task 4223,Job 0,3,6,3,10,0,6,13,7,3,3,2,4223,4256,13
Task 4223,Job 1,8,4,2,6,0,10,14,4,2,2,0,4223,4256,17
Task 4224,Job 0,9,8,4,7,0,13,16,3,4,3,0,4224,4257,17
Task 4224,Job 1,14,7,4,10,0,18,24,6,4,4,0,4224,4257,5
Task 4225,Job 0,5,8,3,7,0,8,12,4,3,2,0,4225,4259,20
Task 4225,Job 1,10,9,2,11,0,12,21,9,2,4,0,4225,4259,20
Task 4226,Job 0,1,4,2,7,0,3,8,5,2,3,0,4226,4259,16
Task 4226,Job 1,6,9,4,10,0,10,16,6,4,1,2,4226,4259,14
Task 4227,Job 0,6,7,2,12,0,8,18,10,2,2,0,4227,4261,11
Task 4227,Job 1,11,10,3,8,0,14,19,5,3,1,2,4227,4261,12
Task 4228,Job 0,4,6,4,6,0,8,10,2,4,2,1,4228,4261,12
Task 4228,Job 1,9,5,3,8,0,12,17,5,3,4,1,4228,4261,19
Task 4229,Job 0,5,10,4,9,0,9,14,5,4,3,2,4229,4263,16
Task 4229,Job 1,10,10,4,10,0,14,20,6,4,2,2,4229,4263,12
Task 4230,Job 0,7,8,4,12,1,11,19,8,4,1,2,4230,4263,11
Task 4230,Job 1,12,7,2,11,0,14,23,9,2,1,0,4230,4263,12
Task 4231,Job 0,8,7,3,8,0,11,16,5,3,3,0,4231,4265,2
Task 4231,Job 1,13,8,2,12,1,15,25,10,2,4,2,4231,4265,10
Task 4232,Job 0,4,6,2,8,0,6,12,6,2,1,1,4232,4266,18
Task 4232,Job 1,9,7,1,7,0,10,16,6,1,1,2,4232,4266,4
Task 4233,Job 0,4,6,3,7,1,7,11,4,3,4,1,4233,4267,11
Task 4233,Job 1,9,5,2,8,0,11,17,6,2,1,2,4233,4267,12
Task 4234,Job 0,1,6,3,10,1,4,11,7,3,3,2,4234,4268,20
Task 4234,Job 1,6,8,4,8,0,10,14,4,4,1,0,4234,4268,7
Task 4235,Job 0,5,5,1,10,0,6,15,9,1,1,1,4235,4268,12
Task 4235,Job 1,10,7,1,6,0,11,16,5,1,4,1,4235,4268,5
Task 4236,Job 0,7,9,4,9,0,11,16,5,4,4,0,4236,4269,5
Task 4236,Job 1,12,8,1,11,0,13,23,10,1,1,2,4236,4269,19
Task 4237,Job 0,2,4,1,8,0,3,10,7,1,4,1,4237,4271,16
Task 4237,Job 1,7,7,2,11,0,9,18,9,2,3,0,4237,4271,3
Task 4238,Job 0,9,10,3,11,0,12,20,8,3,2,1,4238,4272,18
Task 4238,Job 1,14,7,4,12,0,18,26,8,4,3,1,4238,4272,9
Task 4239,Job 0,4,4,2,8,0,6,12,6,2,4,0,4239,4273,2
Task 4239,Job 1,9,4,3,8,0,12,17,5,3,2,0,4239,4273,15
Task 4240,Job 0,9,8,3,8,0,12,17,5,3,2,0,4240,4274,8
Task 4240,Job 1,14,8,1,10,0,15,24,9,1,3,2,4240,4274,11
Task 4241,Job 0,4,6,2,11,1,6,15,9,2,4,1,4241,4275,4
Task 4241,Job 1,9,6,4,8,0,13,17,4,4,4,1,4241,4275,17
Task 4242,Job 0,4,10,4,8,1,8,12,4,4,3,0,4242,4276,17
Task 4242,Job 1,9,7,2,11,1,11,20,9,2,4,1,4242,4276,16
Task 4243,Job 0,8,10,4,8,0,12,16,4,4,3,0,4243,4277,10
Task 4243,Job 1,13,9,1,12,1,14,25,11,1,2,0,4243,4277,16
Task 4244,Job 0,6,6,1,6,0,7,12,5,1,3,2,4244,4278,17
Task 4244,Job 1,11,4,4,8,0,15,19,4,4,2,0,4244,4278,20
Task 4245,Job 0,9,8,4,11,0,13,20,7,4,1,0,4245,4278,19
Task 4245,Job 1,14,9,4,9,0,18,23,5,4,4,2,4245,4278,20
Task 4246,Job 0,10,7,2,11,0,12,21,9,2,2,1,4246,4279,12
Task 4246,Job 1,15,7,1,11,0,16,26,10,1,3,0,4246,4279,11
Task 4247,Job 0,1,9,3,12,0,4,13,9,3,1,1,4247,4281,8
Task 4247,Job 1,6,10,4,6,0,10,12,2,4,3,2,4247,4281,8
Task 4248,Job 0,4,9,2,6,1,6,10,4,2,4,2,4248,4282,4
Task 4248,Job 1,9,4,2,9,0,11,18,7,2,2,2,4248,4282,4
Task 4249,Job 0,2,7,4,12,1,6,14,8,4,1,2,4249,4282,8
Task 4249,Job 1,7,7,1,10,0,8,17,9,1,3,0,4249,4282,14
Task 4250,Job 0,3,6,2,12,0,5,15,10,2,1,0,4250,4284,19
Task 4250,Job 1,8,8,2,8,0,10,16,6,2,1,0,4250,4284,16
Task 4251,Job 0,10,8,2,12,0,12,22,10,2,1,0,4251,4285,11
Task 4251,Job 1,15,6,1,11,0,16,26,10,1,2,2,4251,4285,18
Task 4252,Job 0,9,5,4,12,0,13,21,8,4,3,0,4252,4286,10
Task 4252,Job 1,14,5,4,7,0,18,21,3,4,3,0,4252,4286,9
Task 4253,Job 0,10,9,4,9,1,14,19,5,4,2,2,4253,4287,20
Task 4253,Job 1,15,6,2,11,0,17,26,9,2,3,0,4253,4287,13
Task 4254,Job 0,8,10,2,10,0,10,18,8,2,1,2,4254,4287,5
Task 4254,Job 1,13,5,4,7,0,17,20,3,4,1,2,4254,4287,12
Task 4255,Job 0,7,8,2,9,0,9,16,7,2,4,2,4255,4288,19
Task 4255,Job 1,12,8,2,9,1,14,21,7,2,3,0,4255,4288,16
Task 4256,Job 0,9,10,1,10,0,10,19,9,1,2,2,4256,4289,2
Task 4256,Job 1,14,10,4,8,0,18,22,4,4,2,0,4256,4289,12
Task 4257,Job 0,1,6,3,6,0,4,7,3,3,2,2,4257,4291,16
Task 4257,Job 1,6,4,1,6,0,7,12,5,1,4,1,4257,4291,5
Task 4258,Job 0,10,5,1,9,1,11,19,8,1,3,1,4258,4292,8
Task 4258,Job 1,15,4,2,8,0,17,23,6,2,2,1,4258,4292,12
Task 4259,Job 0,2,6,2,8,0,4,10,6,2,1,2,4259,4292,6
Task 4259,Job 1,7,8,3,11,1,10,18,8,3,4,2,4259,4292,19
Task 4260,Job 0,7,8,4,10,0,11,17,6,4,1,2,4260,4293,17
Task 4260,Job 1,12,9,3,7,0,15,19,4,3,3,2,4260,4293,2
Task 4261,Job 0,3,5,1,11,1,4,14,10,1,3,0,4261,4294,3
Task 4261,Job 1,8,10,4,6,0,12,14,2,4,4,2,4261,4294,6
Task 4262,Job 0,9,10,2,10,0,11,19,8,2,2,1,4262,4296,20
Task 4262,Job 1,14,4,4,7,0,18,21,3,4,4,0,4262,4296,5
Task 4263,Job 0,3,7,2,9,1,5,12,7,2,1,0,4263,4297,12
Task 4263,Job 1,8,4,3,10,0,11,18,7,3,1,2,4263,4297,11
Task 4264,Job 0,3,5,2,7,0,5,10,5,2,2,2,4264,4298,14
Task 4264,Job 1,8,10,4,7,0,12,15,3,4,3,0,4264,4298,17
Task 4265,Job 0,10,8,3,7,0,13,17,4,3,4,1,4265,4298,3
Task 4265,Job 1,15,7,3,6,0,18,21,3,3,2,1,4265,4298,20
Task 4266,Job 0,10,6,3,12,0,13,22,9,3,3,1,4266,4299,14
Task 4266,Job 1,15,5,1,12,0,16,27,11,1,3,2,4266,4299,5
Task 4267,Job 0,1,6,4,10,0,5,11,6,4,2,2,4267,4301,7
Task 4267,Job 1,6,7,1,9,0,7,15,8,1,2,1,4267,4301,18
Task 4268,Job 0,6,6,3,11,1,9,17,8,3,4,2,4268,4302,2
Task 4268,Job 1,11,7,4,9,1,15,20,5,4,3,0,4268,4302,14
Task 4269,Job 0,7,8,4,12,0,11,19,8,4,3,1,4269,4303,4
Task 4269,Job 1,12,9,1,11,1,13,23,10,1,3,1,4269,4303,19
Task 4270,Job 0,3,6,2,6,0,5,9,4,2,1,2,4270,4304,4
Task 4270,Job 1,8,8,2,12,0,10,20,10,2,4,0,4270,4304,18
Task 4271,Job 0,4,10,1,9,0,5,13,8,1,1,2,4271,4304,8
Task 4271,Job 1,9,10,2,11,0,11,20,9,2,1,0,4271,4304,13
Task 4272,Job 0,10,10,3,9,0,13,19,6,3,1,2,4272,4305,3
Task 4272,Job 1,15,5,1,9,0,16,24,8,1,4,2,4272,4305,11
Task 4273,Job 0,10,5,3,6,0,13,16,3,3,4,2,4273,4307,19
Task 4273,Job 1,15,9,2,7,0,17,22,5,2,3,0,4273,4307,4
Task 4274,Job 0,6,7,3,9,0,9,15,6,3,1,1,4274,4307,12
Task 4274,Job 1,11,5,2,9,1,13,20,7,2,1,2,4274,4307,11
Task 4275,Job 0,7,7,2,6,0,9,13,4,2,3,1,4275,4309,12
Task 4275,Job 1,12,10,4,10,0,16,22,6,4,4,2,4275,4309,11
Task 4276,Job 0,3,6,3,7,0,6,10,4,3,2,0,4276,4310,5
Task 4276,Job 1,8,7,4,11,0,12,19,7,4,3,1,4276,4310,11
Task 4277,Job 0,10,10,1,11,0,11,21,10,1,3,1,4277,4310,15
Task 4277,Job 1,15,9,1,11,0,16,26,10,1,2,2,4277,4310,15
Task 4278,Job 0,2,9,2,8,0,4,10,6,2,4,0,4278,4312,9
Task 4278,Job 1,7,4,2,7,0,9,14,5,2,4,2,4278,4312,9
Task 4279,Job 0,3,7,3,11,0,6,14,8,3,3,2,4279,4313,11
Task 4279,Job 1,8,9,3,12,0,11,20,9,3,2,0,4279,4313,15
Task 4280,Job 0,6,10,4,8,0,10,14,4,4,2,1,4280,4314,8
Task 4280,Job 1,11,8,3,11,0,14,22,8,3,3,0,4280,4314,20
Task 4281,Job 0,4,8,3,12,0,7,16,9,3,2,2,4281,4314,4
Task 4281,Job 1,9,9,1,12,0,10,21,11,1,2,0,4281,4314,16
Task 4282,Job 0,7,7,3,12,0,10,19,9,3,4,0,4282,4316,4
Task 4282,Job 1,12,7,2,6,1,14,18,4,2,1,0,4282,4316,3
Task 4283,Job 0,7,8,1,10,1,8,17,9,1,1,1,4283,4317,16
Task 4283,Job 1,12,4,4,6,0,16,18,2,4,4,1,4283,4317,17
Task 4284,Job 0,9,6,1,12,0,10,21,11,1,1,2,4284,4318,14
Task 4284,Job 1,14,4,3,7,1,17,21,4,3,3,0,4284,4318,18
Task 4285,Job 0,1,9,2,8,1,3,9,6,2,1,0,4285,4319,18
Task 4285,Job 1,6,10,2,8,0,8,14,6,2,1,2,4285,4319,3
Task 4286,Job 0,2,10,3,7,0,5,9,4,3,4,2,4286,4319,9
Task 4286,Job 1,7,6,4,8,0,11,15,4,4,2,1,4286,4319,7
Task 4287,Job 0,4,10,4,11,1,8,15,7,4,3,1,4287,4320,11
Task 4287,Job 1,9,8,2,11,1,11,20,9,2,4,2,4287,4320,6
Task 4288,Job 0,9,4,1,9,0,10,18,8,1,4,2,4288,4322,8
Task 4288,Job 1,14,8,2,9,0,16,23,7,2,3,2,4288,4322,15
Task 4289,Job 0,6,9,1,8,0,7,14,7,1,4,2,4289,4323,6
Task 4289,Job 1,11,5,2,7,0,13,18,5,2,2,2,4289,4323,16
Task 4290,Job 0,5,7,4,9,0,9,14,5,4,3,1,4290,4324,15
Task 4290,Job 1,10,6,4,10,0,14,20,6,4,4,1,4290,4324,15
Task 4291,Job 0,4,8,4,8,1,8,12,4,4,2,2,4291,4324,13
Task 4291,Job 1,9,7,2,6,0,11,15,4,2,4,1,4291,4324,19
Task 4292,Job 0,10,5,1,8,0,11,18,7,1,4,2,4292,4325,2
Task 4292,Job 1,15,6,3,9,0,18,24,6,3,3,1,4292,4325,14
Task 4293,Job 0,8,7,2,9,1,10,17,7,2,3,0,4293,4327,9
Task 4293,Job 1,13,9,1,8,0,14,21,7,1,2,1,4293,4327,14
Task 4294,Job 0,8,5,4,8,0,12,16,4,4,2,0,4294,4328,3
Task 4294,Job 1,13,9,1,12,0,14,25,11,1,3,0,4294,4328,2
Task 4295,Job 0,10,7,1,7,0,11,17,6,1,3,1,4295,4328,9
Task 4295,Job 1,15,4,4,7,0,19,22,3,4,3,2,4295,4328,17
Task 4296,Job 0,5,5,3,11,0,8,16,8,3,3,1,4296,4329,18
Task 4296,Job 1,10,8,3,7,0,13,17,4,3,1,2,4296,4329,7
Task 4297,Job 0,3,7,1,7,0,4,10,6,1,4,0,4297,4331,9
Task 4297,Job 1,8,10,2,10,1,10,18,8,2,1,2,4297,4331,20
Task 4298,Job 0,4,9,1,6,0,5,10,5,1,1,2,4298,4332,14
Task 4298,Job 1,9,8,4,6,0,13,15,2,4,1,1,4298,4332,5
Task 4299,Job 0,10,9,1,7,1,11,17,6,1,1,2,4299,4333,20
Task 4299,Job 1,15,9,1,9,0,16,24,8,1,4,0,4299,4333,4
Task 4300,Job 0,8,9,2,10,0,10,18,8,2,4,2,4300,4333,5
Task 4300,Job 1,13,10,4,7,1,17,20,3,4,2,1,4300,4333,10
Task 4301,Job 0,3,6,3,6,0,6,9,3,3,1,1,4301,4335,17
Task 4301,Job 1,8,9,1,9,1,9,17,8,1,3,0,4301,4335,3
Task 4302,Job 0,9,6,1,8,0,10,17,7,1,1,0,4302,4336,4
Task 4302,Job 1,14,7,4,10,0,18,24,6,4,4,2,4302,4336,11
Task 4303,Job 0,7,5,1,11,0,8,18,10,1,2,2,4303,4337,19
Task 4303,Job 1,12,8,3,6,0,15,18,3,3,4,1,4303,4337,20
Task 4304,Job 0,6,5,2,6,0,8,12,4,2,4,0,4304,4337,16
Task 4304,Job 1,11,6,3,6,1,14,17,3,3,4,2,4304,4337,8
Task 4305,Job 0,10,10,1,10,0,11,20,9,1,4,2,4305,4338,2
Task 4305,Job 1,15,5,1,12,0,16,27,11,1,3,2,4305,4338,9
Task 4306,Job 0,3,9,4,6,0,7,9,2,4,4,2,4306,4339,14
Task 4306,Job 1,8,7,1,8,0,9,16,7,1,2,1,4306,4339,18
Task 4307,Job 0,7,8,4,12,1,11,19,8,4,4,2,4307,4341,9
Task 4307,Job 1,12,10,3,10,0,15,22,7,3,2,1,4307,4341,3
Task 4308,Job 0,1,6,1,8,0,2,9,7,1,3,2,4308,4341,4
Task 4308,Job 1,6,7,2,11,0,8,17,9,2,2,1,4308,4341,11
Task 4309,Job 0,7,8,3,11,0,10,18,8,3,4,1,4309,4343,19
Task 4309,Job 1,12,10,1,6,0,13,18,5,1,3,0,4309,4343,7
Task 4310,Job 0,8,6,1,10,1,9,18,9,1,4,2,4310,4343,12
Task 4310,Job 1,13,9,4,12,0,17,25,8,4,4,2,4310,4343,15
Task 4311,Job 0,1,4,3,6,0,4,7,3,3,4,2,4311,4344,8
Task 4311,Job 1,6,10,2,6,0,8,12,4,2,1,2,4311,4344,4
Task 4312,Job 0,4,7,1,11,0,5,15,10,1,4,2,4312,4346,19
Task 4312,Job 1,9,6,2,10,0,11,19,8,2,3,0,4312,4346,4
Task 4313,Job 0,9,9,4,9,0,13,18,5,4,3,2,4313,4346,13
Task 4313,Job 1,14,8,2,11,0,16,25,9,2,2,0,4313,4346,18
Task 4314,Job 0,9,8,4,7,1,13,16,3,4,2,0,4314,4348,2
Task 4314,Job 1,14,6,4,8,1,18,22,4,4,1,2,4314,4348,17
Task 4315,Job 0,7,7,2,12,1,9,19,10,2,2,2,4315,4349,8
Task 4315,Job 1,12,8,1,8,0,13,20,7,1,2,2,4315,4349,17
Task 4316,Job 0,7,5,4,12,0,11,19,8,4,1,2,4316,4349,8
Task 4316,Job 1,12,10,4,11,0,16,23,7,4,2,2,4316,4349,17
Task 4317,Job 0,4,9,3,6,0,7,10,3,3,4,1,4317,4351,8
Task 4317,Job 1,9,8,4,10,0,13,19,6,4,2,1,4317,4351,17
Task 4318,Job 0,9,7,1,6,0,10,15,5,1,4,0,4318,4352,10
Task 4318,Job 1,14,5,4,9,0,18,23,5,4,3,2,4318,4352,17
Task 4319,Job 0,1,4,1,7,0,2,8,6,1,2,1,4319,4352,5
Task 4319,Job 1,6,5,3,8,0,9,14,5,3,2,2,4319,4352,12
Task 4320,Job 0,3,4,1,12,1,4,15,11,1,1,2,4320,4354,15
Task 4320,Job 1,8,10,1,9,0,9,17,8,1,1,2,4320,4354,19
Task 4321,Job 0,1,8,3,6,0,4,7,3,3,2,0,4321,4355,4
Task 4321,Job 1,6,5,1,8,0,7,14,7,1,3,2,4321,4355,17
Task 4322,Job 0,8,6,4,7,0,12,15,3,4,1,1,4322,4355,13
Task 4322,Job 1,13,8,2,10,1,15,23,8,2,3,1,4322,4355,4
Task 4323,Job 0,9,9,1,11,1,10,20,10,1,4,2,4323,4356,14
Task 4323,Job 1,14,8,1,11,0,15,25,10,1,3,2,4323,4356,6
Task 4324,Job 0,5,4,2,10,0,7,15,8,2,3,1,4324,4358,11
Task 4324,Job 1,10,7,3,10,0,13,20,7,3,3,1,4324,4358,5
Task 4325,Job 0,9,8,1,12,0,10,21,11,1,1,2,4325,4359,5
Task 4325,Job 1,14,8,1,10,1,15,24,9,1,4,2,4325,4359,14
Task 4326,Job 0,1,5,2,8,0,3,9,6,2,3,2,4326,4359,10
Task 4326,Job 1,6,4,4,12,1,10,18,8,4,4,1,4326,4359,4
Task 4327,Job 0,9,8,2,9,0,11,18,7,2,1,1,4327,4360,11
Task 4327,Job 1,14,7,3,9,1,17,23,6,3,3,2,4327,4360,20
Task 4328,Job 0,7,4,3,9,1,10,16,6,3,4,0,4328,4361,13
Task 4328,Job 1,12,4,1,8,0,13,20,7,1,1,1,4328,4361,11
Task 4329,Job 0,1,9,3,7,0,4,8,4,3,1,0,4329,4363,5
Task 4329,Job 1,6,7,4,12,0,10,18,8,4,3,1,4329,4363,16
Task 4330,Job 0,5,6,2,10,0,7,15,8,2,4,0,4330,4363,11
Task 4330,Job 1,10,5,1,10,1,11,20,9,1,4,1,4330,4363,14
Task 4331,Job 0,9,4,4,12,0,13,21,8,4,3,0,4331,4364,8
Task 4331,Job 1,14,6,4,8,0,18,22,4,4,3,2,4331,4364,17
Task 4332,Job 0,9,7,3,10,1,12,19,7,3,4,0,4332,4366,7
Task 4332,Job 1,14,4,4,7,0,18,21,3,4,2,0,4332,4366,5
Task 4333,Job 0,10,7,1,9,1,11,19,8,1,3,0,4333,4366,12
Task 4333,Job 1,15,5,4,8,0,19,23,4,4,2,0,4333,4366,8
Task 4334,Job 0,3,10,4,10,0,7,13,6,4,1,2,4334,4367,6
Task 4334,Job 1,8,9,3,11,0,11,19,8,3,4,1,4334,4367,10
Task 4335,Job 0,1,5,2,8,0,3,9,6,2,1,1,4335,4369,5
Task 4335,Job 1,6,10,1,11,0,7,17,10,1,1,1,4335,4369,18
Task 4336,Job 0,10,10,2,7,1,12,17,5,2,4,0,4336,4369,16
Task 4336,Job 1,15,7,1,8,0,16,23,7,1,4,2,4336,4369,4
Task 4337,Job 0,1,8,4,11,0,5,12,7,4,3,2,4337,4370,2
Task 4337,Job 1,6,7,3,6,0,9,12,3,3,4,1,4337,4370,6
Task 4338,Job 0,8,5,1,10,0,9,18,9,1,2,2,4338,4371,13
Task 4338,Job 1,13,9,3,9,0,16,22,6,3,2,1,4338,4371,4
Task 4339,Job 0,10,7,3,9,0,13,19,6,3,1,0,4339,4373,2
Task 4339,Job 1,15,10,4,11,0,19,26,7,4,1,2,4339,4373,7
Task 4340,Job 0,8,8,1,11,1,9,19,10,1,3,2,4340,4374,14
Task 4340,Job 1,13,8,1,12,0,14,25,11,1,1,0,4340,4374,19
Task 4341,Job 0,10,7,4,6,0,14,16,2,4,3,2,4341,4374,7
Task 4341,Job 1,15,10,4,10,1,19,25,6,4,4,0,4341,4374,16
Task 4342,Job 0,2,5,4,6,1,6,8,2,4,2,1,4342,4376,18
Task 4342,Job 1,7,7,4,12,0,11,19,8,4,2,1,4342,4376,20
Task 4343,Job 0,9,7,4,8,0,13,17,4,4,3,1,4343,4376,2
Task 4343,Job 1,14,9,2,12,0,16,26,10,2,1,2,4343,4376,20
Task 4344,Job 0,6,7,1,12,0,7,18,11,1,3,0,4344,4378,14
Task 4344,Job 1,11,9,3,7,0,14,18,4,3,1,2,4344,4378,2
Task 4345,Job 0,6,10,3,8,1,9,14,5,3,2,1,4345,4379,17
Task 4345,Job 1,11,10,3,10,1,14,21,7,3,1,0,4345,4379,20
Task 4346,Job 0,10,9,3,9,0,13,19,6,3,3,0,4346,4379,12
Task 4346,Job 1,15,10,2,10,0,17,25,8,2,3,0,4346,4379,18
Task 4347,Job 0,8,10,2,12,0,10,20,10,2,2,1,4347,4380,13
Task 4347,Job 1,13,5,1,6,0,14,19,5,1,4,1,4347,4380,13
Task 4348,Job 0,6,4,2,9,0,8,15,7,2,3,1,4348,4381,9
Task 4348,Job 1,11,4,1,10,0,12,21,9,1,1,1,4348,4381,15
Task 4349,Job 0,4,10,4,11,0,8,15,7,4,3,0,4349,4383,5
Task 4349,Job 1,9,9,1,11,1,10,20,10,1,1,0,4349,4383,10
Task 4350,Job 0,4,7,4,11,0,8,15,7,4,2,1,4350,4383,8
Task 4350,Job 1,9,10,4,8,1,13,17,4,4,1,1,4350,4383,7
Task 4351,Job 0,10,9,4,6,1,14,16,2,4,2,2,4351,4385,20
Task 4351,Job 1,15,6,2,8,0,17,23,6,2,1,2,4351,4385,9
Task 4352,Job 0,7,6,3,11,0,10,18,8,3,1,1,4352,4385,12
Task 4352,Job 1,12,5,2,8,1,14,20,6,2,1,0,4352,4385,4
Task 4353,Job 0,3,10,2,11,0,5,14,9,2,3,0,4353,4387,4
Task 4353,Job 1,8,8,4,6,0,12,14,2,4,2,0,4353,4387,10
Task 4354,Job 0,4,8,2,6,1,6,10,4,2,1,0,4354,4388,13
Task 4354,Job 1,9,6,2,7,1,11,16,5,2,3,0,4354,4388,11
Task 4355,Job 0,2,7,4,6,0,6,8,2,4,3,2,4355,4389,16
Task 4355,Job 1,7,7,2,7,0,9,14,5,2,2,1,4355,4389,6
Task 4356,Job 0,1,8,1,12,0,2,13,11,1,2,1,4356,4390,2
Task 4356,Job 1,6,10,4,10,0,10,16,6,4,1,0,4356,4390,10
Task 4357,Job 0,5,6,2,8,0,7,13,6,2,4,1,4357,4390,18
Task 4357,Job 1,10,4,3,11,1,13,21,8,3,2,2,4357,4390,10
Task 4358,Job 0,3,9,2,10,0,5,13,8,2,3,2,4358,4391,13
Task 4358,Job 1,8,5,4,11,1,12,19,7,4,1,1,4358,4391,13
Task 4359,Job 0,9,5,3,6,0,12,15,3,3,1,0,4359,4393,17
Task 4359,Job 1,14,6,4,8,0,18,22,4,4,2,1,4359,4393,9
Task 4360,Job 0,5,8,3,8,0,8,13,5,3,2,2,4360,4393,17
Task 4360,Job 1,10,10,4,10,0,14,20,6,4,1,1,4360,4393,19
Task 4361,Job 0,1,8,2,10,0,3,11,8,2,1,1,4361,4395,2
Task 4361,Job 1,6,10,3,10,0,9,16,7,3,3,2,4361,4395,5
Task 4362,Job 0,8,5,2,7,1,10,15,5,2,2,2,4362,4396,3
Task 4362,Job 1,13,8,4,10,0,17,23,6,4,3,1,4362,4396,14
Task 4363,Job 0,3,8,3,11,0,6,14,8,3,1,0,4363,4397,7
Task 4363,Job 1,8,6,3,6,1,11,14,3,3,3,1,4363,4397,19
Task 4364,Job 0,5,5,3,11,0,8,16,8,3,3,1,4364,4397,6
Task 4364,Job 1,10,9,2,12,0,12,22,10,2,3,1,4364,4397,13
Task 4365,Job 0,2,9,2,11,0,4,13,9,2,3,1,4365,4398,12
Task 4365,Job 1,7,8,3,8,0,10,15,5,3,3,0,4365,4398,18
Task 4366,Job 0,2,4,2,8,1,4,10,6,2,4,2,4366,4399,11
Task 4366,Job 1,7,8,4,12,0,11,19,8,4,2,2,4366,4399,5
Task 4367,Job 0,5,7,2,9,0,7,14,7,2,1,2,4367,4400,4
Task 4367,Job 1,10,5,2,10,0,12,20,8,2,1,2,4367,4400,7
Task 4368,Job 0,1,9,4,11,0,5,12,7,4,4,0,4368,4402,19
Task 4368,Job 1,6,10,2,8,0,8,14,6,2,2,0,4368,4402,11
Task 4369,Job 0,9,6,4,7,0,13,16,3,4,4,2,4369,4402,19
Task 4369,Job 1,14,9,2,7,0,16,21,5,2,3,2,4369,4402,20
Task 4370,Job 0,3,6,3,9,0,6,12,6,3,4,0,4370,4403,17
Task 4370,Job 1,8,4,4,9,0,12,17,5,4,3,0,4370,4403,12
Task 4371,Job 0,10,6,4,12,0,14,22,8,4,1,1,4371,4404,4
Task 4371,Job 1,15,10,1,8,0,16,23,7,1,1,1,4371,4404,5
Task 4372,Job 0,6,5,2,8,0,8,14,6,2,1,2,4372,4406,5
Task 4372,Job 1,11,6,1,12,0,12,23,11,1,4,1,4372,4406,18
Task 4373,Job 0,5,6,4,7,0,9,12,3,4,4,1,4373,4407,11
Task 4373,Job 1,10,5,4,10,0,14,20,6,4,4,1,4373,4407,4
Task 4374,Job 0,6,10,2,11,0,8,17,9,2,3,2,4374,4408,8
Task 4374,Job 1,11,6,1,9,0,12,20,8,1,3,2,4374,4408,10
Task 4375,Job 0,4,10,4,12,0,8,16,8,4,4,1,4375,4409,16
Task 4375,Job 1,9,9,4,11,1,13,20,7,4,3,0,4375,4409,16
Task 4376,Job 0,8,8,2,11,0,10,19,9,2,3,2,4376,4409,7
Task 4376,Job 1,13,6,2,12,0,15,25,10,2,4,1,4376,4409,17
Task 4377,Job 0,3,6,4,11,0,7,14,7,4,1,1,4377,4410,6
Task 4377,Job 1,8,4,1,10,0,9,18,9,1,1,2,4377,4410,16
Task 4378,Job 0,8,4,3,10,0,11,18,7,3,3,0,4378,4411,19
Task 4378,Job 1,13,5,2,6,0,15,19,4,2,1,1,4378,4411,6
Task 4379,Job 0,4,6,3,7,0,7,11,4,3,1,2,4379,4413,15
Task 4379,Job 1,9,8,3,11,0,12,20,8,3,4,0,4379,4413,8
Task 4380,Job 0,8,9,3,6,0,11,14,3,3,3,0,4380,4413,15
Task 4380,Job 1,13,7,4,10,0,17,23,6,4,4,0,4380,4413,15
Task 4381,Job 0,8,4,4,7,0,12,15,3,4,4,0,4381,4415,9
Task 4381,Job 1,13,8,2,9,0,15,22,7,2,3,1,4381,4415,3
Task 4382,Job 0,1,5,4,7,1,5,8,3,4,4,2,4382,4415,14
Task 4382,Job 1,6,9,1,9,0,7,15,8,1,1,2,4382,4415,5
Task 4383,Job 0,9,5,4,12,0,13,21,8,4,2,1,4383,4416,9
Task 4383,Job 1,14,5,3,9,0,17,23,6,3,4,2,4383,4416,3
Task 4384,Job 0,4,5,2,10,0,6,14,8,2,1,1,4384,4418,11
Task 4384,Job 1,9,7,3,11,1,12,20,8,3,1,2,4384,4418,20
Task 4385,Job 0,1,9,2,9,0,3,10,7,2,3,2,4385,4418,15
Task 4385,Job 1,6,9,4,7,0,10,13,3,4,4,1,4385,4418,20
Task 4386,Job 0,2,4,4,9,1,6,11,5,4,3,0,4386,4420,7
Task 4386,Job 1,7,9,1,8,1,8,15,7,1,3,1,4386,4420,12
Task 4387,Job 0,3,9,1,7,0,4,10,6,1,4,2,4387,4420,4
Task 4387,Job 1,8,4,3,8,1,11,16,5,3,1,0,4387,4420,15
Task 4388,Job 0,5,9,3,9,0,8,14,6,3,2,0,4388,4422,15
Task 4388,Job 1,10,9,4,8,0,14,18,4,4,3,1,4388,4422,8
Task 4389,Job 0,6,4,4,12,0,10,18,8,4,3,2,4389,4423,18
Task 4389,Job 1,11,8,4,9,0,15,20,5,4,3,2,4389,4423,7
Task 4390,Job 0,7,8,1,8,0,8,15,7,1,4,0,4390,4423,16
Task 4390,Job 1,12,7,2,6,0,14,18,4,2,4,0,4390,4423,6
Task 4391,Job 0,2,9,3,10,0,5,12,7,3,3,1,4391,4424,6
Task 4391,Job 1,7,6,4,7,1,11,14,3,4,3,2,4391,4424,10
Task 4392,Job 0,1,5,1,7,0,2,8,6,1,1,1,4392,4425,16
Task 4392,Job 1,6,7,4,6,0,10,12,2,4,3,1,4392,4425,13
Task 4393,Job 0,6,8,2,9,0,8,15,7,2,3,0,4393,4426,20
Task 4393,Job 1,11,8,2,12,0,13,23,10,2,1,2,4393,4426,6
Task 4394,Job 0,6,9,1,10,0,7,16,9,1,4,1,4394,4427,15
Task 4394,Job 1,11,6,1,8,0,12,19,7,1,4,0,4394,4427,18
Task 4395,Job 0,2,5,2,10,0,4,12,8,2,1,1,4395,4428,15
Task 4395,Job 1,7,5,4,9,1,11,16,5,4,4,2,4395,4428,2
Task 4396,Job 0,9,9,4,12,0,13,21,8,4,4,1,4396,4429,17
Task 4396,Job 1,14,5,3,11,1,17,25,8,3,3,0,4396,4429,8
Task 4397,Job 0,8,5,2,7,0,10,15,5,2,3,2,4397,4430,20
Task 4397,Job 1,13,8,2,6,0,15,19,4,2,1,0,4397,4430,13
Task 4398,Job 0,2,7,4,11,1,6,13,7,4,4,2,4398,4432,18
Task 4398,Job 1,7,8,4,10,0,11,17,6,4,4,1,4398,4432,14
Task 4399,Job 0,9,8,3,7,0,12,16,4,3,4,1,4399,4433,7
Task 4399,Job 1,14,9,1,11,0,15,25,10,1,2,2,4399,4433,2
Task 4400,Job 0,5,8,4,8,0,9,13,4,4,4,1,4400,4434,6
Task 4400,Job 1,10,7,1,11,0,11,21,10,1,3,2,4400,4434,14
Task 4401,Job 0,5,4,3,6,0,8,11,3,3,2,2,4401,4435,4
Task 4401,Job 1,10,8,3,9,1,13,19,6,3,4,0,4401,4435,12
Task 4402,Job 0,9,6,4,9,1,13,18,5,4,3,0,4402,4435,9
Task 4402,Job 1,14,8,4,7,0,18,21,3,4,4,0,4402,4435,20
Task 4403,Job 0,2,6,3,9,1,5,11,6,3,1,1,4403,4436,13
Task 4403,Job 1,7,5,1,8,0,8,15,7,1,2,1,4403,4436,11
Task 4404,Job 0,6,4,2,12,0,8,18,10,2,4,2,4404,4437,16
Task 4404,Job 1,11,4,3,6,1,14,17,3,3,3,2,4404,4437,3
Task 4405,Job 0,2,9,1,11,0,3,13,10,1,2,2,4405,4438,7
Task 4405,Job 1,7,7,1,10,1,8,17,9,1,1,2,4405,4438,18
Task 4406,Job 0,7,4,3,8,0,10,15,5,3,3,1,4406,4439,15
Task 4406,Job 1,12,4,1,8,0,13,20,7,1,3,1,4406,4439,15
Task 4407,Job 0,1,9,1,12,1,2,13,11,1,4,2,4407,4440,13
Task 4407,Job 1,6,5,4,12,1,10,18,8,4,4,0,4407,4440,15
Task 4408,Job 0,6,10,3,10,0,9,16,7,3,1,0,4408,4441,6
Task 4408,Job 1,11,9,1,9,0,12,20,8,1,2,1,4408,4441,4
Task 4409,Job 0,4,9,2,7,0,6,11,5,2,2,0,4409,4443,7
Task 4409,Job 1,9,8,3,9,0,12,18,6,3,2,1,4409,4443,5
Task 4410,Job 0,2,10,2,10,0,4,12,8,2,2,0,4410,4444,19
Task 4410,Job 1,7,5,4,6,0,11,13,2,4,2,0,4410,4444,17
Task 4411,Job 0,5,5,3,8,0,8,13,5,3,4,1,4411,4444,11
Task 4411,Job 1,10,8,1,7,0,11,17,6,1,2,2,4411,4444,16
Task 4412,Job 0,8,7,1,7,0,9,15,6,1,1,2,4412,4445,11
Task 4412,Job 1,13,8,4,12,0,17,25,8,4,1,2,4412,4445,2
Task 4413,Job 0,1,9,4,6,0,5,7,2,4,4,0,4413,4446,8
Task 4413,Job 1,6,6,2,6,1,8,12,4,2,3,0,4413,4446,4
Task 4414,Job 0,6,8,4,10,0,10,16,6,4,2,1,4414,4447,3
Task 4414,Job 1,11,6,2,6,0,13,17,4,2,3,0,4414,4447,20
Task 4415,Job 0,8,9,4,12,1,12,20,8,4,2,1,4415,4449,2
Task 4415,Job 1,13,6,2,10,0,15,23,8,2,2,2,4415,4449,6
Task 4416,Job 0,3,8,1,7,0,4,10,6,1,1,1,4416,4449,14
Task 4416,Job 1,8,10,1,6,0,9,14,5,1,3,0,4416,4449,14
Task 4417,Job 0,3,8,1,12,0,4,15,11,1,2,2,4417,4450,5
Task 4417,Job 1,8,10,2,8,1,10,16,6,2,2,1,4417,4450,13
Task 4418,Job 0,1,9,2,6,1,3,7,4,2,2,2,4418,4452,14
Task 4418,Job 1,6,8,1,10,0,7,16,9,1,4,2,4418,4452,17
Task 4419,Job 0,2,6,4,9,0,6,11,5,4,4,1,4419,4453,18
Task 4419,Job 1,7,7,1,10,0,8,17,9,1,4,2,4419,4453,20
Task 4420,Job 0,2,6,3,8,0,5,10,5,3,1,1,4420,4453,11
Task 4420,Job 1,7,5,1,8,0,8,15,7,1,1,0,4420,4453,2
Task 4421,Job 0,2,6,4,6,0,6,8,2,4,2,1,4421,4454,8
Task 4421,Job 1,7,4,1,7,0,8,14,6,1,2,0,4421,4454,13
Task 4422,Job 0,3,9,1,8,0,4,11,7,1,3,0,4422,4456,20
Task 4422,Job 1,8,5,2,10,0,10,18,8,2,3,0,4422,4456,16
Task 4423,Job 0,3,5,4,9,0,7,12,5,4,4,1,4423,4456,14
Task 4423,Job 1,8,9,2,8,0,10,16,6,2,3,2,4423,4456,16
Task 4424,Job 0,10,9,1,6,0,11,16,5,1,4,2,4424,4458,10
Task 4424,Job 1,15,8,2,8,0,17,23,6,2,1,0,4424,4458,8
Task 4425,Job 0,9,9,2,10,0,11,19,8,2,2,2,4425,4459,5
Task 4425,Job 1,14,5,3,12,0,17,26,9,3,4,0,4425,4459,11
Task 4426,Job 0,3,6,2,9,0,5,12,7,2,1,1,4426,4460,4
Task 4426,Job 1,8,5,2,8,1,10,16,6,2,2,0,4426,4460,5
Task 4427,Job 0,5,7,2,9,0,7,14,7,2,4,0,4427,4461,17
Task 4427,Job 1,10,10,1,7,1,11,17,6,1,4,2,4427,4461,15
Task 4428,Job 0,5,5,1,10,0,6,15,9,1,3,1,4428,4462,17
Task 4428,Job 1,10,10,1,8,0,11,18,7,1,4,2,4428,4462,14
Task 4429,Job 0,8,9,2,7,1,10,15,5,2,4,1,4429,4463,6
Task 4429,Job 1,13,8,2,6,0,15,19,4,2,2,0,4429,4463,5
Task 4430,Job 0,10,6,3,11,0,13,21,8,3,4,1,4430,4464,13
Task 4430,Job 1,15,4,1,9,0,16,24,8,1,3,1,4430,4464,19
Task 4431,Job 0,2,6,4,9,0,6,11,5,4,2,0,4431,4465,11
Task 4431,Job 1,7,9,1,9,0,8,16,8,1,3,2,4431,4465,4
Task 4432,Job 0,1,6,1,7,0,2,8,6,1,4,0,4432,4465,2
Task 4432,Job 1,6,9,2,12,1,8,18,10,2,1,2,4432,4465,14
Task 4433,Job 0,8,8,4,6,0,12,14,2,4,2,2,4433,4467,3
Task 4433,Job 1,13,6,3,10,0,16,23,7,3,3,2,4433,4467,7
Task 4434,Job 0,5,8,1,9,0,6,14,8,1,2,1,4434,4468,18
Task 4434,Job 1,10,7,3,7,0,13,17,4,3,2,1,4434,4468,7
Task 4435,Job 0,6,6,2,6,0,8,12,4,2,4,0,4435,4469,13
Task 4435,Job 1,11,9,3,12,0,14,23,9,3,1,0,4435,4469,8
Task 4436,Job 0,4,4,4,9,0,8,13,5,4,1,2,4436,4469,8
Task 4436,Job 1,9,6,4,7,0,13,16,3,4,3,1,4436,4469,6
Task 4437,Job 0,10,7,1,12,1,11,22,11,1,4,1,4437,4470,19
Task 4437,Job 1,15,7,3,6,1,18,21,3,3,2,0,4437,4470,18
Task 4438,Job 0,4,8,3,12,0,7,16,9,3,4,0,4438,4471,19
Task 4438,Job 1,9,5,1,8,0,10,17,7,1,4,1,4438,4471,11
Task 4439,Job 0,3,7,2,10,0,5,13,8,2,4,0,4439,4472,3
Task 4439,Job 1,8,8,4,10,1,12,18,6,4,2,0,4439,4472,13
Task 4440,Job 0,2,7,4,10,0,6,12,6,4,2,2,4440,4474,3
Task 4440,Job 1,7,6,2,6,0,9,13,4,2,3,1,4440,4474,13
Task 4441,Job 0,6,4,3,8,0,9,14,5,3,3,1,4441,4474,18
Task 4441,Job 1,11,4,3,7,0,14,18,4,3,4,1,4441,4474,6
Task 4442,Job 0,7,8,2,12,1,9,19,10,2,2,1,4442,4476,7
Task 4442,Job 1,12,6,2,8,0,14,20,6,2,1,2,4442,4476,11
Task 4443,Job 0,8,5,3,10,0,11,18,7,3,4,2,4443,4476,11
Task 4443,Job 1,13,9,1,6,1,14,19,5,1,2,2,4443,4476,5
Task 4444,Job 0,1,4,1,12,0,2,13,11,1,4,2,4444,4477,10
Task 4444,Job 1,6,4,1,6,0,7,12,5,1,4,1,4444,4477,15
Task 4445,Job 0,10,9,2,12,0,12,22,10,2,4,1,4445,4478,15
Task 4445,Job 1,15,7,4,8,0,19,23,4,4,1,1,4445,4478,2
Task 4446,Job 0,7,4,1,11,0,8,18,10,1,3,0,4446,4479,18
Task 4446,Job 1,12,10,1,11,1,13,23,10,1,1,0,4446,4479,19
Task 4447,Job 0,4,4,1,11,0,5,15,10,1,3,0,4447,4481,19
Task 4447,Job 1,9,8,1,10,1,10,19,9,1,2,0,4447,4481,18
Task 4448,Job 0,1,7,4,7,0,5,8,3,4,2,1,4448,4482,7
Task 4448,Job 1,6,9,3,12,0,9,18,9,3,3,1,4448,4482,18
Task 4449,Job 0,6,9,2,12,1,8,18,10,2,1,1,4449,4483,7
Task 4449,Job 1,11,6,2,7,0,13,18,5,2,4,0,4449,4483,14
Task 4450,Job 0,3,5,2,9,0,5,12,7,2,1,2,4450,4484,5
Task 4450,Job 1,8,4,3,9,0,11,17,6,3,4,0,4450,4484,8
Task 4451,Job 0,4,8,4,8,0,8,12,4,4,4,2,4451,4484,13
Task 4451,Job 1,9,9,1,9,0,10,18,8,1,3,1,4451,4484,19
Task 4452,Job 0,2,10,3,6,0,5,8,3,3,2,1,4452,4485,9
Task 4452,Job 1,7,8,2,11,0,9,18,9,2,4,2,4452,4485,8
Task 4453,Job 0,1,4,2,7,1,3,8,5,2,1,0,4453,4486,20
Task 4453,Job 1,6,10,3,6,1,9,12,3,3,2,2,4453,4486,12
Task 4454,Job 0,3,6,3,6,0,6,9,3,3,3,0,4454,4487,11
Task 4454,Job 1,8,7,3,6,0,11,14,3,3,3,1,4454,4487,19
Task 4455,Job 0,2,5,1,9,1,3,11,8,1,3,1,4455,4489,19
Task 4455,Job 1,7,7,3,12,0,10,19,9,3,1,1,4455,4489,15
Task 4456,Job 0,8,9,4,10,0,12,18,6,4,2,2,4456,4490,12
Task 4456,Job 1,13,6,2,7,0,15,20,5,2,2,0,4456,4490,4
Task 4457,Job 0,6,9,3,6,1,9,12,3,3,2,2,4457,4490,11
Task 4457,Job 1,11,9,2,9,0,13,20,7,2,1,2,4457,4490,2
Task 4458,Job 0,10,5,4,6,0,14,16,2,4,3,2,4458,4492,2
Task 4458,Job 1,15,5,3,7,1,18,22,4,3,4,1,4458,4492,13
Task 4459,Job 0,2,9,2,10,0,4,12,8,2,1,2,4459,4493,3
Task 4459,Job 1,7,5,4,8,0,11,15,4,4,2,2,4459,4493,20
Task 4460,Job 0,1,9,3,10,0,4,11,7,3,2,1,4460,4494,6
Task 4460,Job 1,6,8,4,9,0,10,15,5,4,4,2,4460,4494,3
Task 4461,Job 0,6,9,1,9,0,7,15,8,1,1,2,4461,4495,10
Task 4461,Job 1,11,5,4,8,0,15,19,4,4,2,0,4461,4495,4
Task 4462,Job 0,2,6,2,9,1,4,11,7,2,4,0,4462,4496,11
Task 4462,Job 1,7,5,4,10,0,11,17,6,4,4,2,4462,4496,13
Task 4463,Job 0,9,6,2,9,1,11,18,7,2,4,2,4463,4497,11
Task 4463,Job 1,14,7,1,6,0,15,20,5,1,3,0,4463,4497,11
Task 4464,Job 0,5,9,1,12,0,6,17,11,1,3,2,4464,4498,7
Task 4464,Job 1,10,4,4,7,1,14,17,3,4,2,0,4464,4498,8
Task 4465,Job 0,8,8,1,8,1,9,16,7,1,1,2,4465,4498,7
Task 4465,Job 1,13,8,1,11,0,14,24,10,1,1,2,4465,4498,11
Task 4466,Job 0,9,7,4,11,0,13,20,7,4,2,0,4466,4499,9
Task 4466,Job 1,14,10,4,10,0,18,24,6,4,4,2,4466,4499,12
Task 4467,Job 0,6,4,1,7,0,7,13,6,1,1,2,4467,4500,4
Task 4467,Job 1,11,4,1,8,0,12,19,7,1,4,1,4467,4500,4
Task 4468,Job 0,9,8,1,8,1,10,17,7,1,4,0,4468,4501,13
Task 4468,Job 1,14,10,2,10,0,16,24,8,2,1,2,4468,4501,13
Task 4469,Job 0,4,10,1,10,0,5,14,9,1,1,2,4469,4503,6
Task 4469,Job 1,9,8,2,8,1,11,17,6,2,1,2,4469,4503,19
Task 4470,Job 0,1,5,1,10,0,2,11,9,1,3,0,4470,4503,19
Task 4470,Job 1,6,10,2,9,0,8,15,7,2,4,1,4470,4503,11
Task 4471,Job 0,3,4,1,7,0,4,10,6,1,1,0,4471,4505,12
Task 4471,Job 1,8,7,2,12,0,10,20,10,2,1,0,4471,4505,8
Task 4472,Job 0,2,7,2,12,0,4,14,10,2,3,2,4472,4506,11
Task 4472,Job 1,7,8,4,7,0,11,14,3,4,2,0,4472,4506,20
Task 4473,Job 0,5,9,4,12,0,9,17,8,4,4,2,4473,4507,9
Task 4473,Job 1,10,4,2,11,1,12,21,9,2,2,2,4473,4507,17
Task 4474,Job 0,10,5,1,12,0,11,22,11,1,1,0,4474,4507,20
Task 4474,Job 1,15,10,1,9,0,16,24,8,1,3,1,4474,4507,6
Task 4475,Job 0,7,5,4,8,0,11,15,4,4,2,2,4475,4508,9
Task 4475,Job 1,12,7,1,8,0,13,20,7,1,3,2,4475,4508,20
Task 4476,Job 0,7,8,2,12,0,9,19,10,2,2,2,4476,4509,4
Task 4476,Job 1,12,6,1,9,0,13,21,8,1,2,2,4476,4509,13
Task 4477,Job 0,3,6,1,10,1,4,13,9,1,2,0,4477,4510,13
Task 4477,Job 1,8,4,3,8,0,11,16,5,3,3,0,4477,4510,12
Task 4478,Job 0,1,7,3,9,0,4,10,6,3,1,2,4478,4511,19
Task 4478,Job 1,6,9,2,12,0,8,18,10,2,1,1,4478,4511,3
Task 4479,Job 0,8,6,4,6,1,12,14,2,4,2,0,4479,4513,7
Task 4479,Job 1,13,9,4,8,1,17,21,4,4,3,1,4479,4513,15
Task 4480,Job 0,1,8,2,10,0,3,11,8,2,4,0,4480,4514,14
Task 4480,Job 1,6,6,1,7,0,7,13,6,1,2,1,4480,4514,5
Task 4481,Job 0,3,8,4,8,0,7,11,4,4,3,0,4481,4515,5
Task 4481,Job 1,8,5,4,9,0,12,17,5,4,1,0,4481,4515,11
Task 4482,Job 0,2,10,1,9,0,3,11,8,1,4,0,4482,4516,2
Task 4482,Job 1,7,6,2,8,1,9,15,6,2,3,2,4482,4516,3
Task 4483,Job 0,2,7,3,7,0,5,9,4,3,1,0,4483,4516,5
Task 4483,Job 1,7,8,3,7,1,10,14,4,3,3,1,4483,4516,18
Task 4484,Job 0,8,6,2,12,0,10,20,10,2,2,2,4484,4518,14
Task 4484,Job 1,13,9,4,8,0,17,21,4,4,4,0,4484,4518,20
Task 4485,Job 0,1,5,1,6,1,2,7,5,1,2,2,4485,4519,7
Task 4485,Job 1,6,9,2,7,1,8,13,5,2,2,1,4485,4519,19
Task 4486,Job 0,6,6,4,6,1,10,12,2,4,2,0,4486,4519,13
Task 4486,Job 1,11,7,2,7,0,13,18,5,2,4,2,4486,4519,7
Task 4487,Job 0,3,9,2,12,0,5,15,10,2,4,2,4487,4520,10
Task 4487,Job 1,8,8,2,10,0,10,18,8,2,1,0,4487,4520,3
Task 4488,Job 0,3,6,2,6,0,5,9,4,2,3,2,4488,4521,8
Task 4488,Job 1,8,9,1,8,1,9,16,7,1,2,2,4488,4521,4
Task 4489,Job 0,3,6,1,10,0,4,13,9,1,1,1,4489,4523,7
Task 4489,Job 1,8,8,4,10,0,12,18,6,4,3,2,4489,4523,6
Task 4490,Job 0,9,7,2,12,0,11,21,10,2,2,2,4490,4523,19
Task 4490,Job 1,14,6,2,6,1,16,20,4,2,1,2,4490,4523,8
Task 4491,Job 0,4,4,2,12,0,6,16,10,2,1,1,4491,4524,6
Task 4491,Job 1,9,10,1,7,0,10,16,6,1,2,1,4491,4524,3
Task 4492,Job 0,4,7,3,9,1,7,13,6,3,4,1,4492,4525,4
Task 4492,Job 1,9,5,2,6,0,11,15,4,2,1,0,4492,4525,18
Task 4493,Job 0,1,7,4,6,0,5,7,2,4,3,2,4493,4526,10
Task 4493,Job 1,6,4,1,9,0,7,15,8,1,3,2,4493,4526,15
Task 4494,Job 0,6,7,2,10,0,8,16,8,2,1,1,4494,4528,10
Task 4494,Job 1,11,10,2,9,1,13,20,7,2,1,1,4494,4528,20
Task 4495,Job 0,7,10,3,6,1,10,13,3,3,1,0,4495,4528,2
Task 4495,Job 1,12,5,3,11,0,15,23,8,3,1,1,4495,4528,15
Task 4496,Job 0,2,9,4,9,0,6,11,5,4,3,2,4496,4530,2
Task 4496,Job 1,7,6,1,6,0,8,13,5,1,4,0,4496,4530,19
Task 4497,Job 0,1,7,2,12,0,3,13,10,2,3,1,4497,4530,16
Task 4497,Job 1,6,8,1,9,0,7,15,8,1,2,2,4497,4530,4
Task 4498,Job 0,9,7,4,7,1,13,16,3,4,3,0,4498,4532,9
Task 4498,Job 1,14,5,3,8,0,17,22,5,3,4,1,4498,4532,14
Task 4499,Job 0,4,7,4,6,0,8,10,2,4,2,0,4499,4533,16
Task 4499,Job 1,9,5,2,10,0,11,19,8,2,3,2,4499,4533,10
Task 4500,Job 0,5,9,2,7,0,7,12,5,2,2,2,4500,4534,9
Task 4500,Job 1,10,7,2,12,0,12,22,10,2,4,0,4500,4534,14
Task 4501,Job 0,8,4,4,10,0,12,18,6,4,4,2,4501,4534,17
Task 4501,Job 1,13,7,1,10,0,14,23,9,1,4,1,4501,4534,18
Task 4502,Job 0,2,8,4,6,0,6,8,2,4,3,0,4502,4535,12
Task 4502,Job 1,7,10,1,6,1,8,13,5,1,3,2,4502,4535,2
Task 4503,Job 0,10,4,1,12,0,11,22,11,1,3,1,4503,4537,8
Task 4503,Job 1,15,8,1,9,0,16,24,8,1,3,1,4503,4537,8
Task 4504,Job 0,2,8,4,9,0,6,11,5,4,3,2,4504,4537,14
Task 4504,Job 1,7,6,4,9,0,11,16,5,4,4,2,4504,4537,9
Task 4505,Job 0,5,10,1,9,1,6,14,8,1,4,1,4505,4538,5
Task 4505,Job 1,10,6,3,12,0,13,22,9,3,3,1,4505,4538,15
Task 4506,Job 0,5,6,3,8,0,8,13,5,3,4,2,4506,4540,10
Task 4506,Job 1,10,4,4,12,0,14,22,8,4,4,2,4506,4540,10
Task 4507,Job 0,3,8,4,9,1,7,12,5,4,4,1,4507,4541,20
Task 4507,Job 1,8,5,4,10,0,12,18,6,4,4,0,4507,4541,20
Task 4508,Job 0,5,10,1,6,1,6,11,5,1,4,1,4508,4542,3
Task 4508,Job 1,10,7,2,8,0,12,18,6,2,1,1,4508,4542,13
Task 4509,Job 0,2,7,2,6,0,4,8,4,2,3,2,4509,4543,18
Task 4509,Job 1,7,9,4,8,0,11,15,4,4,2,1,4509,4543,7
Task 4510,Job 0,9,10,3,10,1,12,19,7,3,3,1,4510,4544,15
Task 4510,Job 1,14,10,2,8,0,16,22,6,2,2,0,4510,4544,10
Task 4511,Job 0,6,9,2,10,0,8,16,8,2,1,0,4511,4544,10
Task 4511,Job 1,11,8,4,6,0,15,17,2,4,4,2,4511,4544,19
Task 4512,Job 0,10,7,2,8,0,12,18,6,2,4,0,4512,4545,15
Task 4512,Job 1,15,6,4,6,0,19,21,2,4,1,0,4512,4545,17
Task 4513,Job 0,2,7,2,8,0,4,10,6,2,1,1,4513,4547,17
Task 4513,Job 1,7,9,1,9,0,8,16,8,1,2,0,4513,4547,20
Task 4514,Job 0,9,8,4,9,0,13,18,5,4,3,1,4514,4548,19
Task 4514,Job 1,14,8,4,9,0,18,23,5,4,3,0,4514,4548,13
Task 4515,Job 0,8,10,2,12,0,10,20,10,2,1,1,4515,4548,16
Task 4515,Job 1,13,4,3,9,0,16,22,6,3,4,2,4515,4548,17
Task 4516,Job 0,8,10,2,11,0,10,19,9,2,1,0,4516,4549,8
Task 4516,Job 1,13,4,3,10,0,16,23,7,3,1,0,4516,4549,8
Task 4517,Job 0,6,10,4,11,0,10,17,7,4,3,1,4517,4551,13
Task 4517,Job 1,11,4,1,6,0,12,17,5,1,4,2,4517,4551,18
Task 4518,Job 0,8,4,1,12,0,9,20,11,1,3,0,4518,4551,15
Task 4518,Job 1,13,9,4,11,0,17,24,7,4,4,0,4518,4551,19
Task 4519,Job 0,10,8,4,10,1,14,20,6,4,4,0,4519,4553,4
Task 4519,Job 1,15,7,1,6,0,16,21,5,1,3,2,4519,4553,11
Task 4520,Job 0,3,7,2,6,0,5,9,4,2,4,0,4520,4553,14
Task 4520,Job 1,8,7,1,9,0,9,17,8,1,2,2,4520,4553,5
Task 4521,Job 0,9,4,3,6,0,12,15,3,3,4,2,4521,4554,2
Task 4521,Job 1,14,6,1,7,0,15,21,6,1,3,0,4521,4554,3
Task 4522,Job 0,3,10,2,12,0,5,15,10,2,3,0,4522,4555,13
Task 4522,Job 1,8,7,2,6,0,10,14,4,2,2,0,4522,4555,18
Task 4523,Job 0,8,5,4,12,0,12,20,8,4,2,1,4523,4556,20
Task 4523,Job 1,13,9,3,12,0,16,25,9,3,1,1,4523,4556,13
Task 4524,Job 0,8,10,4,8,1,12,16,4,4,3,1,4524,4557,15
Task 4524,Job 1,13,10,2,10,0,15,23,8,2,1,1,4524,4557,18
Task 4525,Job 0,3,8,4,12,0,7,15,8,4,4,2,4525,4559,6
Task 4525,Job 1,8,4,4,6,0,12,14,2,4,3,0,4525,4559,9
Task 4526,Job 0,10,9,3,8,0,13,18,5,3,1,0,4526,4560,12
Task 4526,Job 1,15,10,2,12,0,17,27,10,2,3,2,4526,4560,20
Task 4527,Job 0,10,5,1,6,0,11,16,5,1,3,1,4527,4560,18
Task 4527,Job 1,15,5,2,9,0,17,24,7,2,4,1,4527,4560,14
Task 4528,Job 0,7,10,2,9,0,9,16,7,2,1,0,4528,4562,2
Task 4528,Job 1,12,4,1,6,0,13,18,5,1,1,0,4528,4562,6
Task 4529,Job 0,10,7,3,8,0,13,18,5,3,1,0,4529,4563,5
Task 4529,Job 1,15,5,3,10,0,18,25,7,3,1,2,4529,4563,11
Task 4530,Job 0,8,5,4,12,0,12,20,8,4,4,1,4530,4563,6
Task 4530,Job 1,13,7,4,6,1,17,19,2,4,1,2,4530,4563,4
Task 4531,Job 0,8,4,1,7,1,9,15,6,1,3,2,4531,4565,9
Task 4531,Job 1,13,9,2,7,0,15,20,5,2,3,1,4531,4565,13
Task 4532,Job 0,5,10,1,9,0,6,14,8,1,3,0,4532,4566,20
Task 4532,Job 1,10,9,2,7,0,12,17,5,2,4,2,4532,4566,15
Task 4533,Job 0,2,5,2,6,0,4,8,4,2,1,2,4533,4567,9
Task 4533,Job 1,7,4,4,8,0,11,15,4,4,3,2,4533,4567,12
Task 4534,Job 0,6,9,3,12,1,9,18,9,3,3,2,4534,4567,17
Task 4534,Job 1,11,4,2,10,0,13,21,8,2,2,0,4534,4567,8
Task 4535,Job 0,7,5,1,12,0,8,19,11,1,3,1,4535,4568,18
Task 4535,Job 1,12,10,2,6,0,14,18,4,2,3,1,4535,4568,19
Task 4536,Job 0,4,8,4,12,0,8,16,8,4,3,1,4536,4569,8
Task 4536,Job 1,9,7,2,8,0,11,17,6,2,2,1,4536,4569,13
Task 4537,Job 0,3,4,1,8,0,4,11,7,1,4,2,4537,4570,17
Task 4537,Job 1,8,8,1,6,1,9,14,5,1,4,2,4537,4570,9
Task 4538,Job 0,5,6,1,10,0,6,15,9,1,2,2,4538,4571,18
Task 4538,Job 1,10,6,2,10,0,12,20,8,2,2,0,4538,4571,2
Task 4539,Job 0,8,10,3,6,0,11,14,3,3,1,1,4539,4572,3
Task 4539,Job 1,13,8,3,9,0,16,22,6,3,4,2,4539,4572,20
Task 4540,Job 0,4,7,1,6,1,5,10,5,1,4,0,4540,4574,15
Task 4540,Job 1,9,8,2,7,1,11,16,5,2,4,2,4540,4574,2
Task 4541,Job 0,2,7,4,7,1,6,9,3,4,3,2,4541,4574,11
Task 4541,Job 1,7,4,4,6,0,11,13,2,4,1,1,4541,4574,7
Task 4542,Job 0,4,4,4,8,0,8,12,4,4,3,1,4542,4576,13
Task 4542,Job 1,9,9,1,10,0,10,19,9,1,3,0,4542,4576,17
Task 4543,Job 0,3,4,1,11,0,4,14,10,1,3,2,4543,4577,12
Task 4543,Job 1,8,8,2,7,0,10,15,5,2,4,2,4543,4577,17
Task 4544,Job 0,9,5,3,8,0,12,17,5,3,2,2,4544,4577,6
Task 4544,Job 1,14,4,1,12,0,15,26,11,1,4,2,4544,4577,15
Task 4545,Job 0,7,5,4,7,0,11,14,3,4,1,2,4545,4578,4
Task 4545,Job 1,12,10,1,6,0,13,18,5,1,1,0,4545,4578,5
Task 4546,Job 0,6,8,4,6,1,10,12,2,4,4,0,4546,4580,4
Task 4546,Job 1,11,6,4,9,1,15,20,5,4,3,0,4546,4580,17
Task 4547,Job 0,3,10,2,10,1,5,13,8,2,2,2,4547,4580,10
Task 4547,Job 1,8,9,4,8,0,12,16,4,4,1,0,4547,4580,8
Task 4548,Job 0,8,4,2,9,0,10,17,7,2,1,0,4548,4582,5
Task 4548,Job 1,13,5,2,7,0,15,20,5,2,3,1,4548,4582,5
Task 4549,Job 0,1,5,4,10,0,5,11,6,4,3,1,4549,4583,10
Task 4549,Job 1,6,6,3,12,0,9,18,9,3,3,0,4549,4583,10
Task 4550,Job 0,4,10,3,12,0,7,16,9,3,1,0,4550,4584,5
Task 4550,Job 1,9,8,4,8,0,13,17,4,4,2,0,4550,4584,2
Task 4551,Job 0,1,4,4,6,0,5,7,2,4,4,2,4551,4584,7
Task 4551,Job 1,6,5,1,11,1,7,17,10,1,1,0,4551,4584,12
Task 4552,Job 0,6,5,4,11,0,10,17,7,4,4,1,4552,4586,15
Task 4552,Job 1,11,8,3,9,1,14,20,6,3,3,0,4552,4586,8
Task 4553,Job 0,9,5,1,9,0,10,18,8,1,2,0,4553,4586,10
Task 4553,Job 1,14,6,4,11,0,18,25,7,4,3,2,4553,4586,7
Task 4554,Job 0,9,9,1,11,0,10,20,10,1,2,1,4554,4588,16
Task 4554,Job 1,14,8,2,6,1,16,20,4,2,3,1,4554,4588,16
Task 4555,Job 0,3,7,3,7,0,6,10,4,3,2,1,4555,4588,16
Task 4555,Job 1,8,9,2,12,0,10,20,10,2,4,1,4555,4588,7
Task 4556,Job 0,3,6,2,12,0,5,15,10,2,4,0,4556,4590,15
Task 4556,Job 1,8,4,3,6,1,11,14,3,3,3,0,4556,4590,15
Task 4557,Job 0,7,6,3,10,0,10,17,7,3,1,0,4557,4590,9
Task 4557,Job 1,12,5,3,6,0,15,18,3,3,2,0,4557,4590,9
Task 4558,Job 0,7,9,3,6,1,10,13,3,3,3,2,4558,4591,4
Task 4558,Job 1,12,8,4,8,0,16,20,4,4,1,2,4558,4591,5
Task 4559,Job 0,9,9,4,11,1,13,20,7,4,1,1,4559,4593,3
Task 4559,Job 1,14,4,4,10,1,18,24,6,4,1,2,4559,4593,7
Task 4560,Job 0,3,8,1,10,0,4,13,9,1,2,2,4560,4593,13
Task 4560,Job 1,8,9,2,10,0,10,18,8,2,1,2,4560,4593,2
Task 4561,Job 0,8,5,4,9,1,12,17,5,4,4,1,4561,4595,10
Task 4561,Job 1,13,10,2,7,0,15,20,5,2,4,0,4561,4595,2
Task 4562,Job 0,5,6,1,9,0,6,14,8,1,4,1,4562,4595,10
Task 4562,Job 1,10,5,2,8,0,12,18,6,2,1,2,4562,4595,5
Task 4563,Job 0,7,5,2,6,0,9,13,4,2,4,1,4563,4597,15
Task 4563,Job 1,12,4,4,7,0,16,19,3,4,4,2,4563,4597,19
Task 4564,Job 0,3,6,4,10,0,7,13,6,4,1,1,4564,4598,4
Task 4564,Job 1,8,8,1,12,1,9,20,11,1,3,0,4564,4598,9
Task 4565,Job 0,5,5,2,7,1,7,12,5,2,3,2,4565,4599,12
Task 4565,Job 1,10,6,4,12,0,14,22,8,4,3,0,4565,4599,15
Task 4566,Job 0,5,6,3,6,1,8,11,3,3,4,1,4566,4599,11
Task 4566,Job 1,10,5,2,12,0,12,22,10,2,2,1,4566,4599,6
Task 4567,Job 0,7,9,2,9,1,9,16,7,2,4,0,4567,4600,11
Task 4567,Job 1,12,9,1,12,1,13,24,11,1,4,0,4567,4600,11
Task 4568,Job 0,2,6,3,9,0,5,11,6,3,2,1,4568,4601,16
Task 4568,Job 1,7,5,3,7,0,10,14,4,3,4,0,4568,4601,12
Task 4569,Job 0,4,5,4,10,0,8,14,6,4,4,0,4569,4602,10
Task 4569,Job 1,9,6,3,12,0,12,21,9,3,1,1,4569,4602,16
Task 4570,Job 0,5,4,2,12,0,7,17,10,2,2,2,4570,4604,2
Task 4570,Job 1,10,9,4,12,0,14,22,8,4,2,2,4570,4604,2
Task 4571,Job 0,9,5,3,9,0,12,18,6,3,3,1,4571,4605,4
Task 4571,Job 1,14,7,1,12,0,15,26,11,1,4,0,4571,4605,4
Task 4572,Job 0,10,6,2,12,0,12,22,10,2,4,1,4572,4605,7
Task 4572,Job 1,15,8,4,10,0,19,25,6,4,2,0,4572,4605,18
Task 4573,Job 0,7,4,3,7,0,10,14,4,3,2,2,4573,4606,9
Task 4573,Job 1,12,8,4,12,1,16,24,8,4,4,0,4573,4606,4
Task 4574,Job 0,1,7,1,8,0,2,9,7,1,1,0,4574,4607,20
Task 4574,Job 1,6,8,2,11,0,8,17,9,2,3,0,4574,4607,10
Task 4575,Job 0,4,6,3,7,1,7,11,4,3,3,1,4575,4608,12
Task 4575,Job 1,9,9,1,10,0,10,19,9,1,2,2,4575,4608,15
Task 4576,Job 0,2,7,4,6,0,6,8,2,4,2,0,4576,4609,13
Task 4576,Job 1,7,9,4,8,1,11,15,4,4,4,2,4576,4609,5
Task 4577,Job 0,10,10,3,12,0,13,22,9,3,4,2,4577,4610,4
Task 4577,Job 1,15,10,1,9,0,16,24,8,1,2,1,4577,4610,9
Task 4578,Job 0,8,4,1,8,0,9,16,7,1,1,1,4578,4612,6
Task 4578,Job 1,13,10,3,8,0,16,21,5,3,4,2,4578,4612,14
Task 4579,Job 0,8,9,1,12,1,9,20,11,1,2,0,4579,4612,6
Task 4579,Job 1,13,10,3,12,0,16,25,9,3,3,1,4579,4612,8
Task 4580,Job 0,9,5,1,9,0,10,18,8,1,4,1,4580,4613,11
Task 4580,Job 1,14,8,2,8,0,16,22,6,2,2,0,4580,4613,6
Task 4581,Job 0,7,9,2,10,0,9,17,8,2,3,1,4581,4614,2
Task 4581,Job 1,12,9,4,9,0,16,21,5,4,4,2,4581,4614,19
Task 4582,Job 0,9,4,1,10,0,10,19,9,1,4,0,4582,4615,8
Task 4582,Job 1,14,9,2,11,1,16,25,9,2,4,0,4582,4615,19
Task 4583,Job 0,2,4,3,9,0,5,11,6,3,1,0,4583,4616,13
Task 4583,Job 1,7,9,4,6,0,11,13,2,4,3,0,4583,4616,3
Task 4584,Job 0,2,7,4,8,0,6,10,4,4,4,2,4584,4618,20
Task 4584,Job 1,7,4,4,7,0,11,14,3,4,3,1,4584,4618,9
Task 4585,Job 0,10,6,2,11,0,12,21,9,2,1,0,4585,4618,11
Task 4585,Job 1,15,5,4,12,0,19,27,8,4,2,2,4585,4618,12
Task 4586,Job 0,2,5,2,10,0,4,12,8,2,2,2,4586,4619,6
Task 4586,Job 1,7,4,2,11,0,9,18,9,2,4,1,4586,4619,17
Task 4587,Job 0,5,4,3,6,0,8,11,3,3,1,2,4587,4621,16
Task 4587,Job 1,10,5,4,11,0,14,21,7,4,1,0,4587,4621,20
Task 4588,Job 0,5,10,2,12,0,7,17,10,2,4,1,4588,4621,7
Task 4588,Job 1,10,10,3,12,0,13,22,9,3,3,2,4588,4621,10
Task 4589,Job 0,9,7,3,11,0,12,20,8,3,4,1,4589,4622,20
Task 4589,Job 1,14,8,4,8,0,18,22,4,4,1,0,4589,4622,17
Task 4590,Job 0,8,8,2,10,0,10,18,8,2,2,1,4590,4623,3
Task 4590,Job 1,13,5,1,12,0,14,25,11,1,3,0,4590,4623,16
Task 4591,Job 0,10,5,2,8,1,12,18,6,2,2,2,4591,4625,6
Task 4591,Job 1,15,6,4,7,1,19,22,3,4,1,0,4591,4625,17
Task 4592,Job 0,4,6,1,11,1,5,15,10,1,1,0,4592,4625,14
Task 4592,Job 1,9,7,2,10,1,11,19,8,2,2,0,4592,4625,13
Task 4593,Job 0,9,7,4,9,0,13,18,5,4,1,1,4593,4627,6
Task 4593,Job 1,14,8,1,8,0,15,22,7,1,1,0,4593,4627,5
Task 4594,Job 0,3,5,1,10,0,4,13,9,1,1,2,4594,4627,14
Task 4594,Job 1,8,7,3,8,1,11,16,5,3,4,2,4594,4627,3
Task 4595,Job 0,8,7,1,11,0,9,19,10,1,4,1,4595,4628,19
Task 4595,Job 1,13,8,1,11,0,14,24,10,1,3,1,4595,4628,5
Task 4596,Job 0,10,8,2,9,0,12,19,7,2,1,0,4596,4630,11
Task 4596,Job 1,15,4,3,7,0,18,22,4,3,1,1,4596,4630,20
Task 4597,Job 0,10,10,2,6,0,12,16,4,2,2,1,4597,4631,18
Task 4597,Job 1,15,8,3,11,1,18,26,8,3,1,0,4597,4631,18
Task 4598,Job 0,4,6,2,7,0,6,11,5,2,4,0,4598,4632,17
Task 4598,Job 1,9,6,2,6,1,11,15,4,2,4,2,4598,4632,8
Task 4599,Job 0,7,6,1,12,0,8,19,11,1,2,1,4599,4632,19
Task 4599,Job 1,12,9,3,9,0,15,21,6,3,2,0,4599,4632,6
Task 4600,Job 0,3,6,4,12,0,7,15,8,4,2,2,4600,4633,20
Task 4600,Job 1,8,8,3,6,0,11,14,3,3,3,0,4600,4633,4
Task 4601,Job 0,5,5,3,8,0,8,13,5,3,4,1,4601,4634,8
Task 4601,Job 1,10,10,2,6,0,12,16,4,2,3,0,4601,4634,5
Task 4602,Job 0,9,5,4,7,1,13,16,3,4,4,0,4602,4635,16
Task 4602,Job 1,14,5,1,12,0,15,26,11,1,2,1,4602,4635,20
Task 4603,Job 0,10,4,2,8,0,12,18,6,2,4,0,4603,4637,16
Task 4603,Job 1,15,4,3,8,0,18,23,5,3,1,1,4603,4637,17
Task 4604,Job 0,3,7,3,12,0,6,15,9,3,3,2,4604,4638,13
Task 4604,Job 1,8,9,3,11,0,11,19,8,3,3,2,4604,4638,9
Task 4605,Job 0,3,9,1,10,0,4,13,9,1,3,0,4605,4638,5
Task 4605,Job 1,8,6,4,7,0,12,15,3,4,4,2,4605,4638,5
Task 4606,Job 0,5,10,1,9,0,6,14,8,1,2,2,4606,4639,3
Task 4606,Job 1,10,6,4,10,0,14,20,6,4,3,1,4606,4639,8
Task 4607,Job 0,9,5,3,7,0,12,16,4,3,2,0,4607,4640,20
Task 4607,Job 1,14,5,3,10,0,17,24,7,3,4,2,4607,4640,18
Task 4608,Job 0,1,9,3,9,1,4,10,6,3,1,2,4608,4641,2
Task 4608,Job 1,6,8,3,8,0,9,14,5,3,3,0,4608,4641,13
Task 4609,Job 0,5,5,3,10,0,8,15,7,3,1,0,4609,4643,19
Task 4609,Job 1,10,4,2,10,0,12,20,8,2,4,0,4609,4643,18
Task 4610,Job 0,1,7,2,9,0,3,10,7,2,4,1,4610,4644,20
Task 4610,Job 1,6,4,3,7,1,9,13,4,3,2,0,4610,4644,18
Task 4611,Job 0,3,4,2,10,1,5,13,8,2,1,2,4611,4644,5
Task 4611,Job 1,8,5,3,9,0,11,17,6,3,2,2,4611,4644,5
Task 4612,Job 0,10,9,1,10,0,11,20,9,1,1,0,4612,4645,16
Task 4612,Job 1,15,7,1,9,0,16,24,8,1,2,0,4612,4645,19
Task 4613,Job 0,7,4,2,7,0,9,14,5,2,2,0,4613,4646,4
Task 4613,Job 1,12,6,2,6,0,14,18,4,2,2,1,4613,4646,11
Task 4614,Job 0,9,9,3,7,0,12,16,4,3,4,1,4614,4648,19
Task 4614,Job 1,14,6,2,12,0,16,26,10,2,1,2,4614,4648,2
Task 4615,Job 0,3,7,1,9,1,4,12,8,1,1,2,4615,4649,13
Task 4615,Job 1,8,10,3,12,0,11,20,9,3,4,0,4615,4649,6
Task 4616,Job 0,9,8,3,10,0,12,19,7,3,3,0,4616,4649,7
Task 4616,Job 1,14,10,1,9,0,15,23,8,1,1,0,4616,4649,14
Task 4617,Job 0,5,7,1,6,1,6,11,5,1,1,1,4617,4651,14
Task 4617,Job 1,10,7,3,10,0,13,20,7,3,2,1,4617,4651,12
Task 4618,Job 0,9,6,2,11,0,11,20,9,2,1,0,4618,4652,19
Task 4618,Job 1,14,4,1,7,0,15,21,6,1,2,0,4618,4652,14
Task 4619,Job 0,7,9,3,6,0,10,13,3,3,4,1,4619,4652,2
Task 4619,Job 1,12,5,2,9,0,14,21,7,2,3,1,4619,4652,17
Task 4620,Job 0,7,10,3,8,0,10,15,5,3,2,1,4620,4654,12
Task 4620,Job 1,12,9,2,12,1,14,24,10,2,4,0,4620,4654,12
Task 4621,Job 0,7,8,1,8,0,8,15,7,1,3,0,4621,4654,16
Task 4621,Job 1,12,10,3,12,1,15,24,9,3,4,0,4621,4654,4
Task 4622,Job 0,2,6,4,10,1,6,12,6,4,4,1,4622,4655,20
Task 4622,Job 1,7,8,3,12,1,10,19,9,3,1,2,4622,4655,16
Task 4623,Job 0,2,8,2,8,1,4,10,6,2,4,1,4623,4656,15
Task 4623,Job 1,7,5,1,11,0,8,18,10,1,4,2,4623,4656,7
Task 4624,Job 0,8,10,2,12,0,10,20,10,2,2,0,4624,4657,18
Task 4624,Job 1,13,9,2,6,0,15,19,4,2,1,2,4624,4657,7
Task 4625,Job 0,8,5,1,11,1,9,19,10,1,1,1,4625,4659,17
Task 4625,Job 1,13,8,1,12,0,14,25,11,1,1,2,4625,4659,5
Task 4626,Job 0,2,5,1,10,0,3,12,9,1,2,2,4626,4660,17
Task 4626,Job 1,7,9,1,12,1,8,19,11,1,1,2,4626,4660,20
Task 4627,Job 0,4,8,4,9,0,8,13,5,4,4,2,4627,4660,13
Task 4627,Job 1,9,10,1,11,0,10,20,10,1,2,1,4627,4660,8
Task 4628,Job 0,7,9,2,10,0,9,17,8,2,2,1,4628,4662,11
Task 4628,Job 1,12,4,4,6,0,16,18,2,4,2,2,4628,4662,8
Task 4629,Job 0,7,6,3,6,0,10,13,3,3,2,1,4629,4663,8
Task 4629,Job 1,12,7,4,6,0,16,18,2,4,3,1,4629,4663,16
Task 4630,Job 0,10,5,2,12,0,12,22,10,2,3,2,4630,4664,19
Task 4630,Job 1,15,10,3,6,1,18,21,3,3,4,2,4630,4664,20
Task 4631,Job 0,1,9,4,10,1,5,11,6,4,4,0,4631,4665,5
Task 4631,Job 1,6,8,1,11,0,7,17,10,1,1,2,4631,4665,9
Task 4632,Job 0,7,8,4,9,1,11,16,5,4,2,1,4632,4666,15
Task 4632,Job 1,12,4,1,9,0,13,21,8,1,3,2,4632,4666,16
Task 4633,Job 0,4,9,1,12,0,5,16,11,1,2,1,4633,4667,14
Task 4633,Job 1,9,4,4,8,0,13,17,4,4,3,2,4633,4667,3
Task 4634,Job 0,7,4,4,8,1,11,15,4,4,4,2,4634,4668,3
Task 4634,Job 1,12,8,3,8,1,15,20,5,3,2,1,4634,4668,6
Task 4635,Job 0,9,7,4,10,0,13,19,6,4,2,0,4635,4668,11
Task 4635,Job 1,14,5,4,7,1,18,21,3,4,4,2,4635,4668,9
Task 4636,Job 0,4,10,2,9,1,6,13,7,2,3,2,4636,4670,14
Task 4636,Job 1,9,6,2,8,0,11,17,6,2,3,1,4636,4670,14
Task 4637,Job 0,4,4,1,9,0,5,13,8,1,1,2,4637,4670,20
Task 4637,Job 1,9,7,4,12,1,13,21,8,4,2,0,4637,4670,7
Task 4638,Job 0,6,4,3,12,0,9,18,9,3,1,2,4638,4671,11
Task 4638,Job 1,11,4,4,7,0,15,18,3,4,1,0,4638,4671,3
Task 4639,Job 0,4,9,4,11,1,8,15,7,4,2,2,4639,4672,4
Task 4639,Job 1,9,7,1,11,1,10,20,10,1,2,0,4639,4672,5
Task 4640,Job 0,3,7,1,11,0,4,14,10,1,2,2,4640,4674,15
Task 4640,Job 1,8,4,3,7,0,11,15,4,3,3,0,4640,4674,6
Task 4641,Job 0,6,4,1,7,0,7,13,6,1,2,2,4641,4675,10
Task 4641,Job 1,11,9,2,6,0,13,17,4,2,2,1,4641,4675,9
Task 4642,Job 0,8,8,4,12,0,12,20,8,4,4,2,4642,4675,3
Task 4642,Job 1,13,7,2,10,0,15,23,8,2,1,0,4642,4675,16
Task 4643,Job 0,6,7,3,10,0,9,16,7,3,1,0,4643,4676,11
Task 4643,Job 1,11,5,3,12,0,14,23,9,3,3,0,4643,4676,6
Task 4644,Job 0,4,9,2,7,1,6,11,5,2,3,2,4644,4677,17
Task 4644,Job 1,9,8,1,12,0,10,21,11,1,2,1,4644,4677,15
Task 4645,Job 0,1,7,3,10,0,4,11,7,3,3,1,4645,4678,17
Task 4645,Job 1,6,7,1,8,0,7,14,7,1,4,1,4645,4678,16
Task 4646,Job 0,7,7,1,11,0,8,18,10,1,1,1,4646,4680,11
Task 4646,Job 1,12,6,2,9,0,14,21,7,2,1,0,4646,4680,20
Task 4647,Job 0,9,10,1,9,0,10,18,8,1,2,2,4647,4680,7
Task 4647,Job 1,14,10,2,8,0,16,22,6,2,4,1,4647,4680,19
Task 4648,Job 0,9,7,1,12,0,10,21,11,1,1,0,4648,4682,9
Task 4648,Job 1,14,9,2,9,0,16,23,7,2,3,2,4648,4682,10
Task 4649,Job 0,9,7,3,8,0,12,17,5,3,2,1,4649,4682,10
Task 4649,Job 1,14,6,2,10,0,16,24,8,2,1,2,4649,4682,6
Task 4650,Job 0,7,10,2,6,0,9,13,4,2,4,1,4650,4683,8
Task 4650,Job 1,12,5,2,10,0,14,22,8,2,1,1,4650,4683,16
Task 4651,Job 0,10,7,1,6,0,11,16,5,1,4,0,4651,4685,8
Task 4651,Job 1,15,6,4,12,0,19,27,8,4,1,1,4651,4685,7
Task 4652,Job 0,2,7,2,6,1,4,8,4,2,4,1,4652,4685,5
Task 4652,Job 1,7,7,1,9,1,8,16,8,1,2,2,4652,4685,6
Task 4653,Job 0,7,5,3,11,0,10,18,8,3,1,0,4653,4687,13
Task 4653,Job 1,12,8,1,11,0,13,23,10,1,2,1,4653,4687,13
Task 4654,Job 0,5,9,3,10,1,8,15,7,3,4,0,4654,4687,5
Task 4654,Job 1,10,9,1,10,0,11,20,9,1,1,2,4654,4687,3
Task 4655,Job 0,10,9,4,10,1,14,20,6,4,2,0,4655,4688,2
Task 4655,Job 1,15,7,3,7,0,18,22,4,3,2,0,4655,4688,20
Task 4656,Job 0,7,8,2,9,0,9,16,7,2,1,1,4656,4690,8
Task 4656,Job 1,12,9,3,6,0,15,18,3,3,4,0,4656,4690,18
Task 4657,Job 0,9,8,4,12,0,13,21,8,4,2,1,4657,4690,11
Task 4657,Job 1,14,10,3,7,0,17,21,4,3,2,2,4657,4690,18
Task 4658,Job 0,5,6,2,6,0,7,11,4,2,4,0,4658,4692,19
Task 4658,Job 1,10,6,4,6,0,14,16,2,4,2,1,4658,4692,9
Task 4659,Job 0,8,5,4,6,1,12,14,2,4,2,2,4659,4693,19
Task 4659,Job 1,13,7,1,8,0,14,21,7,1,4,1,4659,4693,13
Task 4660,Job 0,9,8,3,6,0,12,15,3,3,3,2,4660,4694,8
Task 4660,Job 1,14,8,2,10,1,16,24,8,2,2,0,4660,4694,17
Task 4661,Job 0,2,4,2,7,0,4,9,5,2,2,1,4661,4694,13
Task 4661,Job 1,7,4,2,10,0,9,17,8,2,3,2,4661,4694,19
Task 4662,Job 0,4,7,3,10,0,7,14,7,3,4,0,4662,4695,7
Task 4662,Job 1,9,8,2,6,1,11,15,4,2,4,1,4662,4695,19
Task 4663,Job 0,10,9,3,8,1,13,18,5,3,3,1,4663,4697,2
Task 4663,Job 1,15,5,3,9,0,18,24,6,3,2,0,4663,4697,17
Task 4664,Job 0,4,8,4,12,0,8,16,8,4,2,1,4664,4698,7
Task 4664,Job 1,9,7,2,6,0,11,15,4,2,2,2,4664,4698,3
Task 4665,Job 0,4,9,2,7,0,6,11,5,2,3,0,4665,4698,2
Task 4665,Job 1,9,5,4,11,0,13,20,7,4,2,1,4665,4698,7
Task 4666,Job 0,7,10,2,11,0,9,18,9,2,3,2,4666,4699,15
Task 4666,Job 1,12,5,3,6,0,15,18,3,3,2,0,4666,4699,8
Task 4667,Job 0,7,8,4,11,0,11,18,7,4,1,1,4667,4701,5
Task 4667,Job 1,12,8,4,9,0,16,21,5,4,4,1,4667,4701,13
Task 4668,Job 0,3,4,1,11,1,4,14,10,1,2,0,4668,4702,14
Task 4668,Job 1,8,7,1,12,0,9,20,11,1,1,0,4668,4702,19
Task 4669,Job 0,4,4,1,12,0,5,16,11,1,4,2,4669,4703,12
Task 4669,Job 1,9,4,2,6,0,11,15,4,2,1,2,4669,4703,15
Task 4670,Job 0,1,7,3,9,0,4,10,6,3,2,0,4670,4703,13
Task 4670,Job 1,6,10,4,7,0,10,13,3,4,2,0,4670,4703,11
Task 4671,Job 0,2,9,3,8,0,5,10,5,3,1,0,4671,4705,4
Task 4671,Job 1,7,8,1,11,1,8,18,10,1,1,1,4671,4705,19
Task 4672,Job 0,1,5,3,6,1,4,7,3,3,4,1,4672,4705,8
Task 4672,Job 1,6,8,3,7,0,9,13,4,3,1,2,4672,4705,8
Task 4673,Job 0,1,8,3,7,0,4,8,4,3,4,1,4673,4707,6
Task 4673,Job 1,6,10,2,6,0,8,12,4,2,2,0,4673,4707,12
Task 4674,Job 0,8,10,4,12,0,12,20,8,4,2,0,4674,4707,14
Task 4674,Job 1,13,5,3,10,0,16,23,7,3,1,1,4674,4707,20
Task 4675,Job 0,5,10,2,8,0,7,13,6,2,1,1,4675,4708,13
Task 4675,Job 1,10,7,1,6,1,11,16,5,1,2,1,4675,4708,13
Task 4676,Job 0,3,5,1,10,0,4,13,9,1,2,1,4676,4710,10
Task 4676,Job 1,8,6,4,8,0,12,16,4,4,3,0,4676,4710,15
Task 4677,Job 0,4,4,3,6,0,7,10,3,3,2,1,4677,4710,17
Task 4677,Job 1,9,6,4,12,0,13,21,8,4,4,2,4677,4710,13
Task 4678,Job 0,5,5,2,12,0,7,17,10,2,3,2,4678,4711,8
Task 4678,Job 1,10,9,1,6,1,11,16,5,1,3,1,4678,4711,7
Task 4679,Job 0,9,5,1,8,0,10,17,7,1,4,0,4679,4712,9
Task 4679,Job 1,14,8,1,12,0,15,26,11,1,1,2,4679,4712,8
Task 4680,Job 0,4,10,3,8,1,7,12,5,3,4,0,4680,4714,13
Task 4680,Job 1,9,5,3,8,0,12,17,5,3,2,0,4680,4714,4
Task 4681,Job 0,6,10,3,6,0,9,12,3,3,4,2,4681,4714,15
Task 4681,Job 1,11,9,2,10,0,13,21,8,2,2,2,4681,4714,10
Task 4682,Job 0,3,10,3,9,0,6,12,6,3,2,0,4682,4716,9
Task 4682,Job 1,8,4,4,10,0,12,18,6,4,4,1,4682,4716,19
Task 4683,Job 0,6,4,2,7,1,8,13,5,2,3,0,4683,4717,3
Task 4683,Job 1,11,7,3,10,0,14,21,7,3,2,1,4683,4717,14
Task 4684,Job 0,5,9,2,7,0,7,12,5,2,1,1,4684,4718,11
Task 4684,Job 1,10,7,3,12,1,13,22,9,3,3,0,4684,4718,11
Task 4685,Job 0,7,7,2,6,0,9,13,4,2,3,2,4685,4719,15
Task 4685,Job 1,12,7,3,9,0,15,21,6,3,3,0,4685,4719,19
Task 4686,Job 0,3,7,3,10,0,6,13,7,3,3,1,4686,4720,6
Task 4686,Job 1,8,7,1,8,0,9,16,7,1,4,0,4686,4720,4
Task 4687,Job 0,4,6,4,12,1,8,16,8,4,3,1,4687,4721,18
Task 4687,Job 1,9,6,3,6,1,12,15,3,3,4,2,4687,4721,20
Task 4688,Job 0,5,7,4,7,0,9,12,3,4,1,1,4688,4722,10
Task 4688,Job 1,10,4,2,9,0,12,19,7,2,4,1,4688,4722,16
Task 4689,Job 0,4,7,2,11,0,6,15,9,2,2,0,4689,4722,15
Task 4689,Job 1,9,10,4,11,0,13,20,7,4,1,1,4689,4722,5
Task 4690,Job 0,4,8,1,7,0,5,11,6,1,4,0,4690,4724,17
Task 4690,Job 1,9,10,2,9,0,11,18,7,2,3,2,4690,4724,14
Task 4691,Job 0,8,7,3,10,0,11,18,7,3,2,0,4691,4725,5
Task 4691,Job 1,13,5,1,12,1,14,25,11,1,1,0,4691,4725,14
Task 4692,Job 0,1,5,1,7,0,2,8,6,1,2,0,4692,4725,2
Task 4692,Job 1,6,8,2,9,0,8,15,7,2,1,2,4692,4725,12
Task 4693,Job 0,6,5,3,12,0,9,18,9,3,2,0,4693,4726,14
Task 4693,Job 1,11,8,1,12,0,12,23,11,1,2,2,4693,4726,7
Task 4694,Job 0,5,6,3,11,0,8,16,8,3,4,0,4694,4727,3
Task 4694,Job 1,10,5,2,11,1,12,21,9,2,1,1,4694,4727,18
Task 4695,Job 0,8,8,3,10,0,11,18,7,3,4,1,4695,4728,6
Task 4695,Job 1,13,8,1,6,0,14,19,5,1,2,2,4695,4728,19
Task 4696,Job 0,4,6,2,10,1,6,14,8,2,4,0,4696,4729,5
Task 4696,Job 1,9,5,3,9,0,12,18,6,3,1,0,4696,4729,18
Task 4697,Job 0,9,8,1,6,0,10,15,5,1,4,1,4697,4731,18
Task 4697,Job 1,14,9,1,7,0,15,21,6,1,2,2,4697,4731,19
Task 4698,Job 0,7,8,1,6,0,8,13,5,1,2,1,4698,4732,4
Task 4698,Job 1,12,4,2,7,1,14,19,5,2,1,1,4698,4732,5
Task 4699,Job 0,10,4,2,7,1,12,17,5,2,2,2,4699,4733,5
Task 4699,Job 1,15,10,1,10,0,16,25,9,1,2,0,4699,4733,2
Task 4700,Job 0,1,7,2,8,1,3,9,6,2,4,0,4700,4733,2
Task 4700,Job 1,6,10,2,7,0,8,13,5,2,3,0,4700,4733,7
Task 4701,Job 0,4,9,3,9,0,7,13,6,3,2,0,4701,4734,12
Task 4701,Job 1,9,5,3,12,0,12,21,9,3,3,2,4701,4734,13
Task 4702,Job 0,10,5,3,10,0,13,20,7,3,2,1,4702,4736,5
Task 4702,Job 1,15,6,2,10,1,17,25,8,2,4,2,4702,4736,16
Task 4703,Job 0,9,4,2,10,1,11,19,8,2,4,0,4703,4737,20
Task 4703,Job 1,14,9,2,12,1,16,26,10,2,2,1,4703,4737,8
Task 4704,Job 0,7,4,2,7,0,9,14,5,2,4,1,4704,4738,10
Task 4704,Job 1,12,7,4,11,0,16,23,7,4,1,0,4704,4738,17
Task 4705,Job 0,1,6,2,9,0,3,10,7,2,1,1,4705,4739,15
Task 4705,Job 1,6,9,2,6,0,8,12,4,2,2,2,4705,4739,12
Task 4706,Job 0,9,9,3,9,0,12,18,6,3,2,1,4706,4740,17
Task 4706,Job 1,14,4,2,11,0,16,25,9,2,3,1,4706,4740,4
Task 4707,Job 0,5,5,4,7,1,9,12,3,4,3,1,4707,4740,19
Task 4707,Job 1,10,6,3,12,1,13,22,9,3,2,2,4707,4740,12
Task 4708,Job 0,7,10,1,12,0,8,19,11,1,3,2,4708,4741,11
Task 4708,Job 1,12,8,3,7,0,15,19,4,3,3,0,4708,4741,20
Task 4709,Job 0,5,10,3,12,0,8,17,9,3,3,2,4709,4742,20
Task 4709,Job 1,10,6,2,12,0,12,22,10,2,2,0,4709,4742,15
Task 4710,Job 0,4,5,2,8,0,6,12,6,2,2,1,4710,4743,14
Task 4710,Job 1,9,10,3,9,0,12,18,6,3,2,2,4710,4743,11
Task 4711,Job 0,5,7,4,10,0,9,15,6,4,1,2,4711,4745,18
Task 4711,Job 1,10,7,3,11,0,13,21,8,3,2,2,4711,4745,17
Task 4712,Job 0,10,9,4,10,0,14,20,6,4,1,0,4712,4745,2
Task 4712,Job 1,15,10,3,10,0,18,25,7,3,1,0,4712,4745,19
Task 4713,Job 0,8,7,4,11,0,12,19,7,4,2,0,4713,4746,14
Task 4713,Job 1,13,7,4,12,0,17,25,8,4,4,2,4713,4746,8
Task 4714,Job 0,10,8,2,6,0,12,16,4,2,4,0,4714,4747,14
Task 4714,Job 1,15,10,1,7,0,16,22,6,1,4,1,4714,4747,4
Task 4715,Job 0,9,6,1,9,0,10,18,8,1,2,1,4715,4748,15
Task 4715,Job 1,14,4,4,6,0,18,20,2,4,4,2,4715,4748,7
Task 4716,Job 0,8,7,3,6,0,11,14,3,3,2,2,4716,4750,6
Task 4716,Job 1,13,5,2,10,0,15,23,8,2,3,2,4716,4750,5
Task 4717,Job 0,6,9,4,12,1,10,18,8,4,3,0,4717,4751,12
Task 4717,Job 1,11,4,1,6,0,12,17,5,1,3,1,4717,4751,10
Task 4718,Job 0,8,6,2,10,0,10,18,8,2,2,2,4718,4752,13
Task 4718,Job 1,13,10,3,12,0,16,25,9,3,1,2,4718,4752,2
Task 4719,Job 0,5,9,3,7,0,8,12,4,3,1,1,4719,4753,2
Task 4719,Job 1,10,5,3,9,0,13,19,6,3,3,2,4719,4753,5
Task 4720,Job 0,7,5,3,10,0,10,17,7,3,3,2,4720,4753,19
Task 4720,Job 1,12,8,4,11,0,16,23,7,4,2,1,4720,4753,19
Task 4721,Job 0,6,4,1,12,0,7,18,11,1,4,2,4721,4755,8
Task 4721,Job 1,11,7,2,11,0,13,22,9,2,1,0,4721,4755,10
Task 4722,Job 0,8,7,1,7,0,9,15,6,1,3,1,4722,4755,5
Task 4722,Job 1,13,4,1,7,1,14,20,6,1,4,0,4722,4755,11
Task 4723,Job 0,9,7,2,6,0,11,15,4,2,3,0,4723,4756,19
Task 4723,Job 1,14,9,4,6,0,18,20,2,4,2,1,4723,4756,2
Task 4724,Job 0,1,10,4,8,0,5,9,4,4,1,1,4724,4757,9
Task 4724,Job 1,6,8,4,8,0,10,14,4,4,2,1,4724,4757,14
Task 4725,Job 0,7,4,2,12,1,9,19,10,2,4,1,4725,4758,20
Task 4725,Job 1,12,7,3,6,1,15,18,3,3,3,1,4725,4758,12
Task 4726,Job 0,6,8,4,8,0,10,14,4,4,4,1,4726,4759,16
Task 4726,Job 1,11,7,1,10,0,12,21,9,1,1,1,4726,4759,9
Task 4727,Job 0,1,5,2,6,1,3,7,4,2,4,1,4727,4761,13
Task 4727,Job 1,6,6,2,10,1,8,16,8,2,2,0,4727,4761,19
Task 4728,Job 0,8,9,3,6,1,11,14,3,3,1,2,4728,4761,17
Task 4728,Job 1,13,10,3,12,0,16,25,9,3,1,1,4728,4761,18
Task 4729,Job 0,2,6,3,8,0,5,10,5,3,2,2,4729,4762,7
Task 4729,Job 1,7,5,4,6,1,11,13,2,4,1,2,4729,4762,20
Task 4730,Job 0,2,6,1,10,0,3,12,9,1,2,2,4730,4764,19
Task 4730,Job 1,7,10,4,9,0,11,16,5,4,1,2,4730,4764,6
Task 4731,Job 0,3,9,4,10,0,7,13,6,4,4,1,4731,4764,2
Task 4731,Job 1,8,8,3,12,0,11,20,9,3,4,0,4731,4764,19
Task 4732,Job 0,3,7,2,9,1,5,12,7,2,2,0,4732,4765,19
Task 4732,Job 1,8,8,1,9,0,9,17,8,1,4,1,4732,4765,15
Task 4733,Job 0,4,6,4,10,0,8,14,6,4,3,2,4733,4766,18
Task 4733,Job 1,9,5,1,11,0,10,20,10,1,1,1,4733,4766,14
Task 4734,Job 0,5,8,2,9,0,7,14,7,2,2,0,4734,4768,9
Task 4734,Job 1,10,6,4,10,0,14,20,6,4,2,1,4734,4768,15
Task 4735,Job 0,10,4,2,9,0,12,19,7,2,1,2,4735,4769,17
Task 4735,Job 1,15,9,2,10,1,17,25,8,2,1,0,4735,4769,9
Task 4736,Job 0,6,4,1,6,0,7,12,5,1,2,2,4736,4769,3
Task 4736,Job 1,11,4,3,7,0,14,18,4,3,1,0,4736,4769,8
Task 4737,Job 0,3,9,4,10,1,7,13,6,4,1,1,4737,4770,4
Task 4737,Job 1,8,6,2,9,0,10,17,7,2,1,1,4737,4770,7
Task 4738,Job 0,10,6,2,6,1,12,16,4,2,4,1,4738,4771,11
Task 4738,Job 1,15,8,1,11,0,16,26,10,1,4,2,4738,4771,6
Task 4739,Job 0,4,7,2,7,0,6,11,5,2,1,2,4739,4772,16
Task 4739,Job 1,9,5,2,11,0,11,20,9,2,1,1,4739,4772,17
Task 4740,Job 0,3,6,3,7,1,6,10,4,3,4,1,4740,4774,19
Task 4740,Job 1,8,7,3,9,0,11,17,6,3,4,1,4740,4774,18
Task 4741,Job 0,7,8,3,8,0,10,15,5,3,3,1,4741,4775,5
Task 4741,Job 1,12,7,2,10,1,14,22,8,2,3,1,4741,4775,12
Task 4742,Job 0,7,9,3,11,0,10,18,8,3,2,0,4742,4776,11
Task 4742,Job 1,12,4,2,9,0,14,21,7,2,2,0,4742,4776,19
Task 4743,Job 0,2,4,1,10,1,3,12,9,1,4,2,4743,4777,5
Task 4743,Job 1,7,6,4,9,0,11,16,5,4,3,1,4743,4777,14
Task 4744,Job 0,3,5,2,9,0,5,12,7,2,3,0,4744,4777,16
Task 4744,Job 1,8,10,1,6,1,9,14,5,1,2,2,4744,4777,4
Task 4745,Job 0,6,8,4,8,0,10,14,4,4,3,2,4745,4778,2
Task 4745,Job 1,11,8,1,7,1,12,18,6,1,1,2,4745,4778,6
Task 4746,Job 0,2,5,3,9,0,5,11,6,3,2,1,4746,4779,15
Task 4746,Job 1,7,7,4,12,0,11,19,8,4,4,2,4746,4779,16
Task 4747,Job 0,8,6,1,12,0,9,20,11,1,2,0,4747,4780,18
Task 4747,Job 1,13,10,4,7,1,17,20,3,4,3,0,4747,4780,13
Task 4748,Job 0,7,9,3,9,1,10,16,6,3,3,1,4748,4781,15
Task 4748,Job 1,12,8,4,11,0,16,23,7,4,2,0,4748,4781,4
Task 4749,Job 0,10,5,4,9,0,14,19,5,4,4,1,4749,4783,12
Task 4749,Job 1,15,4,2,12,1,17,27,10,2,2,2,4749,4783,18
Task 4750,Job 0,6,4,4,10,0,10,16,6,4,4,0,4750,4784,3
Task 4750,Job 1,11,4,3,8,0,14,19,5,3,3,2,4750,4784,4
Task 4751,Job 0,10,4,4,12,0,14,22,8,4,4,0,4751,4785,10
Task 4751,Job 1,15,6,2,6,0,17,21,4,2,1,2,4751,4785,13
Task 4752,Job 0,5,8,3,10,0,8,15,7,3,4,2,4752,4785,10
Task 4752,Job 1,10,5,1,10,1,11,20,9,1,4,0,4752,4785,14
Task 4753,Job 0,4,7,3,12,1,7,16,9,3,1,0,4753,4786,20
Task 4753,Job 1,9,8,1,6,0,10,15,5,1,1,0,4753,4786,7
Task 4754,Job 0,4,5,1,8,0,5,12,7,1,4,2,4754,4788,13
Task 4754,Job 1,9,10,2,11,1,11,20,9,2,1,2,4754,4788,14
Task 4755,Job 0,6,7,4,6,0,10,12,2,4,4,2,4755,4789,5
Task 4755,Job 1,11,9,3,7,1,14,18,4,3,3,2,4755,4789,10
Task 4756,Job 0,10,10,1,10,0,11,20,9,1,4,1,4756,4790,17
Task 4756,Job 1,15,5,2,12,0,17,27,10,2,4,0,4756,4790,20
Task 4757,Job 0,1,10,1,9,0,2,10,8,1,2,0,4757,4791,7
Task 4757,Job 1,6,5,2,7,1,8,13,5,2,2,0,4757,4791,10
Task 4758,Job 0,2,10,3,8,0,5,10,5,3,2,2,4758,4792,16
Task 4758,Job 1,7,6,1,11,0,8,18,10,1,1,0,4758,4792,3
Task 4759,Job 0,3,10,4,7,1,7,10,3,4,4,0,4759,4792,13
Task 4759,Job 1,8,7,1,6,0,9,14,5,1,3,2,4759,4792,12
Task 4760,Job 0,10,6,2,11,0,12,21,9,2,1,1,4760,4794,16
Task 4760,Job 1,15,7,1,11,1,16,26,10,1,2,1,4760,4794,5
Task 4761,Job 0,4,4,4,6,0,8,10,2,4,1,1,4761,4794,8
Task 4761,Job 1,9,7,1,8,0,10,17,7,1,4,1,4761,4794,19
Task 4762,Job 0,10,6,2,9,0,12,19,7,2,2,1,4762,4795,7
Task 4762,Job 1,15,7,2,8,0,17,23,6,2,2,1,4762,4795,19
Task 4763,Job 0,1,9,1,6,0,2,7,5,1,2,0,4763,4796,2
Task 4763,Job 1,6,5,1,10,1,7,16,9,1,2,0,4763,4796,2
Task 4764,Job 0,6,8,3,6,0,9,12,3,3,2,1,4764,4798,15
Task 4764,Job 1,11,7,3,8,0,14,19,5,3,3,0,4764,4798,17
Task 4765,Job 0,9,10,1,9,0,10,18,8,1,4,0,4765,4799,3
Task 4765,Job 1,14,4,2,7,0,16,21,5,2,4,1,4765,4799,12
Task 4766,Job 0,5,10,2,12,0,7,17,10,2,3,2,4766,4799,12
Task 4766,Job 1,10,9,1,12,0,11,22,11,1,4,1,4766,4799,17
Task 4767,Job 0,7,4,3,12,1,10,19,9,3,1,1,4767,4800,18
Task 4767,Job 1,12,5,4,11,0,16,23,7,4,3,0,4767,4800,11
Task 4768,Job 0,6,6,4,7,1,10,13,3,4,4,0,4768,4802,17
Task 4768,Job 1,11,6,4,12,0,15,23,8,4,2,1,4768,4802,9
Task 4769,Job 0,2,9,2,10,0,4,12,8,2,3,1,4769,4803,19
Task 4769,Job 1,7,5,4,8,0,11,15,4,4,2,0,4769,4803,18
Task 4770,Job 0,6,6,3,11,0,9,17,8,3,2,2,4770,4803,14
Task 4770,Job 1,11,5,1,8,0,12,19,7,1,2,1,4770,4803,8
Task 4771,Job 0,6,6,3,9,0,9,15,6,3,1,2,4771,4804,19
Task 4771,Job 1,11,6,1,10,1,12,21,9,1,1,1,4771,4804,9
Task 4772,Job 0,3,7,1,12,0,4,15,11,1,2,0,4772,4806,10
Task 4772,Job 1,8,7,3,7,0,11,15,4,3,2,1,4772,4806,15
Task 4773,Job 0,6,5,3,10,1,9,16,7,3,1,1,4773,4807,12
Task 4773,Job 1,11,7,4,10,0,15,21,6,4,3,2,4773,4807,15
Task 4774,Job 0,4,7,3,6,0,7,10,3,3,3,2,4774,4807,5
Task 4774,Job 1,9,9,3,11,0,12,20,8,3,1,0,4774,4807,2
Task 4775,Job 0,1,8,2,7,0,3,8,5,2,4,0,4775,4808,19
Task 4775,Job 1,6,7,3,11,0,9,17,8,3,3,0,4775,4808,2
Task 4776,Job 0,8,5,2,8,0,10,16,6,2,3,1,4776,4809,6
Task 4776,Job 1,13,6,1,7,0,14,20,6,1,3,2,4776,4809,20
Task 4777,Job 0,5,4,2,9,0,7,14,7,2,1,0,4777,4810,3
Task 4777,Job 1,10,5,1,7,0,11,17,6,1,4,2,4777,4810,17
Task 4778,Job 0,4,6,1,9,0,5,13,8,1,3,2,4778,4811,13
Task 4778,Job 1,9,10,4,6,0,13,15,2,4,1,0,4778,4811,11
Task 4779,Job 0,7,8,3,6,0,10,13,3,3,2,1,4779,4812,19
Task 4779,Job 1,12,7,2,10,0,14,22,8,2,3,0,4779,4812,19
Task 4780,Job 0,7,5,4,12,0,11,19,8,4,4,0,4780,4813,5
Task 4780,Job 1,12,8,2,10,0,14,22,8,2,1,1,4780,4813,19
Task 4781,Job 0,2,6,1,11,1,3,13,10,1,4,0,4781,4814,5
Task 4781,Job 1,7,6,1,6,0,8,13,5,1,4,2,4781,4814,13
Task 4782,Job 0,1,9,4,12,0,5,13,8,4,2,1,4782,4816,19
Task 4782,Job 1,6,10,2,7,1,8,13,5,2,3,2,4782,4816,19
Task 4783,Job 0,8,4,1,8,0,9,16,7,1,1,0,4783,4817,16
Task 4783,Job 1,13,8,4,11,0,17,24,7,4,3,0,4783,4817,10
Task 4784,Job 0,8,5,4,8,0,12,16,4,4,3,1,4784,4817,2
Task 4784,Job 1,13,7,4,9,0,17,22,5,4,3,1,4784,4817,20
Task 4785,Job 0,9,8,2,11,1,11,20,9,2,2,0,4785,4819,6
Task 4785,Job 1,14,8,3,6,0,17,20,3,3,4,0,4785,4819,4
Task 4786,Job 0,2,4,3,8,0,5,10,5,3,2,2,4786,4819,8
Task 4786,Job 1,7,9,2,10,0,9,17,8,2,1,0,4786,4819,8
Task 4787,Job 0,3,5,2,9,0,5,12,7,2,3,0,4787,4820,7
Task 4787,Job 1,8,5,2,12,0,10,20,10,2,1,0,4787,4820,4
Task 4788,Job 0,1,5,4,11,0,5,12,7,4,3,0,4788,4822,12
Task 4788,Job 1,6,10,1,12,0,7,18,11,1,4,2,4788,4822,16
Task 4789,Job 0,4,6,1,12,1,5,16,11,1,3,2,4789,4823,5
Task 4789,Job 1,9,7,3,9,0,12,18,6,3,4,1,4789,4823,6
Task 4790,Job 0,2,5,3,7,0,5,9,4,3,3,1,4790,4823,14
Task 4790,Job 1,7,4,3,8,0,10,15,5,3,2,2,4790,4823,8
Task 4791,Job 0,8,6,1,11,1,9,19,10,1,1,1,4791,4824,20
Task 4791,Job 1,13,4,4,6,1,17,19,2,4,1,0,4791,4824,20
Task 4792,Job 0,6,6,2,6,0,8,12,4,2,3,2,4792,4826,9
Task 4792,Job 1,11,8,3,9,0,14,20,6,3,3,0,4792,4826,4
Task 4793,Job 0,6,6,3,8,1,9,14,5,3,1,2,4793,4826,6
Task 4793,Job 1,11,5,3,12,0,14,23,9,3,2,1,4793,4826,2
Task 4794,Job 0,3,5,4,7,1,7,10,3,4,1,0,4794,4827,13
Task 4794,Job 1,8,6,4,7,0,12,15,3,4,4,0,4794,4827,6
Task 4795,Job 0,10,7,2,8,0,12,18,6,2,4,2,4795,4828,9
Task 4795,Job 1,15,8,1,7,1,16,22,6,1,2,2,4795,4828,18
Task 4796,Job 0,2,4,2,6,0,4,8,4,2,2,1,4796,4829,17
Task 4796,Job 1,7,4,3,9,0,10,16,6,3,3,2,4796,4829,20
Task 4797,Job 0,10,6,4,7,1,14,17,3,4,3,1,4797,4830,8
Task 4797,Job 1,15,10,3,12,1,18,27,9,3,4,0,4797,4830,3
Task 4798,Job 0,9,6,1,10,1,10,19,9,1,3,0,4798,4831,4
Task 4798,Job 1,14,8,1,10,0,15,24,9,1,2,2,4798,4831,3
Task 4799,Job 0,8,6,3,11,0,11,19,8,3,2,2,4799,4832,8
Task 4799,Job 1,13,4,2,10,0,15,23,8,2,1,0,4799,4832,12
Task 4800,Job 0,2,9,3,12,0,5,14,9,3,3,2,4800,4833,10
Task 4800,Job 1,7,4,4,7,0,11,14,3,4,1,0,4800,4833,15
Task 4801,Job 0,7,9,2,7,0,9,14,5,2,2,1,4801,4834,13
Task 4801,Job 1,12,5,3,10,0,15,22,7,3,3,1,4801,4834,15
Task 4802,Job 0,10,7,1,12,0,11,22,11,1,2,2,4802,4835,17
Task 4802,Job 1,15,4,4,12,0,19,27,8,4,1,0,4802,4835,8
Task 4803,Job 0,8,10,1,8,1,9,16,7,1,3,1,4803,4836,8
Task 4803,Job 1,13,8,4,8,0,17,21,4,4,4,0,4803,4836,4
Task 4804,Job 0,1,7,2,11,0,3,12,9,2,2,0,4804,4838,8
Task 4804,Job 1,6,5,3,6,0,9,12,3,3,4,0,4804,4838,6
Task 4805,Job 0,3,8,3,12,0,6,15,9,3,2,0,4805,4839,8
Task 4805,Job 1,8,5,4,7,0,12,15,3,4,4,2,4805,4839,9
Task 4806,Job 0,9,9,4,11,0,13,20,7,4,1,2,4806,4840,15
Task 4806,Job 1,14,8,3,7,0,17,21,4,3,2,0,4806,4840,6
Task 4807,Job 0,8,4,3,8,1,11,16,5,3,4,0,4807,4840,15
Task 4807,Job 1,13,7,2,10,0,15,23,8,2,1,2,4807,4840,7
Task 4808,Job 0,5,5,1,11,0,6,16,10,1,1,1,4808,4841,20
Task 4808,Job 1,10,6,4,9,0,14,19,5,4,1,1,4808,4841,19
Task 4809,Job 0,9,7,2,11,0,11,20,9,2,1,1,4809,4843,18
Task 4809,Job 1,14,5,1,12,1,15,26,11,1,4,0,4809,4843,16
Task 4810,Job 0,9,9,2,6,0,11,15,4,2,1,2,4810,4844,16
Task 4810,Job 1,14,8,4,10,0,18,24,6,4,1,1,4810,4844,18
Task 4811,Job 0,1,9,4,12,1,5,13,8,4,3,1,4811,4845,2
Task 4811,Job 1,6,8,3,11,0,9,17,8,3,1,2,4811,4845,10
Task 4812,Job 0,9,10,4,9,0,13,18,5,4,1,1,4812,4846,3
Task 4812,Job 1,14,9,3,7,0,17,21,4,3,2,0,4812,4846,15
Task 4813,Job 0,3,7,4,10,1,7,13,6,4,1,1,4813,4846,20
Task 4813,Job 1,8,7,4,10,0,12,18,6,4,2,0,4813,4846,4
Task 4814,Job 0,6,6,4,9,1,10,15,5,4,3,0,4814,4847,6
Task 4814,Job 1,11,6,1,7,0,12,18,6,1,4,0,4814,4847,6
Task 4815,Job 0,7,10,3,6,1,10,13,3,3,3,0,4815,4848,2
Task 4815,Job 1,12,8,1,7,0,13,19,6,1,2,0,4815,4848,20
Task 4816,Job 0,4,10,2,6,0,6,10,4,2,2,2,4816,4850,5
Task 4816,Job 1,9,8,1,6,0,10,15,5,1,3,0,4816,4850,13
Task 4817,Job 0,4,4,1,7,0,5,11,6,1,4,0,4817,4850,6
Task 4817,Job 1,9,4,1,12,0,10,21,11,1,1,1,4817,4850,7
Task 4818,Job 0,10,5,3,10,0,13,20,7,3,2,2,4818,4851,20
Task 4818,Job 1,15,7,3,7,0,18,22,4,3,4,2,4818,4851,18
Task 4819,Job 0,4,10,3,7,0,7,11,4,3,2,2,4819,4852,8
Task 4819,Job 1,9,7,2,6,1,11,15,4,2,4,0,4819,4852,11
Task 4820,Job 0,8,9,3,10,0,11,18,7,3,1,0,4820,4853,6
Task 4820,Job 1,13,4,4,9,0,17,22,5,4,3,0,4820,4853,19
Task 4821,Job 0,10,10,3,12,1,13,22,9,3,3,0,4821,4855,14
Task 4821,Job 1,15,5,3,6,0,18,21,3,3,1,0,4821,4855,17
Task 4822,Job 0,6,5,2,10,0,8,16,8,2,2,0,4822,4856,8
Task 4822,Job 1,11,8,1,12,0,12,23,11,1,2,2,4822,4856,15
Task 4823,Job 0,7,4,3,9,0,10,16,6,3,2,0,4823,4857,10
Task 4823,Job 1,12,5,4,10,1,16,22,6,4,2,0,4823,4857,14
Task 4824,Job 0,10,10,3,10,0,13,20,7,3,2,2,4824,4858,3
Task 4824,Job 1,15,9,4,9,0,19,24,5,4,3,2,4824,4858,3
Task 4825,Job 0,8,7,4,12,0,12,20,8,4,3,1,4825,4859,8
Task 4825,Job 1,13,10,1,9,0,14,22,8,1,4,1,4825,4859,15
Task 4826,Job 0,6,7,4,6,0,10,12,2,4,4,0,4826,4859,4
Task 4826,Job 1,11,10,1,7,1,12,18,6,1,3,2,4826,4859,17
Task 4827,Job 0,5,5,2,12,1,7,17,10,2,1,2,4827,4861,12
Task 4827,Job 1,10,9,1,7,1,11,17,6,1,3,0,4827,4861,4
Task 4828,Job 0,10,7,1,11,1,11,21,10,1,4,2,4828,4862,6
Task 4828,Job 1,15,9,3,8,0,18,23,5,3,2,0,4828,4862,9
Task 4829,Job 0,4,8,3,12,0,7,16,9,3,4,1,4829,4863,20
Task 4829,Job 1,9,7,4,10,0,13,19,6,4,3,0,4829,4863,15
Task 4830,Job 0,1,7,2,12,0,3,13,10,2,3,0,4830,4863,15
Task 4830,Job 1,6,9,4,9,0,10,15,5,4,3,0,4830,4863,9
Task 4831,Job 0,4,8,3,11,0,7,15,8,3,1,0,4831,4865,18
Task 4831,Job 1,9,5,2,7,0,11,16,5,2,2,2,4831,4865,16
Task 4832,Job 0,2,5,4,6,0,6,8,2,4,2,0,4832,4865,18
Task 4832,Job 1,7,4,1,11,1,8,18,10,1,3,0,4832,4865,9
Task 4833,Job 0,6,4,2,8,1,8,14,6,2,4,2,4833,4866,15
Task 4833,Job 1,11,10,3,12,0,14,23,9,3,2,1,4833,4866,6
Task 4834,Job 0,4,7,1,12,0,5,16,11,1,3,2,4834,4868,10
Task 4834,Job 1,9,10,3,11,0,12,20,8,3,2,2,4834,4868,15
Task 4835,Job 0,1,6,2,9,0,3,10,7,2,1,2,4835,4869,2
Task 4835,Job 1,6,5,2,12,0,8,18,10,2,2,0,4835,4869,11
Task 4836,Job 0,9,6,3,7,0,12,16,4,3,4,0,4836,4870,9
Task 4836,Job 1,14,6,1,10,0,15,24,9,1,3,1,4836,4870,17
Task 4837,Job 0,4,6,2,12,1,6,16,10,2,4,1,4837,4871,10
Task 4837,Job 1,9,7,3,8,1,12,17,5,3,2,1,4837,4871,18
Task 4838,Job 0,7,10,2,6,0,9,13,4,2,2,2,4838,4872,9
Task 4838,Job 1,12,7,2,12,0,14,24,10,2,1,2,4838,4872,17
Task 4839,Job 0,9,8,4,9,0,13,18,5,4,2,2,4839,4873,17
Task 4839,Job 1,14,7,2,9,0,16,23,7,2,4,2,4839,4873,2
Task 4840,Job 0,3,7,3,11,0,6,14,8,3,4,1,4840,4873,2
Task 4840,Job 1,8,8,2,8,1,10,16,6,2,3,0,4840,4873,13
Task 4841,Job 0,8,10,3,8,1,11,16,5,3,1,2,4841,4874,4
Task 4841,Job 1,13,7,3,10,1,16,23,7,3,3,0,4841,4874,11
Task 4842,Job 0,5,8,1,11,0,6,16,10,1,4,2,4842,4875,11
Task 4842,Job 1,10,4,1,12,0,11,22,11,1,1,0,4842,4875,14
Task 4843,Job 0,2,7,3,7,0,5,9,4,3,2,1,4843,4876,11
Task 4843,Job 1,7,7,1,8,1,8,15,7,1,1,1,4843,4876,6
Task 4844,Job 0,6,10,3,7,1,9,13,4,3,1,0,4844,4878,4
Task 4844,Job 1,11,9,3,12,1,14,23,9,3,4,0,4844,4878,19
Task 4845,Job 0,10,10,3,12,1,13,22,9,3,1,1,4845,4879,9
Task 4845,Job 1,15,6,1,8,1,16,23,7,1,2,2,4845,4879,7
Task 4846,Job 0,9,8,4,12,0,13,21,8,4,4,2,4846,4880,10
Task 4846,Job 1,14,5,3,7,0,17,21,4,3,2,1,4846,4880,6
Task 4847,Job 0,2,9,2,8,0,4,10,6,2,2,1,4847,4881,14
Task 4847,Job 1,7,4,1,9,1,8,16,8,1,3,2,4847,4881,2
Task 4848,Job 0,5,6,3,10,0,8,15,7,3,3,2,4848,4881,2
Task 4848,Job 1,10,7,4,10,1,14,20,6,4,1,0,4848,4881,14
Task 4849,Job 0,9,7,3,11,0,12,20,8,3,3,0,4849,4883,12
Task 4849,Job 1,14,4,3,11,0,17,25,8,3,4,2,4849,4883,6
Task 4850,Job 0,1,8,2,10,0,3,11,8,2,1,2,4850,4883,11
Task 4850,Job 1,6,10,3,7,0,9,13,4,3,4,2,4850,4883,13
Task 4851,Job 0,4,8,1,8,0,5,12,7,1,1,1,4851,4884,5
Task 4851,Job 1,9,7,1,9,0,10,18,8,1,4,2,4851,4884,15
Task 4852,Job 0,7,8,4,10,0,11,17,6,4,3,2,4852,4886,16
Task 4852,Job 1,12,5,2,6,0,14,18,4,2,3,2,4852,4886,17
Task 4853,Job 0,7,4,2,6,0,9,13,4,2,3,0,4853,4887,15
Task 4853,Job 1,12,10,4,11,1,16,23,7,4,1,0,4853,4887,2
Task 4854,Job 0,10,10,2,12,1,12,22,10,2,2,0,4854,4888,12
Task 4854,Job 1,15,6,1,12,0,16,27,11,1,3,0,4854,4888,20
Task 4855,Job 0,4,8,1,6,0,5,10,5,1,3,0,4855,4889,19
Task 4855,Job 1,9,6,1,10,0,10,19,9,1,4,1,4855,4889,7
Task 4856,Job 0,1,9,4,10,0,5,11,6,4,4,1,4856,4890,4
Task 4856,Job 1,6,5,1,10,0,7,16,9,1,2,2,4856,4890,14
Task 4857,Job 0,3,6,4,7,1,7,10,3,4,4,2,4857,4890,6
Task 4857,Job 1,8,5,4,10,0,12,18,6,4,4,0,4857,4890,11
Task 4858,Job 0,9,9,3,12,0,12,21,9,3,2,2,4858,4891,18
Task 4858,Job 1,14,4,2,12,0,16,26,10,2,4,2,4858,4891,18
Task 4859,Job 0,3,9,4,8,0,7,11,4,4,4,0,4859,4892,9
Task 4859,Job 1,8,4,3,8,0,11,16,5,3,1,1,4859,4892,6
Task 4860,Job 0,3,5,2,12,1,5,15,10,2,4,0,4860,4893,19
Task 4860,Job 1,8,8,2,12,1,10,20,10,2,4,2,4860,4893,17
Task 4861,Job 0,4,10,1,8,0,5,12,7,1,1,2,4861,4895,10
Task 4861,Job 1,9,9,4,8,1,13,17,4,4,4,2,4861,4895,13
Task 4862,Job 0,1,9,1,8,0,2,9,7,1,4,2,4862,4895,4
Task 4862,Job 1,6,5,1,7,0,7,13,6,1,3,0,4862,4895,14
Task 4863,Job 0,3,10,4,12,0,7,15,8,4,2,1,4863,4897,18
Task 4863,Job 1,8,8,3,12,0,11,20,9,3,1,0,4863,4897,7
Task 4864,Job 0,9,8,3,7,0,12,16,4,3,2,1,4864,4898,18
Task 4864,Job 1,14,8,3,12,0,17,26,9,3,3,0,4864,4898,4
Task 4865,Job 0,9,8,2,10,1,11,19,8,2,2,0,4865,4898,3
Task 4865,Job 1,14,8,4,11,0,18,25,7,4,2,1,4865,4898,13
Task 4866,Job 0,5,6,4,10,0,9,15,6,4,1,2,4866,4900,6
Task 4866,Job 1,10,8,1,11,0,11,21,10,1,2,2,4866,4900,3
Task 4867,Job 0,10,4,3,9,0,13,19,6,3,2,2,4867,4900,6
Task 4867,Job 1,15,9,1,6,0,16,21,5,1,4,0,4867,4900,11
Task 4868,Job 0,1,10,4,7,1,5,8,3,4,3,1,4868,4901,16
Task 4868,Job 1,6,4,4,12,1,10,18,8,4,2,1,4868,4901,6
Task 4869,Job 0,1,9,1,7,0,2,8,6,1,1,0,4869,4902,11
Task 4869,Job 1,6,10,2,6,1,8,12,4,2,2,2,4869,4902,2
Task 4870,Job 0,4,10,3,12,0,7,16,9,3,1,0,4870,4903,8
Task 4870,Job 1,9,7,2,8,0,11,17,6,2,3,1,4870,4903,18
Task 4871,Job 0,3,8,4,12,0,7,15,8,4,1,2,4871,4905,17
Task 4871,Job 1,8,4,2,11,1,10,19,9,2,3,2,4871,4905,11
Task 4872,Job 0,4,8,2,7,0,6,11,5,2,3,0,4872,4906,5
Task 4872,Job 1,9,10,1,8,0,10,17,7,1,4,2,4872,4906,11
Task 4873,Job 0,3,10,1,6,0,4,9,5,1,4,0,4873,4907,14
Task 4873,Job 1,8,8,3,11,1,11,19,8,3,3,1,4873,4907,7
Task 4874,Job 0,4,5,4,6,1,8,10,2,4,4,0,4874,4907,7
Task 4874,Job 1,9,7,2,11,0,11,20,9,2,3,1,4874,4907,16
Task 4875,Job 0,3,7,3,6,1,6,9,3,3,4,2,4875,4909,6
Task 4875,Job 1,8,6,3,6,0,11,14,3,3,3,0,4875,4909,11
Task 4876,Job 0,1,7,2,6,0,3,7,4,2,3,0,4876,4910,17
Task 4876,Job 1,6,6,3,7,0,9,13,4,3,3,1,4876,4910,3
Task 4877,Job 0,4,9,4,10,0,8,14,6,4,1,1,4877,4910,11
Task 4877,Job 1,9,9,3,8,0,12,17,5,3,4,1,4877,4910,18
Task 4878,Job 0,9,8,2,10,0,11,19,8,2,2,1,4878,4911,16
Task 4878,Job 1,14,5,3,8,0,17,22,5,3,2,0,4878,4911,4
Task 4879,Job 0,1,8,2,10,0,3,11,8,2,4,2,4879,4912,5
Task 4879,Job 1,6,6,1,7,0,7,13,6,1,2,1,4879,4912,8
Task 4880,Job 0,5,8,1,8,0,6,13,7,1,2,0,4880,4914,19
Task 4880,Job 1,10,5,2,10,0,12,20,8,2,4,0,4880,4914,2
Task 4881,Job 0,3,9,3,9,0,6,12,6,3,3,0,4881,4914,17
Task 4881,Job 1,8,10,2,12,1,10,20,10,2,3,2,4881,4914,14
Task 4882,Job 0,2,8,4,8,0,6,10,4,4,1,1,4882,4915,12
Task 4882,Job 1,7,10,4,9,0,11,16,5,4,2,0,4882,4915,12
Task 4883,Job 0,9,4,4,11,1,13,20,7,4,2,2,4883,4917,19
Task 4883,Job 1,14,9,1,11,0,15,25,10,1,3,2,4883,4917,19
Task 4884,Job 0,8,10,1,8,0,9,16,7,1,4,0,4884,4918,2
Task 4884,Job 1,13,9,4,9,0,17,22,5,4,2,2,4884,4918,17
Task 4885,Job 0,8,6,2,10,0,10,18,8,2,2,0,4885,4918,2
Task 4885,Job 1,13,5,4,12,1,17,25,8,4,2,0,4885,4918,14
Task 4886,Job 0,2,8,1,7,1,3,9,6,1,2,0,4886,4920,9
Task 4886,Job 1,7,6,3,9,0,10,16,6,3,3,0,4886,4920,17
Task 4887,Job 0,2,7,1,11,0,3,13,10,1,1,2,4887,4920,2
Task 4887,Job 1,7,5,4,9,0,11,16,5,4,2,2,4887,4920,20
Task 4888,Job 0,9,6,2,9,1,11,18,7,2,2,0,4888,4921,4
Task 4888,Job 1,14,4,1,8,0,15,22,7,1,1,2,4888,4921,13
Task 4889,Job 0,4,7,3,8,0,7,12,5,3,3,0,4889,4922,3
Task 4889,Job 1,9,10,4,6,0,13,15,2,4,2,2,4889,4922,6
Task 4890,Job 0,6,6,3,6,0,9,12,3,3,4,0,4890,4923,6
Task 4890,Job 1,11,8,2,11,0,13,22,9,2,4,0,4890,4923,5
Task 4891,Job 0,6,6,2,10,0,8,16,8,2,1,2,4891,4924,20
Task 4891,Job 1,11,7,2,7,0,13,18,5,2,2,1,4891,4924,13
Task 4892,Job 0,2,7,3,11,0,5,13,8,3,3,0,4892,4926,18
Task 4892,Job 1,7,8,2,11,1,9,18,9,2,1,0,4892,4926,5
Task 4893,Job 0,3,8,4,10,0,7,13,6,4,4,1,4893,4927,19
Task 4893,Job 1,8,7,1,10,1,9,18,9,1,4,1,4893,4927,18
Task 4894,Job 0,2,10,2,11,0,4,13,9,2,1,1,4894,4927,3
Task 4894,Job 1,7,4,1,7,0,8,14,6,1,3,1,4894,4927,2
Task 4895,Job 0,7,6,3,10,1,10,17,7,3,4,1,4895,4928,6
Task 4895,Job 1,12,9,3,12,0,15,24,9,3,2,1,4895,4928,11
Task 4896,Job 0,2,4,2,8,0,4,10,6,2,2,0,4896,4929,17
Task 4896,Job 1,7,4,4,7,0,11,14,3,4,3,1,4896,4929,10
Task 4897,Job 0,9,10,4,10,0,13,19,6,4,2,2,4897,4931,10
Task 4897,Job 1,14,10,1,8,0,15,22,7,1,1,1,4897,4931,18
Task 4898,Job 0,7,4,1,10,1,8,17,9,1,2,0,4898,4931,12
Task 4898,Job 1,12,8,4,12,0,16,24,8,4,1,1,4898,4931,19
Task 4899,Job 0,1,4,1,6,0,2,7,5,1,4,2,4899,4933,11
Task 4899,Job 1,6,7,2,8,0,8,14,6,2,4,2,4899,4933,20
Task 4900,Job 0,8,5,2,8,0,10,16,6,2,3,0,4900,4934,3
Task 4900,Job 1,13,6,1,9,0,14,22,8,1,3,0,4900,4934,15
Task 4901,Job 0,8,10,3,12,0,11,20,9,3,3,2,4901,4934,2
Task 4901,Job 1,13,10,2,10,0,15,23,8,2,1,0,4901,4934,11
Task 4902,Job 0,2,9,1,9,1,3,11,8,1,1,1,4902,4935,5
Task 4902,Job 1,7,6,2,7,0,9,14,5,2,2,1,4902,4935,3
Task 4903,Job 0,3,6,2,9,0,5,12,7,2,1,2,4903,4937,2
Task 4903,Job 1,8,10,1,8,0,9,16,7,1,2,0,4903,4937,8
Task 4904,Job 0,9,4,1,10,0,10,19,9,1,1,1,4904,4938,8
Task 4904,Job 1,14,8,1,8,1,15,22,7,1,2,1,4904,4938,19
Task 4905,Job 0,2,7,4,7,0,6,9,3,4,1,2,4905,4939,5
Task 4905,Job 1,7,10,2,9,0,9,16,7,2,1,1,4905,4939,16
Task 4906,Job 0,4,9,3,10,0,7,14,7,3,3,2,4906,4939,9
Task 4906,Job 1,9,6,3,12,0,12,21,9,3,3,0,4906,4939,2
Task 4907,Job 0,8,9,4,12,0,12,20,8,4,2,1,4907,4940,4
Task 4907,Job 1,13,8,4,9,0,17,22,5,4,4,2,4907,4940,10
Task 4908,Job 0,7,10,1,11,1,8,18,10,1,4,1,4908,4941,17
Task 4908,Job 1,12,9,4,11,0,16,23,7,4,2,1,4908,4941,15
Task 4909,Job 0,2,6,1,11,0,3,13,10,1,3,2,4909,4942,12
Task 4909,Job 1,7,6,4,7,1,11,14,3,4,1,1,4909,4942,8
Task 4910,Job 0,3,10,2,7,0,5,10,5,2,2,2,4910,4943,6
Task 4910,Job 1,8,4,2,8,0,10,16,6,2,1,0,4910,4943,13
Task 4911,Job 0,9,6,1,11,0,10,20,10,1,3,2,4911,4945,19
Task 4911,Job 1,14,5,4,12,0,18,26,8,4,1,2,4911,4945,18
Task 4912,Job 0,1,9,2,6,0,3,7,4,2,2,0,4912,4946,13
Task 4912,Job 1,6,8,3,11,0,9,17,8,3,1,1,4912,4946,7
Task 4913,Job 0,2,10,2,6,0,4,8,4,2,3,0,4913,4946,8
Task 4913,Job 1,7,6,2,11,0,9,18,9,2,4,2,4913,4946,18
Task 4914,Job 0,2,6,4,12,0,6,14,8,4,2,0,4914,4947,16
Task 4914,Job 1,7,9,3,8,0,10,15,5,3,3,2,4914,4947,16
Task 4915,Job 0,4,7,2,7,0,6,11,5,2,1,2,4915,4949,2
Task 4915,Job 1,9,5,1,7,0,10,16,6,1,4,1,4915,4949,15
Task 4916,Job 0,1,7,3,11,0,4,12,8,3,4,2,4916,4949,6
Task 4916,Job 1,6,7,2,11,0,8,17,9,2,3,1,4916,4949,16
Task 4917,Job 0,1,9,1,9,1,2,10,8,1,2,0,4917,4951,19
Task 4917,Job 1,6,4,1,12,0,7,18,11,1,3,1,4917,4951,10
Task 4918,Job 0,4,4,1,7,0,5,11,6,1,2,0,4918,4952,17
Task 4918,Job 1,9,4,1,6,0,10,15,5,1,3,0,4918,4952,14
Task 4919,Job 0,5,9,1,12,0,6,17,11,1,3,0,4919,4952,11
Task 4919,Job 1,10,5,4,7,0,14,17,3,4,1,2,4919,4952,15
Task 4920,Job 0,7,4,1,7,0,8,14,6,1,3,2,4920,4954,17
Task 4920,Job 1,12,6,4,10,0,16,22,6,4,1,2,4920,4954,20
Task 4921,Job 0,10,5,3,8,0,13,18,5,3,2,2,4921,4954,18
Task 4921,Job 1,15,4,3,8,0,18,23,5,3,3,1,4921,4954,15
Task 4922,Job 0,3,6,4,11,0,7,14,7,4,2,1,4922,4956,14
Task 4922,Job 1,8,10,4,7,0,12,15,3,4,3,1,4922,4956,11
Task 4923,Job 0,10,10,3,10,0,13,20,7,3,2,0,4923,4956,19
Task 4923,Job 1,15,6,1,6,1,16,21,5,1,4,1,4923,4956,20
Task 4924,Job 0,3,10,2,7,0,5,10,5,2,2,0,4924,4957,8
Task 4924,Job 1,8,4,2,7,0,10,15,5,2,4,0,4924,4957,17
Task 4925,Job 0,7,9,4,12,1,11,19,8,4,4,0,4925,4959,4
Task 4925,Job 1,12,7,4,8,1,16,20,4,4,2,2,4925,4959,14
Task 4926,Job 0,1,7,3,12,0,4,13,9,3,4,2,4926,4960,9
Task 4926,Job 1,6,4,1,6,0,7,12,5,1,1,2,4926,4960,20
Task 4927,Job 0,4,5,4,11,0,8,15,7,4,2,1,4927,4960,4
Task 4927,Job 1,9,5,2,10,0,11,19,8,2,4,2,4927,4960,10
Task 4928,Job 0,6,9,3,10,0,9,16,7,3,4,0,4928,4961,19
Task 4928,Job 1,11,7,1,6,0,12,17,5,1,3,0,4928,4961,9
Task 4929,Job 0,2,6,4,7,0,6,9,3,4,2,0,4929,4962,5
Task 4929,Job 1,7,9,4,7,0,11,14,3,4,2,1,4929,4962,18
Task 4930,Job 0,5,8,4,7,1,9,12,3,4,3,2,4930,4964,14
Task 4930,Job 1,10,6,3,9,0,13,19,6,3,3,2,4930,4964,4
Task 4931,Job 0,7,7,2,11,1,9,18,9,2,1,1,4931,4965,9
Task 4931,Job 1,12,10,4,9,0,16,21,5,4,1,1,4931,4965,4
Task 4932,Job 0,9,5,1,11,0,10,20,10,1,3,1,4932,4965,17
Task 4932,Job 1,14,6,2,8,0,16,22,6,2,1,1,4932,4965,12
Task 4933,Job 0,2,4,3,7,0,5,9,4,3,3,0,4933,4966,13
Task 4933,Job 1,7,9,1,9,0,8,16,8,1,4,2,4933,4966,9
Task 4934,Job 0,8,8,1,7,1,9,15,6,1,4,0,4934,4968,16
Task 4934,Job 1,13,7,2,6,0,15,19,4,2,4,2,4934,4968,12
Task 4935,Job 0,4,10,1,12,0,5,16,11,1,4,1,4935,4968,20
Task 4935,Job 1,9,4,1,6,1,10,15,5,1,2,0,4935,4968,7
Task 4936,Job 0,7,7,1,12,0,8,19,11,1,1,1,4936,4970,16
Task 4936,Job 1,12,8,3,7,0,15,19,4,3,4,1,4936,4970,9
Task 4937,Job 0,1,7,2,11,0,3,12,9,2,1,0,4937,4971,18
Task 4937,Job 1,6,9,2,7,0,8,13,5,2,3,2,4937,4971,11
Task 4938,Job 0,1,10,1,8,0,2,9,7,1,3,2,4938,4971,7
Task 4938,Job 1,6,4,4,8,0,10,14,4,4,1,1,4938,4971,13
Task 4939,Job 0,6,7,4,10,0,10,16,6,4,2,0,4939,4973,13
Task 4939,Job 1,11,4,4,12,0,15,23,8,4,4,1,4939,4973,14
Task 4940,Job 0,6,10,3,10,0,9,16,7,3,4,1,4940,4973,17
Task 4940,Job 1,11,6,1,11,1,12,22,10,1,4,0,4940,4973,11
Task 4941,Job 0,5,6,1,9,1,6,14,8,1,4,2,4941,4975,6
Task 4941,Job 1,10,9,1,11,1,11,21,10,1,1,0,4941,4975,4
Task 4942,Job 0,7,6,1,7,1,8,14,6,1,1,2,4942,4976,11
Task 4942,Job 1,12,8,1,8,0,13,20,7,1,3,1,4942,4976,12
Task 4943,Job 0,10,7,3,7,1,13,17,4,3,2,0,4943,4977,7
Task 4943,Job 1,15,7,4,11,1,19,26,7,4,2,1,4943,4977,14
Task 4944,Job 0,2,10,2,8,0,4,10,6,2,4,1,4944,4978,7
Task 4944,Job 1,7,6,2,6,1,9,13,4,2,4,0,4944,4978,17
Task 4945,Job 0,7,9,4,8,0,11,15,4,4,4,1,4945,4978,3
Task 4945,Job 1,12,8,1,8,1,13,20,7,1,3,1,4945,4978,9
Task 4946,Job 0,9,10,1,6,0,10,15,5,1,2,2,4946,4979,14
Task 4946,Job 1,14,9,4,8,0,18,22,4,4,3,2,4946,4979,14
Task 4947,Job 0,10,4,2,11,0,12,21,9,2,1,0,4947,4980,9
Task 4947,Job 1,15,10,2,9,0,17,24,7,2,2,2,4947,4980,5
Task 4948,Job 0,2,10,1,8,1,3,10,7,1,4,0,4948,4981,5
Task 4948,Job 1,7,4,4,7,1,11,14,3,4,3,2,4948,4981,9
Task 4949,Job 0,4,7,3,6,0,7,10,3,3,2,1,4949,4983,3
Task 4949,Job 1,9,4,1,11,0,10,20,10,1,1,2,4949,4983,9
Task 4950,Job 0,7,8,2,8,0,9,15,6,2,1,2,4950,4983,10
Task 4950,Job 1,12,7,2,8,0,14,20,6,2,3,2,4950,4983,15
Task 4951,Job 0,5,5,2,7,0,7,12,5,2,1,1,4951,4984,8
Task 4951,Job 1,10,10,2,8,0,12,18,6,2,1,1,4951,4984,16
Task 4952,Job 0,4,9,2,6,0,6,10,4,2,4,0,4952,4986,5
Task 4952,Job 1,9,10,4,12,1,13,21,8,4,1,0,4952,4986,16
Task 4953,Job 0,3,7,3,8,0,6,11,5,3,1,2,4953,4987,8
Task 4953,Job 1,8,10,1,9,1,9,17,8,1,4,2,4953,4987,14
Task 4954,Job 0,6,6,4,9,0,10,15,5,4,3,0,4954,4987,3
Task 4954,Job 1,11,10,2,11,1,13,22,9,2,2,0,4954,4987,8
Task 4955,Job 0,6,9,2,10,0,8,16,8,2,4,0,4955,4988,13
Task 4955,Job 1,11,7,3,8,1,14,19,5,3,1,0,4955,4988,19
Task 4956,Job 0,1,7,4,10,0,5,11,6,4,1,1,4956,4989,4
Task 4956,Job 1,6,6,3,10,0,9,16,7,3,2,2,4956,4989,2
Task 4957,Job 0,6,9,3,6,0,9,12,3,3,3,1,4957,4990,15
Task 4957,Job 1,11,4,2,6,0,13,17,4,2,1,0,4957,4990,20
Task 4958,Job 0,10,4,1,10,1,11,20,9,1,1,1,4958,4992,16
Task 4958,Job 1,15,8,2,8,0,17,23,6,2,3,0,4958,4992,10
Task 4959,Job 0,8,5,4,6,0,12,14,2,4,1,2,4959,4992,3
Task 4959,Job 1,13,5,3,11,0,16,24,8,3,1,2,4959,4992,7
Task 4960,Job 0,4,4,4,7,1,8,11,3,4,4,1,4960,4993,4
Task 4960,Job 1,9,7,2,11,0,11,20,9,2,2,1,4960,4993,16
Task 4961,Job 0,5,7,4,9,0,9,14,5,4,4,2,4961,4994,9
Task 4961,Job 1,10,8,2,12,0,12,22,10,2,2,2,4961,4994,14
Task 4962,Job 0,6,6,1,7,1,7,13,6,1,3,0,4962,4995,6
Task 4962,Job 1,11,9,1,6,0,12,17,5,1,2,2,4962,4995,3
Task 4963,Job 0,10,4,3,7,0,13,17,4,3,3,1,4963,4997,17
Task 4963,Job 1,15,7,3,9,0,18,24,6,3,1,1,4963,4997,2
Task 4964,Job 0,2,9,3,7,0,5,9,4,3,4,0,4964,4998,13
Task 4964,Job 1,7,6,1,8,0,8,15,7,1,4,2,4964,4998,3
Task 4965,Job 0,3,9,3,11,0,6,14,8,3,4,1,4965,4999,15
Task 4965,Job 1,8,8,3,9,0,11,17,6,3,4,0,4965,4999,12
Task 4966,Job 0,2,5,4,11,0,6,13,7,4,1,0,4966,4999,10
Task 4966,Job 1,7,8,3,6,0,10,13,3,3,4,0,4966,4999,3
Task 4967,Job 0,7,5,2,12,0,9,19,10,2,2,1,4967,5000,6
Task 4967,Job 1,12,6,2,11,0,14,23,9,2,1,2,4967,5000,3
Task 4968,Job 0,4,7,3,12,0,7,16,9,3,1,0,4968,5001,11
Task 4968,Job 1,9,10,1,12,1,10,21,11,1,4,1,4968,5001,17
Task 4969,Job 0,8,8,4,7,0,12,15,3,4,3,1,4969,5002,6
Task 4969,Job 1,13,8,4,12,0,17,25,8,4,3,0,4969,5002,20
Task 4970,Job 0,7,4,4,6,0,11,13,2,4,4,1,4970,5004,4
Task 4970,Job 1,12,4,3,11,1,15,23,8,3,3,2,4970,5004,15
Task 4971,Job 0,7,5,1,10,0,8,17,9,1,2,0,4971,5005,10
Task 4971,Job 1,12,4,3,6,1,15,18,3,3,3,0,4971,5005,3
Task 4972,Job 0,10,10,1,8,1,11,18,7,1,4,0,4972,5005,16
Task 4972,Job 1,15,8,4,6,0,19,21,2,4,1,0,4972,5005,6
Task 4973,Job 0,7,8,4,11,0,11,18,7,4,4,2,4973,5006,17
Task 4973,Job 1,12,10,1,12,0,13,24,11,1,2,2,4973,5006,11
Task 4974,Job 0,6,9,4,9,0,10,15,5,4,1,2,4974,5007,16
Task 4974,Job 1,11,7,2,10,1,13,21,8,2,2,0,4974,5007,9
Task 4975,Job 0,7,10,4,7,1,11,14,3,4,3,1,4975,5008,14
Task 4975,Job 1,12,9,1,12,0,13,24,11,1,1,0,4975,5008,18
Task 4976,Job 0,9,8,2,10,0,11,19,8,2,3,2,4976,5010,10
Task 4976,Job 1,14,9,2,12,1,16,26,10,2,1,0,4976,5010,6
Task 4977,Job 0,3,5,4,10,0,7,13,6,4,3,0,4977,5010,15
Task 4977,Job 1,8,4,3,6,0,11,14,3,3,3,0,4977,5010,2
Task 4978,Job 0,2,10,1,8,0,3,10,7,1,4,2,4978,5012,13
Task 4978,Job 1,7,10,1,8,0,8,15,7,1,3,2,4978,5012,11
Task 4979,Job 0,2,10,2,6,0,4,8,4,2,2,0,4979,5013,16
Task 4979,Job 1,7,6,4,6,0,11,13,2,4,1,2,4979,5013,8
Task 4980,Job 0,9,5,3,10,1,12,19,7,3,3,0,4980,5014,18
Task 4980,Job 1,14,10,2,8,0,16,22,6,2,4,1,4980,5014,8
Task 4981,Job 0,7,8,2,10,0,9,17,8,2,3,1,4981,5014,14
Task 4981,Job 1,12,10,1,11,1,13,23,10,1,4,0,4981,5014,12
Task 4982,Job 0,6,4,1,12,0,7,18,11,1,1,1,4982,5016,4
Task 4982,Job 1,11,7,1,9,0,12,20,8,1,4,0,4982,5016,10
Task 4983,Job 0,6,9,2,6,0,8,12,4,2,1,0,4983,5016,3
Task 4983,Job 1,11,6,1,12,0,12,23,11,1,3,2,4983,5016,10
Task 4984,Job 0,9,9,1,12,1,10,21,11,1,4,1,4984,5018,14
Task 4984,Job 1,14,6,4,8,1,18,22,4,4,2,2,4984,5018,11
Task 4985,Job 0,1,6,1,9,1,2,10,8,1,2,2,4985,5018,7
Task 4985,Job 1,6,6,2,6,1,8,12,4,2,1,1,4985,5018,16
Task 4986,Job 0,9,7,4,6,0,13,15,2,4,4,0,4986,5020,18
Task 4986,Job 1,14,4,2,9,0,16,23,7,2,2,1,4986,5020,9
Task 4987,Job 0,9,6,3,12,0,12,21,9,3,4,0,4987,5021,14
Task 4987,Job 1,14,10,4,11,1,18,25,7,4,4,1,4987,5021,8
Task 4988,Job 0,1,9,3,9,0,4,10,6,3,3,0,4988,5022,2
Task 4988,Job 1,6,9,3,9,0,9,15,6,3,4,0,4988,5022,10
Task 4989,Job 0,8,4,3,11,0,11,19,8,3,1,1,4989,5023,18
Task 4989,Job 1,13,10,3,11,0,16,24,8,3,4,1,4989,5023,12
Task 4990,Job 0,3,10,4,9,0,7,12,5,4,4,1,4990,5024,13
Task 4990,Job 1,8,4,4,6,0,12,14,2,4,4,2,4990,5024,15
Task 4991,Job 0,6,4,2,12,0,8,18,10,2,4,1,4991,5024,4
Task 4991,Job 1,11,8,4,10,0,15,21,6,4,4,0,4991,5024,10
Task 4992,Job 0,6,8,4,7,0,10,13,3,4,3,0,4992,5026,15
Task 4992,Job 1,11,8,3,9,0,14,20,6,3,4,1,4992,5026,10
Task 4993,Job 0,6,7,1,9,0,7,15,8,1,2,1,4993,5027,19
Task 4993,Job 1,11,10,1,9,1,12,20,8,1,1,1,4993,5027,20
Task 4994,Job 0,7,7,3,6,1,10,13,3,3,4,0,4994,5027,20
Task 4994,Job 1,12,10,3,8,0,15,20,5,3,1,1,4994,5027,5
Task 4995,Job 0,10,9,2,7,0,12,17,5,2,2,1,4995,5028,14
Task 4995,Job 1,15,4,4,11,0,19,26,7,4,4,1,4995,5028,10
Task 4996,Job 0,9,6,4,12,1,13,21,8,4,3,1,4996,5029,2
Task 4996,Job 1,14,10,4,9,0,18,23,5,4,3,2,4996,5029,20
Task 4997,Job 0,10,6,3,11,0,13,21,8,3,2,2,4997,5030,17
Task 4997,Job 1,15,7,1,10,0,16,25,9,1,2,1,4997,5030,8
Task 4998,Job 0,6,7,4,6,1,10,12,2,4,4,0,4998,5032,18
Task 4998,Job 1,11,4,4,10,0,15,21,6,4,3,0,4998,5032,18
Task 4999,Job 0,5,5,4,12,0,9,17,8,4,2,0,4999,5032,19
Task 4999,Job 1,10,6,4,8,0,14,18,4,4,4,2,4999,5032,6
Task 5000,Job 0,2,4,4,7,0,6,9,3,4,4,1,5000,5034,16
Task 5000,Job 1,7,8,3,9,0,10,16,6,3,3,2,5000,5034,14
Task 5001,Job 0,1,8,2,9,0,3,10,7,2,2,2,5001,5034,18
Task 5001,Job 1,6,9,3,11,0,9,17,8,3,1,0,5001,5034,3
Task 5002,Job 0,1,5,1,12,0,2,13,11,1,1,1,5002,5036,9
Task 5002,Job 1,6,8,2,10,0,8,16,8,2,1,1,5002,5036,20
Task 5003,Job 0,2,4,4,12,0,6,14,8,4,2,1,5003,5036,11
Task 5003,Job 1,7,8,4,6,1,11,13,2,4,4,0,5003,5036,15
Task 5004,Job 0,3,6,1,12,1,4,15,11,1,4,2,5004,5037,11
Task 5004,Job 1,8,6,3,8,0,11,16,5,3,3,2,5004,5037,19
Task 5005,Job 0,10,4,4,9,0,14,19,5,4,3,1,5005,5038,16
Task 5005,Job 1,15,10,2,11,0,17,26,9,2,1,0,5005,5038,9
Task 5006,Job 0,5,8,3,11,0,8,16,8,3,3,2,5006,5040,4
Task 5006,Job 1,10,8,1,12,0,11,22,11,1,3,1,5006,5040,18
Task 5007,Job 0,7,9,1,11,0,8,18,10,1,2,0,5007,5041,16
Task 5007,Job 1,12,8,4,9,1,16,21,5,4,1,1,5007,5041,11
Task 5008,Job 0,9,4,4,6,0,13,15,2,4,3,2,5008,5041,18
Task 5008,Job 1,14,10,1,7,1,15,21,6,1,4,1,5008,5041,17
Task 5009,Job 0,7,8,1,11,1,8,18,10,1,1,2,5009,5043,7
Task 5009,Job 1,12,6,4,10,0,16,22,6,4,3,2,5009,5043,10
Task 5010,Job 0,7,8,4,8,0,11,15,4,4,1,1,5010,5044,7
Task 5010,Job 1,12,7,1,12,0,13,24,11,1,3,0,5010,5044,8
Task 5011,Job 0,6,4,4,9,0,10,15,5,4,1,2,5011,5044,2
Task 5011,Job 1,11,4,3,7,0,14,18,4,3,1,1,5011,5044,9
Task 5012,Job 0,1,8,4,10,0,5,11,6,4,4,0,5012,5046,10
Task 5012,Job 1,6,6,2,12,0,8,18,10,2,2,0,5012,5046,15
Task 5013,Job 0,7,10,4,11,0,11,18,7,4,2,2,5013,5047,20
Task 5013,Job 1,12,5,1,8,0,13,20,7,1,1,1,5013,5047,4
Task 5014,Job 0,8,5,4,8,1,12,16,4,4,3,0,5014,5047,8
Task 5014,Job 1,13,6,3,12,1,16,25,9,3,2,0,5014,5047,4
Task 5015,Job 0,1,6,1,6,0,2,7,5,1,1,0,5015,5049,14
Task 5015,Job 1,6,4,2,8,1,8,14,6,2,4,0,5015,5049,3
Task 5016,Job 0,10,10,3,11,1,13,21,8,3,2,1,5016,5050,18
Task 5016,Job 1,15,6,4,6,0,19,21,2,4,1,2,5016,5050,12
Task 5017,Job 0,9,4,3,12,1,12,21,9,3,1,1,5017,5051,7
Task 5017,Job 1,14,5,2,7,1,16,21,5,2,4,2,5017,5051,19
Task 5018,Job 0,8,8,3,6,0,11,14,3,3,1,1,5018,5052,4
Task 5018,Job 1,13,7,2,8,1,15,21,6,2,4,1,5018,5052,12
Task 5019,Job 0,6,7,1,7,1,7,13,6,1,1,1,5019,5053,18
Task 5019,Job 1,11,9,4,12,0,15,23,8,4,1,1,5019,5053,15
Task 5020,Job 0,10,6,2,12,0,12,22,10,2,3,1,5020,5053,11
Task 5020,Job 1,15,8,1,11,0,16,26,10,1,1,1,5020,5053,6
Task 5021,Job 0,9,9,3,10,1,12,19,7,3,2,0,5021,5055,10
Task 5021,Job 1,14,4,3,7,0,17,21,4,3,3,1,5021,5055,8
Task 5022,Job 0,9,8,2,6,0,11,15,4,2,2,1,5022,5055,9
Task 5022,Job 1,14,4,3,8,0,17,22,5,3,2,0,5022,5055,4
Task 5023,Job 0,9,6,4,9,1,13,18,5,4,2,2,5023,5057,19
Task 5023,Job 1,14,6,1,9,0,15,23,8,1,1,1,5023,5057,18
Task 5024,Job 0,6,9,1,11,0,7,17,10,1,4,2,5024,5058,6
Task 5024,Job 1,11,6,3,8,0,14,19,5,3,1,1,5024,5058,10
Task 5025,Job 0,3,10,2,11,1,5,14,9,2,2,1,5025,5058,12
Task 5025,Job 1,8,6,3,10,0,11,18,7,3,1,1,5025,5058,12
Task 5026,Job 0,10,10,3,8,1,13,18,5,3,2,0,5026,5060,10
Task 5026,Job 1,15,5,2,6,0,17,21,4,2,4,1,5026,5060,18
Task 5027,Job 0,3,5,1,7,0,4,10,6,1,3,0,5027,5061,20
Task 5027,Job 1,8,4,1,9,0,9,17,8,1,4,1,5027,5061,10
Task 5028,Job 0,10,9,1,9,0,11,19,8,1,1,1,5028,5062,18
Task 5028,Job 1,15,8,2,11,0,17,26,9,2,4,0,5028,5062,6
Task 5029,Job 0,6,8,1,8,1,7,14,7,1,2,0,5029,5063,19
Task 5029,Job 1,11,6,4,8,0,15,19,4,4,3,1,5029,5063,5
Task 5030,Job 0,5,10,2,6,1,7,11,4,2,2,1,5030,5064,7
Task 5030,Job 1,10,5,4,9,0,14,19,5,4,4,2,5030,5064,5
Task 5031,Job 0,7,6,3,12,0,10,19,9,3,4,1,5031,5065,16
Task 5031,Job 1,12,7,2,6,0,14,18,4,2,3,0,5031,5065,8
Task 5032,Job 0,5,9,3,6,0,8,11,3,3,2,2,5032,5066,12
Task 5032,Job 1,10,8,3,6,0,13,16,3,3,4,2,5032,5066,14
Task 5033,Job 0,4,4,4,10,0,8,14,6,4,2,1,5033,5066,9
Task 5033,Job 1,9,8,3,6,1,12,15,3,3,2,0,5033,5066,6
Task 5034,Job 0,8,6,4,8,1,12,16,4,4,3,1,5034,5068,4
Task 5034,Job 1,13,6,2,11,0,15,24,9,2,2,0,5034,5068,8
Task 5035,Job 0,3,6,3,9,0,6,12,6,3,4,2,5035,5069,9
Task 5035,Job 1,8,9,3,9,0,11,17,6,3,2,1,5035,5069,3
Task 5036,Job 0,10,9,2,6,0,12,16,4,2,1,1,5036,5069,9
Task 5036,Job 1,15,4,3,10,0,18,25,7,3,3,0,5036,5069,20
Task 5037,Job 0,4,9,2,6,1,6,10,4,2,2,2,5037,5071,14
Task 5037,Job 1,9,10,4,7,0,13,16,3,4,4,2,5037,5071,9
Task 5038,Job 0,3,4,3,9,0,6,12,6,3,4,2,5038,5071,14
Task 5038,Job 1,8,10,2,8,0,10,16,6,2,1,1,5038,5071,14
Task 5039,Job 0,1,8,1,12,1,2,13,11,1,3,1,5039,5072,8
Task 5039,Job 1,6,7,3,9,0,9,15,6,3,2,0,5039,5072,11
Task 5040,Job 0,2,10,2,8,0,4,10,6,2,4,2,5040,5073,10
Task 5040,Job 1,7,10,2,10,0,9,17,8,2,2,2,5040,5073,14
Task 5041,Job 0,5,6,3,9,0,8,14,6,3,2,2,5041,5075,5
Task 5041,Job 1,10,5,2,10,0,12,20,8,2,4,2,5041,5075,12
Task 5042,Job 0,6,9,2,6,0,8,12,4,2,3,2,5042,5076,4
Task 5042,Job 1,11,9,1,9,0,12,20,8,1,1,0,5042,5076,11
Task 5043,Job 0,1,6,4,10,0,5,11,6,4,3,0,5043,5077,4
Task 5043,Job 1,6,9,2,10,0,8,16,8,2,3,0,5043,5077,14
Task 5044,Job 0,4,10,1,7,1,5,11,6,1,2,2,5044,5078,18
Task 5044,Job 1,9,9,4,7,0,13,16,3,4,1,0,5044,5078,13
Task 5045,Job 0,8,6,2,9,0,10,17,7,2,4,1,5045,5079,19
Task 5045,Job 1,13,8,3,6,0,16,19,3,3,4,1,5045,5079,13
Task 5046,Job 0,2,10,2,6,0,4,8,4,2,2,0,5046,5079,8
Task 5046,Job 1,7,5,3,8,0,10,15,5,3,2,0,5046,5079,20
Task 5047,Job 0,10,8,2,9,0,12,19,7,2,1,2,5047,5081,10
Task 5047,Job 1,15,5,1,9,0,16,24,8,1,4,0,5047,5081,2
Task 5048,Job 0,10,5,4,12,0,14,22,8,4,1,2,5048,5081,11
Task 5048,Job 1,15,7,3,6,0,18,21,3,3,4,2,5048,5081,3
Task 5049,Job 0,9,9,2,9,0,11,18,7,2,2,0,5049,5082,11
Task 5049,Job 1,14,9,2,11,0,16,25,9,2,4,1,5049,5082,9
Task 5050,Job 0,2,10,2,10,1,4,12,8,2,3,2,5050,5084,6
Task 5050,Job 1,7,4,3,12,0,10,19,9,3,2,0,5050,5084,17
Task 5051,Job 0,5,8,1,10,0,6,15,9,1,3,2,5051,5085,18
Task 5051,Job 1,10,10,1,6,1,11,16,5,1,1,1,5051,5085,15
Task 5052,Job 0,9,8,1,9,0,10,18,8,1,2,1,5052,5085,13
Task 5052,Job 1,14,6,2,9,1,16,23,7,2,2,2,5052,5085,15
Task 5053,Job 0,5,5,4,12,0,9,17,8,4,1,2,5053,5086,7
Task 5053,Job 1,10,9,3,11,0,13,21,8,3,1,2,5053,5086,8
Task 5054,Job 0,6,6,4,8,0,10,14,4,4,1,1,5054,5088,15
Task 5054,Job 1,11,5,2,11,1,13,22,9,2,3,1,5054,5088,10
Task 5055,Job 0,3,5,4,12,0,7,15,8,4,3,1,5055,5089,10
Task 5055,Job 1,8,5,3,9,0,11,17,6,3,1,0,5055,5089,16
Task 5056,Job 0,6,10,1,11,0,7,17,10,1,3,0,5056,5089,6
Task 5056,Job 1,11,6,1,10,1,12,21,9,1,3,0,5056,5089,13
Task 5057,Job 0,8,4,1,7,0,9,15,6,1,3,1,5057,5091,2
Task 5057,Job 1,13,8,3,12,0,16,25,9,3,3,2,5057,5091,14
Task 5058,Job 0,9,7,1,9,1,10,18,8,1,3,2,5058,5092,4
Task 5058,Job 1,14,10,1,6,0,15,20,5,1,1,0,5058,5092,8
Task 5059,Job 0,7,6,3,8,0,10,15,5,3,1,1,5059,5093,19
Task 5059,Job 1,12,5,3,10,0,15,22,7,3,4,2,5059,5093,6
Task 5060,Job 0,3,9,2,7,1,5,10,5,2,2,2,5060,5094,2
Task 5060,Job 1,8,4,2,9,0,10,17,7,2,3,0,5060,5094,5
Task 5061,Job 0,5,4,4,11,1,9,16,7,4,1,1,5061,5095,15
Task 5061,Job 1,10,8,1,10,0,11,20,9,1,2,2,5061,5095,11
Task 5062,Job 0,5,7,1,12,1,6,17,11,1,1,1,5062,5096,17
Task 5062,Job 1,10,4,2,6,1,12,16,4,2,1,0,5062,5096,15
Task 5063,Job 0,1,4,1,9,1,2,10,8,1,2,2,5063,5097,5
Task 5063,Job 1,6,6,1,11,0,7,17,10,1,2,1,5063,5097,7
Task 5064,Job 0,5,5,3,12,0,8,17,9,3,4,0,5064,5097,2
Task 5064,Job 1,10,6,4,10,0,14,20,6,4,3,0,5064,5097,6
Task 5065,Job 0,1,5,3,9,0,4,10,6,3,1,1,5065,5098,17
Task 5065,Job 1,6,8,3,9,0,9,15,6,3,3,0,5065,5098,12
Task 5066,Job 0,10,6,4,6,1,14,16,2,4,1,2,5066,5099,14
Task 5066,Job 1,15,7,2,12,0,17,27,10,2,1,0,5066,5099,16
Task 5067,Job 0,4,8,4,9,0,8,13,5,4,2,1,5067,5100,8
Task 5067,Job 1,9,7,4,8,1,13,17,4,4,4,2,5067,5100,15
Task 5068,Job 0,2,5,2,12,0,4,14,10,2,3,0,5068,5101,16
Task 5068,Job 1,7,7,2,12,1,9,19,10,2,2,1,5068,5101,4
Task 5069,Job 0,8,9,2,7,0,10,15,5,2,3,0,5069,5103,4
Task 5069,Job 1,13,7,3,11,0,16,24,8,3,3,0,5069,5103,18
Task 5070,Job 0,3,9,2,7,0,5,10,5,2,2,2,5070,5103,15
Task 5070,Job 1,8,8,2,12,0,10,20,10,2,2,0,5070,5103,8
Task 5071,Job 0,4,5,2,8,0,6,12,6,2,1,0,5071,5104,14
Task 5071,Job 1,9,5,1,8,1,10,17,7,1,4,0,5071,5104,10
Task 5072,Job 0,9,7,1,10,0,10,19,9,1,2,2,5072,5105,16
Task 5072,Job 1,14,8,2,7,0,16,21,5,2,2,2,5072,5105,8
Task 5073,Job 0,1,4,4,12,0,5,13,8,4,4,2,5073,5107,16
Task 5073,Job 1,6,9,2,6,0,8,12,4,2,4,1,5073,5107,5
Task 5074,Job 0,1,8,4,12,1,5,13,8,4,3,1,5074,5107,3
Task 5074,Job 1,6,7,3,8,1,9,14,5,3,2,0,5074,5107,6
Task 5075,Job 0,5,9,2,6,1,7,11,4,2,2,0,5075,5108,7
Task 5075,Job 1,10,4,4,7,0,14,17,3,4,2,0,5075,5108,10
Task 5076,Job 0,8,9,1,12,0,9,20,11,1,1,2,5076,5109,6
Task 5076,Job 1,13,5,2,9,0,15,22,7,2,3,0,5076,5109,13
Task 5077,Job 0,9,4,2,8,0,11,17,6,2,2,0,5077,5110,8
Task 5077,Job 1,14,9,4,6,0,18,20,2,4,2,2,5077,5110,4
Task 5078,Job 0,9,8,3,8,0,12,17,5,3,4,1,5078,5112,8
Task 5078,Job 1,14,6,3,9,0,17,23,6,3,2,1,5078,5112,11
Task 5079,Job 0,2,4,4,8,0,6,10,4,4,3,1,5079,5112,12
Task 5079,Job 1,7,4,3,11,0,10,18,8,3,3,2,5079,5112,10
Task 5080,Job 0,8,6,2,8,0,10,16,6,2,2,0,5080,5113,12
Task 5080,Job 1,13,5,4,12,0,17,25,8,4,3,0,5080,5113,2
Task 5081,Job 0,7,9,2,11,1,9,18,9,2,2,2,5081,5114,3
Task 5081,Job 1,12,10,3,7,0,15,19,4,3,2,2,5081,5114,18
Task 5082,Job 0,1,4,1,11,0,2,12,10,1,1,0,5082,5116,19
Task 5082,Job 1,6,8,3,7,0,9,13,4,3,3,2,5082,5116,9
Task 5083,Job 0,1,10,2,10,0,3,11,8,2,1,0,5083,5116,20
Task 5083,Job 1,6,6,1,6,0,7,12,5,1,2,2,5083,5116,19
Task 5084,Job 0,6,6,4,8,0,10,14,4,4,3,1,5084,5117,20
Task 5084,Job 1,11,9,2,9,0,13,20,7,2,3,1,5084,5117,7
Task 5085,Job 0,1,4,2,6,0,3,7,4,2,2,1,5085,5118,13
Task 5085,Job 1,6,6,4,9,0,10,15,5,4,1,2,5085,5118,10
Task 5086,Job 0,6,4,4,9,0,10,15,5,4,1,2,5086,5120,8
Task 5086,Job 1,11,10,3,9,0,14,20,6,3,2,0,5086,5120,12
Task 5087,Job 0,10,8,1,9,1,11,19,8,1,1,0,5087,5120,4
Task 5087,Job 1,15,5,1,10,0,16,25,9,1,4,1,5087,5120,16
Task 5088,Job 0,7,4,4,7,0,11,14,3,4,4,1,5088,5121,13
Task 5088,Job 1,12,6,3,7,0,15,19,4,3,3,0,5088,5121,8
Task 5089,Job 0,5,4,2,12,1,7,17,10,2,2,0,5089,5123,3
Task 5089,Job 1,10,6,3,8,0,13,18,5,3,2,1,5089,5123,7
Task 5090,Job 0,2,7,2,12,0,4,14,10,2,1,0,5090,5124,3
Task 5090,Job 1,7,5,1,9,1,8,16,8,1,2,1,5090,5124,19
Task 5091,Job 0,2,6,3,7,0,5,9,4,3,1,0,5091,5125,10
Task 5091,Job 1,7,10,1,11,0,8,18,10,1,2,0,5091,5125,7
Task 5092,Job 0,9,6,4,8,0,13,17,4,4,2,1,5092,5126,5
Task 5092,Job 1,14,6,4,9,0,18,23,5,4,3,1,5092,5126,19
Task 5093,Job 0,6,10,2,7,0,8,13,5,2,2,0,5093,5126,17
Task 5093,Job 1,11,9,4,7,0,15,18,3,4,3,1,5093,5126,18
Task 5094,Job 0,8,4,1,12,0,9,20,11,1,1,1,5094,5128,10
Task 5094,Job 1,13,6,1,12,0,14,25,11,1,1,0,5094,5128,17
Task 5095,Job 0,9,5,2,6,1,11,15,4,2,4,1,5095,5128,18
Task 5095,Job 1,14,9,4,10,0,18,24,6,4,2,2,5095,5128,6
Task 5096,Job 0,8,7,3,11,0,11,19,8,3,3,0,5096,5129,7
Task 5096,Job 1,13,4,2,10,0,15,23,8,2,3,1,5096,5129,10
Task 5097,Job 0,10,7,3,10,0,13,20,7,3,4,2,5097,5131,20
Task 5097,Job 1,15,10,2,9,1,17,24,7,2,1,0,5097,5131,15
Task 5098,Job 0,9,6,4,12,0,13,21,8,4,1,0,5098,5132,13
Task 5098,Job 1,14,10,2,6,1,16,20,4,2,2,1,5098,5132,11
Task 5099,Job 0,4,8,3,11,0,7,15,8,3,1,1,5099,5132,20
Task 5099,Job 1,9,10,3,12,1,12,21,9,3,2,1,5099,5132,2
Task 5100,Job 0,5,8,2,12,1,7,17,10,2,2,1,5100,5134,9
Task 5100,Job 1,10,7,3,11,0,13,21,8,3,1,2,5100,5134,20
Task 5101,Job 0,3,9,1,12,0,4,15,11,1,3,2,5101,5134,10
Task 5101,Job 1,8,5,4,8,0,12,16,4,4,1,2,5101,5134,6
Task 5102,Job 0,1,7,3,9,0,4,10,6,3,4,0,5102,5136,19
Task 5102,Job 1,6,10,2,6,0,8,12,4,2,2,0,5102,5136,9
Task 5103,Job 0,7,7,4,9,0,11,16,5,4,3,0,5103,5137,13
Task 5103,Job 1,12,8,4,12,0,16,24,8,4,1,0,5103,5137,13
Task 5104,Job 0,10,8,3,7,0,13,17,4,3,3,1,5104,5138,20
Task 5104,Job 1,15,10,3,9,0,18,24,6,3,1,0,5104,5138,13
Task 5105,Job 0,5,9,1,11,0,6,16,10,1,1,2,5105,5139,16
Task 5105,Job 1,10,6,2,11,0,12,21,9,2,3,0,5105,5139,12
Task 5106,Job 0,7,8,2,7,1,9,14,5,2,2,1,5106,5139,7
Task 5106,Job 1,12,8,2,9,1,14,21,7,2,3,0,5106,5139,7
Task 5107,Job 0,5,8,4,6,0,9,11,2,4,3,0,5107,5141,12
Task 5107,Job 1,10,7,3,8,1,13,18,5,3,2,1,5107,5141,2
Task 5108,Job 0,8,8,3,7,0,11,15,4,3,4,2,5108,5142,8
Task 5108,Job 1,13,7,3,9,0,16,22,6,3,4,0,5108,5142,12
Task 5109,Job 0,2,10,2,7,1,4,9,5,2,1,2,5109,5142,16
Task 5109,Job 1,7,5,3,8,0,10,15,5,3,1,0,5109,5142,4
Task 5110,Job 0,3,6,2,11,0,5,14,9,2,1,2,5110,5144,4
Task 5110,Job 1,8,5,4,9,0,12,17,5,4,1,1,5110,5144,20
Task 5111,Job 0,1,9,3,12,0,4,13,9,3,4,0,5111,5145,18
Task 5111,Job 1,6,4,3,11,0,9,17,8,3,4,1,5111,5145,10
Task 5112,Job 0,8,10,3,11,1,11,19,8,3,4,2,5112,5146,9
Task 5112,Job 1,13,6,1,7,0,14,20,6,1,2,0,5112,5146,15
Task 5113,Job 0,7,8,2,8,1,9,15,6,2,2,0,5113,5146,2
Task 5113,Job 1,12,5,4,6,0,16,18,2,4,1,1,5113,5146,17
Task 5114,Job 0,10,8,3,11,0,13,21,8,3,4,0,5114,5148,5
Task 5114,Job 1,15,10,2,7,0,17,22,5,2,4,0,5114,5148,8
Task 5115,Job 0,5,7,1,6,0,6,11,5,1,4,2,5115,5149,17
Task 5115,Job 1,10,5,1,10,0,11,20,9,1,1,0,5115,5149,19
Task 5116,Job 0,10,10,2,6,0,12,16,4,2,4,1,5116,5150,11
Task 5116,Job 1,15,10,1,6,0,16,21,5,1,2,1,5116,5150,4
Task 5117,Job 0,8,9,2,11,1,10,19,9,2,1,1,5117,5151,4
Task 5117,Job 1,13,7,1,8,0,14,21,7,1,1,2,5117,5151,14
Task 5118,Job 0,8,8,1,9,0,9,17,8,1,2,1,5118,5151,12
Task 5118,Job 1,13,9,1,7,1,14,20,6,1,1,0,5118,5151,17
Task 5119,Job 0,3,6,1,11,0,4,14,10,1,3,2,5119,5152,7
Task 5119,Job 1,8,10,2,10,1,10,18,8,2,2,0,5119,5152,15
Task 5120,Job 0,5,9,2,12,0,7,17,10,2,1,1,5120,5153,14
Task 5120,Job 1,10,7,1,8,0,11,18,7,1,4,0,5120,5153,19
Task 5121,Job 0,4,5,2,8,1,6,12,6,2,3,1,5121,5154,9
Task 5121,Job 1,9,5,2,12,0,11,21,10,2,1,1,5121,5154,2
Task 5122,Job 0,4,6,4,9,0,8,13,5,4,1,2,5122,5155,19
Task 5122,Job 1,9,7,2,6,0,11,15,4,2,4,0,5122,5155,2
Task 5123,Job 0,2,4,4,9,1,6,11,5,4,3,1,5123,5157,12
Task 5123,Job 1,7,10,4,9,1,11,16,5,4,4,0,5123,5157,13
Task 5124,Job 0,8,8,2,6,0,10,14,4,2,2,2,5124,5158,20
Task 5124,Job 1,13,6,2,9,0,15,22,7,2,1,0,5124,5158,15
Task 5125,Job 0,7,5,2,8,0,9,15,6,2,4,2,5125,5159,4
Task 5125,Job 1,12,8,2,8,1,14,20,6,2,3,2,5125,5159,6
Task 5126,Job 0,3,10,3,6,1,6,9,3,3,1,0,5126,5159,8
Task 5126,Job 1,8,10,4,11,0,12,19,7,4,1,2,5126,5159,6
Task 5127,Job 0,4,10,3,8,0,7,12,5,3,3,1,5127,5161,9
Task 5127,Job 1,9,10,4,10,0,13,19,6,4,2,2,5127,5161,8
Task 5128,Job 0,4,9,4,10,1,8,14,6,4,1,2,5128,5161,2
Task 5128,Job 1,9,9,3,6,0,12,15,3,3,3,1,5128,5161,14
Task 5129,Job 0,1,4,1,11,1,2,12,10,1,3,1,5129,5163,7
Task 5129,Job 1,6,8,1,12,1,7,18,11,1,4,2,5129,5163,14
Task 5130,Job 0,5,5,3,8,1,8,13,5,3,3,1,5130,5164,19
Task 5130,Job 1,10,7,2,8,0,12,18,6,2,4,0,5130,5164,20
Task 5131,Job 0,5,8,3,12,0,8,17,9,3,1,2,5131,5165,17
Task 5131,Job 1,10,10,2,6,0,12,16,4,2,2,1,5131,5165,12
Task 5132,Job 0,9,5,1,10,0,10,19,9,1,1,2,5132,5166,7
Task 5132,Job 1,14,10,4,12,0,18,26,8,4,2,1,5132,5166,20
Task 5133,Job 0,6,7,3,12,0,9,18,9,3,4,1,5133,5166,13
Task 5133,Job 1,11,7,2,8,0,13,19,6,2,1,0,5133,5166,20
Task 5134,Job 0,7,9,2,9,0,9,16,7,2,4,2,5134,5167,2
Task 5134,Job 1,12,7,1,6,0,13,18,5,1,1,0,5134,5167,8
Task 5135,Job 0,9,9,3,7,1,12,16,4,3,2,2,5135,5168,4
Task 5135,Job 1,14,9,1,7,0,15,21,6,1,2,0,5135,5168,9
Task 5136,Job 0,7,10,2,12,0,9,19,10,2,2,1,5136,5170,4
Task 5136,Job 1,12,8,2,8,0,14,20,6,2,4,0,5136,5170,20
Task 5137,Job 0,4,8,1,11,0,5,15,10,1,2,2,5137,5171,10
Task 5137,Job 1,9,9,2,9,0,11,18,7,2,1,2,5137,5171,15
Task 5138,Job 0,6,8,1,8,0,7,14,7,1,4,2,5138,5171,4
Task 5138,Job 1,11,9,3,11,0,14,22,8,3,2,2,5138,5171,13
Task 5139,Job 0,2,5,4,11,0,6,13,7,4,3,0,5139,5172,19
Task 5139,Job 1,7,4,3,11,0,10,18,8,3,2,1,5139,5172,16
Task 5140,Job 0,1,6,4,9,0,5,10,5,4,3,0,5140,5173,18
Task 5140,Job 1,6,10,3,8,0,9,14,5,3,2,2,5140,5173,17
Task 5141,Job 0,1,7,4,6,1,5,7,2,4,2,0,5141,5174,20
Task 5141,Job 1,6,5,3,6,0,9,12,3,3,1,2,5141,5174,20
Task 5142,Job 0,3,9,4,6,0,7,9,2,4,2,0,5142,5176,5
Task 5142,Job 1,8,4,3,10,1,11,18,7,3,4,2,5142,5176,14
Task 5143,Job 0,5,9,4,11,0,9,16,7,4,4,1,5143,5177,20
Task 5143,Job 1,10,8,2,10,0,12,20,8,2,3,0,5143,5177,7
Task 5144,Job 0,9,7,2,9,1,11,18,7,2,4,1,5144,5177,2
Task 5144,Job 1,14,7,4,9,1,18,23,5,4,3,2,5144,5177,5
Task 5145,Job 0,2,10,3,8,0,5,10,5,3,1,1,5145,5179,16
Task 5145,Job 1,7,5,4,10,0,11,17,6,4,4,2,5145,5179,19
Task 5146,Job 0,2,10,3,12,0,5,14,9,3,1,1,5146,5179,5
Task 5146,Job 1,7,10,4,11,1,11,18,7,4,1,0,5146,5179,4
Task 5147,Job 0,9,5,4,11,0,13,20,7,4,4,0,5147,5181,13
Task 5147,Job 1,14,7,2,10,0,16,24,8,2,3,1,5147,5181,8
Task 5148,Job 0,6,8,4,10,1,10,16,6,4,2,2,5148,5182,13
Task 5148,Job 1,11,7,2,12,0,13,23,10,2,1,2,5148,5182,11
Task 5149,Job 0,5,9,3,11,0,8,16,8,3,2,1,5149,5182,7
Task 5149,Job 1,10,10,3,8,0,13,18,5,3,2,0,5149,5182,18
Task 5150,Job 0,8,10,1,9,0,9,17,8,1,3,1,5150,5184,19
Task 5150,Job 1,13,7,3,8,0,16,21,5,3,4,0,5150,5184,12
Task 5151,Job 0,8,4,2,7,0,10,15,5,2,4,2,5151,5184,16
Task 5151,Job 1,13,6,4,7,0,17,20,3,4,1,2,5151,5184,4
Task 5152,Job 0,3,9,2,12,0,5,15,10,2,3,0,5152,5185,4
Task 5152,Job 1,8,9,2,8,0,10,16,6,2,4,1,5152,5185,4
Task 5153,Job 0,8,8,3,11,0,11,19,8,3,2,2,5153,5186,14
Task 5153,Job 1,13,6,4,12,1,17,25,8,4,2,1,5153,5186,15
Task 5154,Job 0,6,7,3,9,0,9,15,6,3,2,1,5154,5188,4
Task 5154,Job 1,11,10,4,11,0,15,22,7,4,3,2,5154,5188,8
Task 5155,Job 0,2,6,2,10,0,4,12,8,2,3,1,5155,5188,16
Task 5155,Job 1,7,5,4,11,0,11,18,7,4,3,1,5155,5188,16
Task 5156,Job 0,1,10,1,11,0,2,12,10,1,4,1,5156,5190,10
Task 5156,Job 1,6,8,2,7,0,8,13,5,2,1,0,5156,5190,8
Task 5157,Job 0,2,9,4,7,0,6,9,3,4,1,0,5157,5191,12
Task 5157,Job 1,7,6,1,6,0,8,13,5,1,1,0,5157,5191,6
Task 5158,Job 0,7,7,1,9,0,8,16,8,1,4,1,5158,5192,7
Task 5158,Job 1,12,7,4,9,0,16,21,5,4,4,2,5158,5192,7
Task 5159,Job 0,5,9,4,6,0,9,11,2,4,2,0,5159,5192,13
Task 5159,Job 1,10,10,4,6,0,14,16,2,4,2,2,5159,5192,11
Task 5160,Job 0,8,9,1,6,1,9,14,5,1,2,2,5160,5193,20
Task 5160,Job 1,13,6,3,9,0,16,22,6,3,3,2,5160,5193,5
Task 5161,Job 0,4,4,3,11,0,7,15,8,3,2,0,5161,5195,10
Task 5161,Job 1,9,4,4,11,1,13,20,7,4,1,2,5161,5195,5
Task 5162,Job 0,5,9,2,9,1,7,14,7,2,3,0,5162,5195,17
Task 5162,Job 1,10,9,2,6,0,12,16,4,2,2,1,5162,5195,13
Task 5163,Job 0,8,10,2,9,0,10,17,7,2,4,1,5163,5196,14
Task 5163,Job 1,13,5,4,10,0,17,23,6,4,4,2,5163,5196,12
Task 5164,Job 0,10,6,3,7,1,13,17,4,3,2,1,5164,5198,8
Task 5164,Job 1,15,7,1,12,0,16,27,11,1,4,0,5164,5198,7
Task 5165,Job 0,2,6,4,7,1,6,9,3,4,1,0,5165,5199,9
Task 5165,Job 1,7,4,3,7,0,10,14,4,3,4,1,5165,5199,12
Task 5166,Job 0,5,7,2,11,0,7,16,9,2,4,1,5166,5199,18
Task 5166,Job 1,10,5,1,10,1,11,20,9,1,3,1,5166,5199,19
Task 5167,Job 0,4,6,4,10,1,8,14,6,4,1,2,5167,5201,20
Task 5167,Job 1,9,6,4,8,0,13,17,4,4,2,2,5167,5201,13
Task 5168,Job 0,3,9,2,9,1,5,12,7,2,2,1,5168,5201,15
Task 5168,Job 1,8,7,4,6,1,12,14,2,4,1,2,5168,5201,3
Task 5169,Job 0,7,7,4,9,1,11,16,5,4,2,0,5169,5203,10
Task 5169,Job 1,12,4,4,8,0,16,20,4,4,4,1,5169,5203,17
Task 5170,Job 0,8,7,2,12,0,10,20,10,2,4,0,5170,5203,5
Task 5170,Job 1,13,7,2,11,1,15,24,9,2,4,1,5170,5203,20
Task 5171,Job 0,7,10,2,6,1,9,13,4,2,1,2,5171,5205,4
Task 5171,Job 1,12,7,2,6,0,14,18,4,2,3,0,5171,5205,8
Task 5172,Job 0,1,9,4,6,0,5,7,2,4,4,1,5172,5206,13
Task 5172,Job 1,6,10,4,12,0,10,18,8,4,1,2,5172,5206,10
Task 5173,Job 0,8,6,2,8,0,10,16,6,2,1,1,5173,5206,10
Task 5173,Job 1,13,7,4,7,1,17,20,3,4,4,2,5173,5206,16
Task 5174,Job 0,9,6,4,8,0,13,17,4,4,4,2,5174,5207,5
Task 5174,Job 1,14,9,2,7,1,16,21,5,2,3,1,5174,5207,9
Task 5175,Job 0,1,6,1,12,0,2,13,11,1,3,2,5175,5209,3
Task 5175,Job 1,6,6,1,11,1,7,17,10,1,3,0,5175,5209,7
Task 5176,Job 0,6,5,3,12,0,9,18,9,3,4,1,5176,5210,14
Task 5176,Job 1,11,8,3,11,0,14,22,8,3,4,0,5176,5210,3
Task 5177,Job 0,10,9,1,11,0,11,21,10,1,1,0,5177,5210,10
Task 5177,Job 1,15,4,2,9,1,17,24,7,2,4,1,5177,5210,4
Task 5178,Job 0,4,10,3,9,1,7,13,6,3,4,0,5178,5212,3
Task 5178,Job 1,9,7,3,6,0,12,15,3,3,2,2,5178,5212,9
Task 5179,Job 0,5,4,2,6,0,7,11,4,2,1,0,5179,5213,9
Task 5179,Job 1,10,10,3,9,0,13,19,6,3,3,0,5179,5213,7
Task 5180,Job 0,2,8,2,12,0,4,14,10,2,2,2,5180,5214,8
Task 5180,Job 1,7,4,2,11,1,9,18,9,2,2,2,5180,5214,8
Task 5181,Job 0,7,8,4,7,1,11,14,3,4,3,0,5181,5214,2
Task 5181,Job 1,12,4,4,10,0,16,22,6,4,2,0,5181,5214,2
Task 5182,Job 0,3,6,4,12,0,7,15,8,4,4,1,5182,5216,3
Task 5182,Job 1,8,7,4,11,0,12,19,7,4,1,0,5182,5216,3
Task 5183,Job 0,6,10,3,11,1,9,17,8,3,1,2,5183,5217,3
Task 5183,Job 1,11,6,1,12,0,12,23,11,1,4,0,5183,5217,4
Task 5184,Job 0,2,6,1,12,0,3,14,11,1,3,0,5184,5217,16
Task 5184,Job 1,7,7,4,10,0,11,17,6,4,1,0,5184,5217,5
Task 5185,Job 0,4,10,2,6,0,6,10,4,2,2,2,5185,5219,11
Task 5185,Job 1,9,6,4,6,1,13,15,2,4,3,0,5185,5219,20
Task 5186,Job 0,7,6,2,6,0,9,13,4,2,3,0,5186,5219,2
Task 5186,Job 1,12,8,3,6,1,15,18,3,3,1,2,5186,5219,16
Task 5187,Job 0,4,5,1,10,0,5,14,9,1,2,1,5187,5221,9
Task 5187,Job 1,9,6,2,9,0,11,18,7,2,1,1,5187,5221,13
Task 5188,Job 0,2,10,2,12,0,4,14,10,2,1,1,5188,5222,7
Task 5188,Job 1,7,8,3,8,0,10,15,5,3,4,2,5188,5222,16
Task 5189,Job 0,2,5,2,9,0,4,11,7,2,2,1,5189,5223,9
Task 5189,Job 1,7,8,3,12,0,10,19,9,3,4,1,5189,5223,20
Task 5190,Job 0,1,9,2,12,0,3,13,10,2,4,2,5190,5224,14
Task 5190,Job 1,6,9,4,10,1,10,16,6,4,2,0,5190,5224,2
Task 5191,Job 0,4,5,4,9,0,8,13,5,4,1,2,5191,5224,14
Task 5191,Job 1,9,9,2,6,0,11,15,4,2,4,0,5191,5224,20
Task 5192,Job 0,1,5,3,7,0,4,8,4,3,1,2,5192,5226,4
Task 5192,Job 1,6,10,4,8,0,10,14,4,4,1,2,5192,5226,16
Task 5193,Job 0,10,5,4,11,0,14,21,7,4,4,2,5193,5227,11
Task 5193,Job 1,15,4,2,6,0,17,21,4,2,1,2,5193,5227,17
Task 5194,Job 0,8,10,1,9,0,9,17,8,1,2,1,5194,5228,9
Task 5194,Job 1,13,10,2,11,1,15,24,9,2,3,2,5194,5228,20
Task 5195,Job 0,10,4,4,11,0,14,21,7,4,3,2,5195,5228,18
Task 5195,Job 1,15,7,3,8,1,18,23,5,3,2,0,5195,5228,3
Task 5196,Job 0,2,9,4,11,0,6,13,7,4,3,1,5196,5229,7
Task 5196,Job 1,7,10,2,9,0,9,16,7,2,2,0,5196,5229,6
Task 5197,Job 0,3,7,1,7,0,4,10,6,1,4,0,5197,5230,9
Task 5197,Job 1,8,4,1,7,0,9,15,6,1,2,2,5197,5230,7
Task 5198,Job 0,6,9,4,11,0,10,17,7,4,4,0,5198,5231,18
Task 5198,Job 1,11,9,4,7,0,15,18,3,4,4,2,5198,5231,7
Task 5199,Job 0,6,4,4,8,1,10,14,4,4,2,1,5199,5232,11
Task 5199,Job 1,11,6,4,10,1,15,21,6,4,1,2,5199,5232,3
Task 5200,Job 0,9,4,1,7,1,10,16,6,1,1,0,5200,5233,10
Task 5200,Job 1,14,8,1,7,0,15,21,6,1,2,2,5200,5233,6
Task 5201,Job 0,5,6,3,10,0,8,15,7,3,1,0,5201,5234,14
Task 5201,Job 1,10,8,2,12,0,12,22,10,2,3,1,5201,5234,12
Task 5202,Job 0,1,5,4,12,0,5,13,8,4,3,0,5202,5235,16
Task 5202,Job 1,6,5,2,7,1,8,13,5,2,2,1,5202,5235,7
Task 5203,Job 0,7,9,2,7,0,9,14,5,2,3,0,5203,5237,5
Task 5203,Job 1,12,6,1,12,0,13,24,11,1,1,0,5203,5237,11
Task 5204,Job 0,7,5,1,10,0,8,17,9,1,2,1,5204,5237,15
Task 5204,Job 1,12,9,1,12,0,13,24,11,1,3,0,5204,5237,15
Task 5205,Job 0,4,6,2,12,0,6,16,10,2,3,1,5205,5238,4
Task 5205,Job 1,9,8,2,7,0,11,16,5,2,2,2,5205,5238,11
Task 5206,Job 0,10,4,4,11,0,14,21,7,4,4,1,5206,5240,15
Task 5206,Job 1,15,8,3,9,1,18,24,6,3,4,2,5206,5240,20
Task 5207,Job 0,9,7,1,11,1,10,20,10,1,1,0,5207,5241,10
Task 5207,Job 1,14,9,3,6,0,17,20,3,3,2,0,5207,5241,5
Task 5208,Job 0,9,8,1,7,0,10,16,6,1,1,1,5208,5242,14
Task 5208,Job 1,14,8,3,12,0,17,26,9,3,2,2,5208,5242,12
Task 5209,Job 0,5,10,2,7,0,7,12,5,2,2,1,5209,5243,20
Task 5209,Job 1,10,10,4,6,0,14,16,2,4,4,0,5209,5243,4
Task 5210,Job 0,2,10,1,8,0,3,10,7,1,4,1,5210,5243,8
Task 5210,Job 1,7,7,2,8,0,9,15,6,2,2,1,5210,5243,5
Task 5211,Job 0,9,7,2,10,0,11,19,8,2,2,0,5211,5245,4
Task 5211,Job 1,14,6,4,8,0,18,22,4,4,1,1,5211,5245,4
Task 5212,Job 0,9,8,3,9,0,12,18,6,3,4,2,5212,5245,2
Task 5212,Job 1,14,5,4,9,0,18,23,5,4,4,0,5212,5245,11
Task 5213,Job 0,5,9,1,7,1,6,12,6,1,3,0,5213,5246,17
Task 5213,Job 1,10,5,1,6,0,11,16,5,1,1,2,5213,5246,16
Task 5214,Job 0,5,4,3,12,0,8,17,9,3,4,2,5214,5247,18
Task 5214,Job 1,10,10,4,6,0,14,16,2,4,1,0,5214,5247,12
Task 5215,Job 0,5,4,2,7,0,7,12,5,2,1,1,5215,5248,5
Task 5215,Job 1,10,10,2,12,1,12,22,10,2,3,1,5215,5248,15
Task 5216,Job 0,1,10,4,9,1,5,10,5,4,1,0,5216,5249,12
Task 5216,Job 1,6,7,3,11,1,9,17,8,3,1,2,5216,5249,20
Task 5217,Job 0,8,8,3,8,1,11,16,5,3,4,2,5217,5251,16
Task 5217,Job 1,13,5,3,8,0,16,21,5,3,2,2,5217,5251,5
Task 5218,Job 0,8,8,1,10,1,9,18,9,1,4,0,5218,5251,5
Task 5218,Job 1,13,6,3,8,1,16,21,5,3,1,1,5218,5251,11
Task 5219,Job 0,10,8,3,8,0,13,18,5,3,2,2,5219,5252,8
Task 5219,Job 1,15,6,4,11,1,19,26,7,4,2,1,5219,5252,14
Task 5220,Job 0,2,5,3,9,0,5,11,6,3,1,1,5220,5254,5
Task 5220,Job 1,7,5,2,7,0,9,14,5,2,1,2,5220,5254,9
Task 5221,Job 0,4,10,4,11,0,8,15,7,4,2,2,5221,5254,5
Task 5221,Job 1,9,4,2,9,1,11,18,7,2,1,0,5221,5254,14
Task 5222,Job 0,10,8,1,7,0,11,17,6,1,4,2,5222,5256,14
Task 5222,Job 1,15,6,2,6,0,17,21,4,2,1,2,5222,5256,2
Task 5223,Job 0,1,4,2,11,0,3,12,9,2,2,2,5223,5257,15
Task 5223,Job 1,6,8,4,6,0,10,12,2,4,1,1,5223,5257,12
Task 5224,Job 0,3,8,2,6,1,5,9,4,2,1,0,5224,5258,14
Task 5224,Job 1,8,5,2,7,1,10,15,5,2,1,1,5224,5258,19
Task 5225,Job 0,4,8,1,11,1,5,15,10,1,2,1,5225,5258,19
Task 5225,Job 1,9,7,2,12,1,11,21,10,2,3,0,5225,5258,4
Task 5226,Job 0,1,4,4,9,0,5,10,5,4,3,1,5226,5259,6
Task 5226,Job 1,6,6,2,6,1,8,12,4,2,3,2,5226,5259,4
Task 5227,Job 0,6,5,3,12,1,9,18,9,3,4,2,5227,5260,15
Task 5227,Job 1,11,5,2,6,0,13,17,4,2,4,1,5227,5260,6
Task 5228,Job 0,5,6,4,12,0,9,17,8,4,3,0,5228,5262,18
Task 5228,Job 1,10,5,1,8,0,11,18,7,1,4,2,5228,5262,14
Task 5229,Job 0,3,10,2,8,0,5,11,6,2,3,2,5229,5262,11
Task 5229,Job 1,8,7,4,12,0,12,20,8,4,3,2,5229,5262,7
Task 5230,Job 0,8,5,4,12,0,12,20,8,4,1,2,5230,5264,3
Task 5230,Job 1,13,8,1,6,0,14,19,5,1,2,0,5230,5264,19
Task 5231,Job 0,10,7,2,11,0,12,21,9,2,4,2,5231,5265,15
Task 5231,Job 1,15,7,4,8,0,19,23,4,4,1,0,5231,5265,19
Task 5232,Job 0,8,8,1,6,1,9,14,5,1,2,1,5232,5266,14
Task 5232,Job 1,13,7,4,6,0,17,19,2,4,2,1,5232,5266,18
Task 5233,Job 0,10,4,3,10,0,13,20,7,3,3,0,5233,5267,2
Task 5233,Job 1,15,7,2,9,0,17,24,7,2,4,1,5233,5267,20
Task 5234,Job 0,7,4,1,11,0,8,18,10,1,3,0,5234,5267,5
Task 5234,Job 1,12,10,4,9,0,16,21,5,4,1,2,5234,5267,9
Task 5235,Job 0,6,10,4,12,1,10,18,8,4,3,1,5235,5268,18
Task 5235,Job 1,11,6,3,12,0,14,23,9,3,2,0,5235,5268,7
Task 5236,Job 0,3,9,3,8,0,6,11,5,3,1,2,5236,5270,4
Task 5236,Job 1,8,9,4,7,0,12,15,3,4,1,1,5236,5270,9
Task 5237,Job 0,8,5,3,6,0,11,14,3,3,2,0,5237,5270,10
Task 5237,Job 1,13,4,4,6,0,17,19,2,4,3,1,5237,5270,11
Task 5238,Job 0,3,9,3,10,0,6,13,7,3,2,2,5238,5272,9
Task 5238,Job 1,8,7,1,10,0,9,18,9,1,3,0,5238,5272,15
Task 5239,Job 0,8,7,2,10,0,10,18,8,2,2,0,5239,5273,11
Task 5239,Job 1,13,9,4,11,1,17,24,7,4,1,2,5239,5273,11
Task 5240,Job 0,10,5,2,9,0,12,19,7,2,4,2,5240,5274,19
Task 5240,Job 1,15,6,3,6,0,18,21,3,3,2,1,5240,5274,20
Task 5241,Job 0,4,6,1,8,0,5,12,7,1,3,2,5241,5275,20
Task 5241,Job 1,9,10,3,7,0,12,16,4,3,2,2,5241,5275,7
Task 5242,Job 0,5,10,3,11,0,8,16,8,3,4,2,5242,5275,13
Task 5242,Job 1,10,7,3,6,0,13,16,3,3,4,2,5242,5275,20
Task 5243,Job 0,3,8,1,12,0,4,15,11,1,3,0,5243,5277,17
Task 5243,Job 1,8,8,2,11,0,10,19,9,2,3,1,5243,5277,16
Task 5244,Job 0,6,7,4,7,0,10,13,3,4,2,0,5244,5278,19
Task 5244,Job 1,11,8,1,8,0,12,19,7,1,2,1,5244,5278,10
Task 5245,Job 0,8,5,2,11,0,10,19,9,2,2,1,5245,5279,12
Task 5245,Job 1,13,9,2,7,0,15,20,5,2,3,2,5245,5279,4
Task 5246,Job 0,2,5,2,11,0,4,13,9,2,1,0,5246,5280,16
Task 5246,Job 1,7,8,4,11,0,11,18,7,4,2,1,5246,5280,17
Task 5247,Job 0,10,8,2,8,0,12,18,6,2,1,2,5247,5280,12
Task 5247,Job 1,15,10,2,6,0,17,21,4,2,1,1,5247,5280,4
Task 5248,Job 0,7,4,1,11,1,8,18,10,1,2,1,5248,5281,7
Task 5248,Job 1,12,6,1,11,1,13,23,10,1,3,0,5248,5281,12
Task 5249,Job 0,6,6,4,7,0,10,13,3,4,1,1,5249,5283,11
Task 5249,Job 1,11,6,3,11,0,14,22,8,3,4,0,5249,5283,15
Task 5250,Job 0,2,10,3,8,1,5,10,5,3,1,1,5250,5284,19
Task 5250,Job 1,7,6,1,6,1,8,13,5,1,1,1,5250,5284,15
Task 5251,Job 0,2,6,2,6,1,4,8,4,2,1,2,5251,5285,5
Task 5251,Job 1,7,5,3,12,1,10,19,9,3,2,1,5251,5285,2
Task 5252,Job 0,9,10,2,8,1,11,17,6,2,1,1,5252,5285,8
Task 5252,Job 1,14,8,1,11,0,15,25,10,1,3,1,5252,5285,19
Task 5253,Job 0,7,5,1,9,0,8,16,8,1,2,2,5253,5287,17
Task 5253,Job 1,12,4,1,8,0,13,20,7,1,4,0,5253,5287,19
Task 5254,Job 0,5,8,1,6,0,6,11,5,1,1,1,5254,5288,12
Task 5254,Job 1,10,9,4,6,0,14,16,2,4,2,1,5254,5288,11
Task 5255,Job 0,6,6,3,7,0,9,13,4,3,1,0,5255,5289,7
Task 5255,Job 1,11,8,4,8,0,15,19,4,4,3,1,5255,5289,19
Task 5256,Job 0,7,4,4,9,0,11,16,5,4,2,2,5256,5290,12
Task 5256,Job 1,12,7,4,9,0,16,21,5,4,3,2,5256,5290,11
Task 5257,Job 0,10,9,3,6,1,13,16,3,3,2,2,5257,5291,14
Task 5257,Job 1,15,4,1,11,0,16,26,10,1,4,0,5257,5291,6
Task 5258,Job 0,7,4,1,11,0,8,18,10,1,3,1,5258,5292,3
Task 5258,Job 1,12,5,4,9,1,16,21,5,4,3,0,5258,5292,9
Task 5259,Job 0,1,8,3,7,0,4,8,4,3,3,0,5259,5293,12
Task 5259,Job 1,6,8,1,7,0,7,13,6,1,4,2,5259,5293,2
Task 5260,Job 0,8,9,1,12,0,9,20,11,1,3,0,5260,5293,10
Task 5260,Job 1,13,10,2,10,0,15,23,8,2,4,0,5260,5293,15
Task 5261,Job 0,9,4,4,11,0,13,20,7,4,2,0,5261,5294,20
Task 5261,Job 1,14,4,4,6,0,18,20,2,4,3,1,5261,5294,2
Task 5262,Job 0,9,8,2,10,0,11,19,8,2,4,2,5262,5296,2
Task 5262,Job 1,14,9,2,8,0,16,22,6,2,3,1,5262,5296,18
Task 5263,Job 0,4,7,1,6,0,5,10,5,1,2,2,5263,5297,10
Task 5263,Job 1,9,6,1,9,0,10,18,8,1,2,2,5263,5297,18
Task 5264,Job 0,2,5,1,9,1,3,11,8,1,2,1,5264,5298,3
Task 5264,Job 1,7,4,1,10,0,8,17,9,1,4,2,5264,5298,13
Task 5265,Job 0,1,7,3,12,0,4,13,9,3,3,0,5265,5299,15
Task 5265,Job 1,6,10,2,8,0,8,14,6,2,2,0,5265,5299,19
Task 5266,Job 0,7,6,1,9,1,8,16,8,1,2,2,5266,5299,8
Task 5266,Job 1,12,4,2,11,1,14,23,9,2,3,2,5266,5299,11
Task 5267,Job 0,4,10,3,10,0,7,14,7,3,4,1,5267,5300,10
Task 5267,Job 1,9,9,2,12,0,11,21,10,2,4,2,5267,5300,10
Task 5268,Job 0,3,8,2,6,1,5,9,4,2,1,0,5268,5302,6
Task 5268,Job 1,8,6,2,10,1,10,18,8,2,2,0,5268,5302,11
Task 5269,Job 0,8,5,3,12,0,11,20,9,3,4,1,5269,5302,13
Task 5269,Job 1,13,8,2,12,1,15,25,10,2,4,1,5269,5302,15
Task 5270,Job 0,2,5,4,8,0,6,10,4,4,2,0,5270,5303,17
Task 5270,Job 1,7,8,4,10,1,11,17,6,4,4,1,5270,5303,19
Task 5271,Job 0,3,7,3,12,1,6,15,9,3,3,2,5271,5304,7
Task 5271,Job 1,8,10,4,6,1,12,14,2,4,3,1,5271,5304,14
Task 5272,Job 0,5,10,3,12,0,8,17,9,3,1,2,5272,5306,9
Task 5272,Job 1,10,7,1,7,0,11,17,6,1,1,1,5272,5306,12
Task 5273,Job 0,10,7,2,9,0,12,19,7,2,3,2,5273,5306,4
Task 5273,Job 1,15,5,1,9,1,16,24,8,1,1,0,5273,5306,17
Task 5274,Job 0,5,6,2,10,1,7,15,8,2,3,1,5274,5307,7
Task 5274,Job 1,10,8,2,11,1,12,21,9,2,1,1,5274,5307,2
Task 5275,Job 0,9,5,3,11,0,12,20,8,3,4,2,5275,5308,5
Task 5275,Job 1,14,4,2,8,0,16,22,6,2,3,0,5275,5308,4
Task 5276,Job 0,6,4,2,12,0,8,18,10,2,1,1,5276,5310,10
Task 5276,Job 1,11,4,3,9,1,14,20,6,3,2,0,5276,5310,5
Task 5277,Job 0,9,8,2,10,0,11,19,8,2,3,0,5277,5310,12
Task 5277,Job 1,14,4,4,7,0,18,21,3,4,3,2,5277,5310,10
Task 5278,Job 0,10,8,2,11,0,12,21,9,2,2,1,5278,5311,5
Task 5278,Job 1,15,4,1,10,0,16,25,9,1,3,0,5278,5311,15
Task 5279,Job 0,8,5,3,9,0,11,17,6,3,4,2,5279,5312,4
Task 5279,Job 1,13,8,3,9,0,16,22,6,3,2,0,5279,5312,7
Task 5280,Job 0,2,4,2,12,0,4,14,10,2,1,0,5280,5314,6
Task 5280,Job 1,7,6,1,6,0,8,13,5,1,2,2,5280,5314,2
Task 5281,Job 0,2,10,3,10,0,5,12,7,3,2,1,5281,5315,4
Task 5281,Job 1,7,10,3,12,1,10,19,9,3,3,0,5281,5315,16
Task 5282,Job 0,8,9,4,8,0,12,16,4,4,2,2,5282,5315,3
Task 5282,Job 1,13,5,2,10,1,15,23,8,2,3,1,5282,5315,11
Task 5283,Job 0,10,5,1,11,0,11,21,10,1,1,1,5283,5316,20
Task 5283,Job 1,15,6,4,12,1,19,27,8,4,2,2,5283,5316,7
Task 5284,Job 0,3,6,3,6,0,6,9,3,3,3,2,5284,5317,12
Task 5284,Job 1,8,10,4,11,0,12,19,7,4,1,1,5284,5317,5
Task 5285,Job 0,10,7,4,12,0,14,22,8,4,1,1,5285,5318,10
Task 5285,Job 1,15,7,3,9,0,18,24,6,3,2,1,5285,5318,6
Task 5286,Job 0,5,10,3,11,0,8,16,8,3,3,1,5286,5319,7
Task 5286,Job 1,10,4,1,11,0,11,21,10,1,3,0,5286,5319,12
Task 5287,Job 0,7,6,4,9,0,11,16,5,4,2,0,5287,5320,20
Task 5287,Job 1,12,8,4,12,1,16,24,8,4,4,2,5287,5320,15
Task 5288,Job 0,9,10,3,8,0,12,17,5,3,1,1,5288,5322,3
Task 5288,Job 1,14,6,2,9,0,16,23,7,2,2,2,5288,5322,17
Task 5289,Job 0,2,7,1,10,1,3,12,9,1,3,1,5289,5322,8
Task 5289,Job 1,7,9,3,7,0,10,14,4,3,3,2,5289,5322,10
Task 5290,Job 0,8,4,4,6,0,12,14,2,4,4,0,5290,5323,20
Task 5290,Job 1,13,4,4,11,0,17,24,7,4,4,0,5290,5323,11
Task 5291,Job 0,1,5,3,11,1,4,12,8,3,3,1,5291,5325,6
Task 5291,Job 1,6,7,2,6,0,8,12,4,2,2,0,5291,5325,8
Task 5292,Job 0,10,7,4,8,0,14,18,4,4,2,1,5292,5326,11
Task 5292,Job 1,15,9,3,7,0,18,22,4,3,4,0,5292,5326,8
Task 5293,Job 0,10,10,2,11,1,12,21,9,2,4,2,5293,5327,16
Task 5293,Job 1,15,10,2,10,0,17,25,8,2,2,1,5293,5327,11
Task 5294,Job 0,5,7,1,12,0,6,17,11,1,1,2,5294,5328,16
Task 5294,Job 1,10,5,4,12,0,14,22,8,4,3,1,5294,5328,11
Task 5295,Job 0,5,9,1,11,0,6,16,10,1,3,0,5295,5328,5
Task 5295,Job 1,10,5,2,7,1,12,17,5,2,1,0,5295,5328,19
Task 5296,Job 0,1,8,4,9,0,5,10,5,4,2,0,5296,5330,16
Task 5296,Job 1,6,5,4,11,0,10,17,7,4,2,0,5296,5330,4
Task 5297,Job 0,8,9,3,9,0,11,17,6,3,1,2,5297,5331,12
Task 5297,Job 1,13,5,4,6,0,17,19,2,4,4,0,5297,5331,4
Task 5298,Job 0,6,5,4,8,0,10,14,4,4,4,0,5298,5331,8
Task 5298,Job 1,11,10,3,12,0,14,23,9,3,4,1,5298,5331,15
Task 5299,Job 0,3,5,2,9,0,5,12,7,2,3,0,5299,5333,17
Task 5299,Job 1,8,10,4,10,0,12,18,6,4,1,1,5299,5333,10
Task 5300,Job 0,5,10,2,10,0,7,15,8,2,4,0,5300,5334,13
Task 5300,Job 1,10,9,4,12,0,14,22,8,4,4,1,5300,5334,2
Task 5301,Job 0,4,9,3,7,1,7,11,4,3,2,0,5301,5335,4
Task 5301,Job 1,9,8,1,9,0,10,18,8,1,1,1,5301,5335,17
Task 5302,Job 0,2,9,1,6,0,3,8,5,1,3,2,5302,5336,11
Task 5302,Job 1,7,7,4,12,0,11,19,8,4,3,0,5302,5336,8
Task 5303,Job 0,4,5,4,10,1,8,14,6,4,2,0,5303,5337,16
Task 5303,Job 1,9,10,2,10,0,11,19,8,2,4,1,5303,5337,11
Task 5304,Job 0,9,7,2,10,0,11,19,8,2,1,2,5304,5338,4
Task 5304,Job 1,14,10,4,11,0,18,25,7,4,2,2,5304,5338,20
Task 5305,Job 0,2,8,2,6,0,4,8,4,2,2,2,5305,5339,16
Task 5305,Job 1,7,8,3,6,0,10,13,3,3,2,2,5305,5339,7
Task 5306,Job 0,9,9,4,7,0,13,16,3,4,2,1,5306,5340,6
Task 5306,Job 1,14,4,2,9,1,16,23,7,2,2,2,5306,5340,6
Task 5307,Job 0,3,4,3,6,1,6,9,3,3,3,0,5307,5341,7
Task 5307,Job 1,8,8,3,8,0,11,16,5,3,4,0,5307,5341,19
Task 5308,Job 0,8,6,1,9,1,9,17,8,1,4,0,5308,5341,10
Task 5308,Job 1,13,4,4,12,1,17,25,8,4,4,0,5308,5341,17
Task 5309,Job 0,1,5,2,10,0,3,11,8,2,1,2,5309,5342,18
Task 5309,Job 1,6,4,2,7,0,8,13,5,2,4,0,5309,5342,20
Task 5310,Job 0,1,9,2,10,1,3,11,8,2,1,1,5310,5344,6
Task 5310,Job 1,6,5,1,9,0,7,15,8,1,1,1,5310,5344,4
Task 5311,Job 0,8,10,2,7,1,10,15,5,2,2,1,5311,5344,4
Task 5311,Job 1,13,7,2,7,0,15,20,5,2,4,1,5311,5344,17
Task 5312,Job 0,10,9,3,9,1,13,19,6,3,2,1,5312,5345,8
Task 5312,Job 1,15,9,1,8,0,16,23,7,1,4,1,5312,5345,8
Task 5313,Job 0,10,6,1,9,0,11,19,8,1,2,1,5313,5347,3
Task 5313,Job 1,15,9,2,6,0,17,21,4,2,2,1,5313,5347,19
Task 5314,Job 0,8,5,3,7,0,11,15,4,3,4,0,5314,5348,5
Task 5314,Job 1,13,6,2,9,1,15,22,7,2,4,1,5314,5348,5
Task 5315,Job 0,6,4,4,7,0,10,13,3,4,3,1,5315,5348,11
Task 5315,Job 1,11,5,3,8,0,14,19,5,3,2,0,5315,5348,17
Task 5316,Job 0,4,7,2,7,0,6,11,5,2,2,1,5316,5350,18
Task 5316,Job 1,9,6,1,12,1,10,21,11,1,4,2,5316,5350,6
Task 5317,Job 0,10,10,4,12,0,14,22,8,4,1,1,5317,5351,7
Task 5317,Job 1,15,9,1,8,1,16,23,7,1,4,2,5317,5351,6
Task 5318,Job 0,4,10,4,7,0,8,11,3,4,3,2,5318,5352,2
Task 5318,Job 1,9,5,4,10,0,13,19,6,4,3,2,5318,5352,17
Task 5319,Job 0,5,7,3,9,1,8,14,6,3,2,0,5319,5353,3
Task 5319,Job 1,10,10,2,6,1,12,16,4,2,3,1,5319,5353,19
Task 5320,Job 0,5,4,3,8,0,8,13,5,3,4,0,5320,5354,2
Task 5320,Job 1,10,9,2,10,0,12,20,8,2,3,2,5320,5354,8
Task 5321,Job 0,1,5,1,8,1,2,9,7,1,3,0,5321,5355,9
Task 5321,Job 1,6,7,2,9,0,8,15,7,2,3,1,5321,5355,18
Task 5322,Job 0,6,4,1,11,0,7,17,10,1,2,2,5322,5356,13
Task 5322,Job 1,11,8,2,7,0,13,18,5,2,2,1,5322,5356,17
Task 5323,Job 0,6,5,4,11,1,10,17,7,4,1,2,5323,5356,9
Task 5323,Job 1,11,7,4,10,1,15,21,6,4,2,2,5323,5356,8
Task 5324,Job 0,1,6,2,11,0,3,12,9,2,2,1,5324,5357,12
Task 5324,Job 1,6,10,3,10,1,9,16,7,3,3,0,5324,5357,12
Task 5325,Job 0,6,5,4,8,0,10,14,4,4,3,1,5325,5358,17
Task 5325,Job 1,11,6,2,10,0,13,21,8,2,3,2,5325,5358,20
Task 5326,Job 0,2,10,2,8,0,4,10,6,2,1,1,5326,5359,17
Task 5326,Job 1,7,8,2,11,0,9,18,9,2,3,0,5326,5359,11
Task 5327,Job 0,7,8,2,12,0,9,19,10,2,4,2,5327,5360,13
Task 5327,Job 1,12,8,4,12,0,16,24,8,4,1,0,5327,5360,11
Task 5328,Job 0,10,6,2,9,0,12,19,7,2,1,0,5328,5361,7
Task 5328,Job 1,15,7,3,9,0,18,24,6,3,1,1,5328,5361,13
Task 5329,Job 0,8,6,2,10,0,10,18,8,2,1,0,5329,5363,3
Task 5329,Job 1,13,8,2,12,0,15,25,10,2,1,0,5329,5363,9
Task 5330,Job 0,4,5,3,10,0,7,14,7,3,1,2,5330,5363,15
Task 5330,Job 1,9,4,3,11,0,12,20,8,3,2,0,5330,5363,2
Task 5331,Job 0,9,5,1,9,0,10,18,8,1,3,0,5331,5365,9
Task 5331,Job 1,14,10,2,8,0,16,22,6,2,1,0,5331,5365,20
Task 5332,Job 0,8,10,3,9,1,11,17,6,3,3,2,5332,5366,14
Task 5332,Job 1,13,6,2,8,1,15,21,6,2,1,1,5332,5366,7
Task 5333,Job 0,1,9,1,10,0,2,11,9,1,3,1,5333,5366,5
Task 5333,Job 1,6,4,2,12,1,8,18,10,2,3,0,5333,5366,18
Task 5334,Job 0,3,10,2,10,1,5,13,8,2,1,0,5334,5367,16
Task 5334,Job 1,8,5,4,7,1,12,15,3,4,3,0,5334,5367,10
Task 5335,Job 0,6,10,4,8,0,10,14,4,4,1,1,5335,5368,16
Task 5335,Job 1,11,8,1,10,0,12,21,9,1,1,0,5335,5368,20
Task 5336,Job 0,4,9,1,6,0,5,10,5,1,1,2,5336,5370,17
Task 5336,Job 1,9,6,1,12,0,10,21,11,1,2,0,5336,5370,7
Task 5337,Job 0,6,8,3,12,0,9,18,9,3,1,1,5337,5370,3
Task 5337,Job 1,11,5,2,11,0,13,22,9,2,3,1,5337,5370,19
Task 5338,Job 0,3,5,4,6,0,7,9,2,4,4,0,5338,5372,20
Task 5338,Job 1,8,4,2,10,0,10,18,8,2,2,1,5338,5372,2
Task 5339,Job 0,10,5,2,11,0,12,21,9,2,2,1,5339,5372,13
Task 5339,Job 1,15,8,3,11,0,18,26,8,3,4,1,5339,5372,2
Task 5340,Job 0,10,6,4,6,1,14,16,2,4,1,2,5340,5374,3
Task 5340,Job 1,15,5,2,8,0,17,23,6,2,1,0,5340,5374,19
Task 5341,Job 0,9,10,1,6,0,10,15,5,1,4,0,5341,5375,17
Task 5341,Job 1,14,9,1,8,0,15,22,7,1,4,0,5341,5375,3
Task 5342,Job 0,7,5,4,6,1,11,13,2,4,3,0,5342,5375,13
Task 5342,Job 1,12,8,2,8,1,14,20,6,2,2,2,5342,5375,4
Task 5343,Job 0,7,7,2,11,0,9,18,9,2,2,2,5343,5376,5
Task 5343,Job 1,12,5,3,12,0,15,24,9,3,4,2,5343,5376,6
Task 5344,Job 0,4,9,2,9,0,6,13,7,2,1,2,5344,5377,3
Task 5344,Job 1,9,9,1,6,0,10,15,5,1,2,1,5344,5377,2
Task 5345,Job 0,3,5,4,11,0,7,14,7,4,2,0,5345,5379,9
Task 5345,Job 1,8,9,3,9,0,11,17,6,3,1,2,5345,5379,3
Task 5346,Job 0,3,5,1,10,0,4,13,9,1,4,0,5346,5379,8
Task 5346,Job 1,8,10,3,9,1,11,17,6,3,4,1,5346,5379,20
Task 5347,Job 0,2,7,2,7,0,4,9,5,2,3,1,5347,5380,10
Task 5347,Job 1,7,7,1,12,1,8,19,11,1,2,1,5347,5380,11
Task 5348,Job 0,8,5,1,6,0,9,14,5,1,3,1,5348,5382,7
Task 5348,Job 1,13,4,1,12,1,14,25,11,1,1,1,5348,5382,18
Task 5349,Job 0,8,10,3,7,0,11,15,4,3,4,1,5349,5382,6
Task 5349,Job 1,13,8,3,12,0,16,25,9,3,4,0,5349,5382,19
Task 5350,Job 0,2,8,4,9,0,6,11,5,4,1,0,5350,5383,14
Task 5350,Job 1,7,5,2,8,0,9,15,6,2,4,0,5350,5383,2
Task 5351,Job 0,4,6,4,7,1,8,11,3,4,1,2,5351,5384,10
Task 5351,Job 1,9,5,3,11,0,12,20,8,3,3,1,5351,5384,15
Task 5352,Job 0,5,6,1,9,0,6,14,8,1,3,1,5352,5386,13
Task 5352,Job 1,10,4,3,9,1,13,19,6,3,2,2,5352,5386,4
Task 5353,Job 0,2,6,1,10,0,3,12,9,1,3,0,5353,5387,17
Task 5353,Job 1,7,5,4,12,0,11,19,8,4,3,2,5353,5387,4
Task 5354,Job 0,1,7,4,10,0,5,11,6,4,3,2,5354,5387,2
Task 5354,Job 1,6,10,3,7,0,9,13,4,3,3,0,5354,5387,15
Task 5355,Job 0,4,6,4,9,0,8,13,5,4,3,2,5355,5389,18
Task 5355,Job 1,9,9,4,12,0,13,21,8,4,1,1,5355,5389,18
Task 5356,Job 0,7,9,3,7,1,10,14,4,3,2,2,5356,5390,3
Task 5356,Job 1,12,4,4,6,0,16,18,2,4,2,0,5356,5390,6
Task 5357,Job 0,4,4,1,6,1,5,10,5,1,4,0,5357,5390,3
Task 5357,Job 1,9,4,1,9,0,10,18,8,1,1,0,5357,5390,10
Task 5358,Job 0,1,7,1,10,0,2,11,9,1,2,0,5358,5392,16
Task 5358,Job 1,6,9,3,11,0,9,17,8,3,4,2,5358,5392,16
Task 5359,Job 0,7,5,3,9,1,10,16,6,3,3,0,5359,5393,6
Task 5359,Job 1,12,5,2,12,0,14,24,10,2,2,2,5359,5393,20
Task 5360,Job 0,10,6,1,8,0,11,18,7,1,4,1,5360,5393,20
Task 5360,Job 1,15,9,3,12,0,18,27,9,3,1,0,5360,5393,17
Task 5361,Job 0,7,9,1,11,0,8,18,10,1,3,0,5361,5395,8
Task 5361,Job 1,12,10,3,9,1,15,21,6,3,2,1,5361,5395,16
Task 5362,Job 0,10,6,2,8,0,12,18,6,2,3,0,5362,5395,14
Task 5362,Job 1,15,8,3,6,0,18,21,3,3,1,0,5362,5395,4
Task 5363,Job 0,5,8,3,8,0,8,13,5,3,2,1,5363,5396,6
Task 5363,Job 1,10,6,1,6,0,11,16,5,1,3,0,5363,5396,15
Task 5364,Job 0,2,6,4,12,0,6,14,8,4,2,1,5364,5397,17
Task 5364,Job 1,7,5,2,11,1,9,18,9,2,4,1,5364,5397,6
Task 5365,Job 0,10,5,4,6,0,14,16,2,4,2,2,5365,5399,13
Task 5365,Job 1,15,5,2,10,0,17,25,8,2,2,2,5365,5399,17
Task 5366,Job 0,2,10,4,10,0,6,12,6,4,2,1,5366,5400,17
Task 5366,Job 1,7,9,2,8,0,9,15,6,2,1,1,5366,5400,8
Task 5367,Job 0,1,8,3,10,0,4,11,7,3,2,1,5367,5401,10
Task 5367,Job 1,6,5,3,11,1,9,17,8,3,3,0,5367,5401,10
Task 5368,Job 0,5,4,1,11,0,6,16,10,1,3,2,5368,5402,16
Task 5368,Job 1,10,6,4,8,0,14,18,4,4,1,2,5368,5402,18
Task 5369,Job 0,4,7,1,12,0,5,16,11,1,3,2,5369,5403,16
Task 5369,Job 1,9,9,2,8,0,11,17,6,2,1,1,5369,5403,13
Task 5370,Job 0,4,10,1,9,0,5,13,8,1,3,0,5370,5404,9
Task 5370,Job 1,9,6,3,10,0,12,19,7,3,3,1,5370,5404,8
Task 5371,Job 0,8,6,4,11,1,12,19,7,4,1,1,5371,5404,5
Task 5371,Job 1,13,9,2,12,0,15,25,10,2,1,0,5371,5404,2
Task 5372,Job 0,4,4,1,8,0,5,12,7,1,4,2,5372,5405,7
Task 5372,Job 1,9,8,4,8,0,13,17,4,4,2,2,5372,5405,18
Task 5373,Job 0,9,6,2,10,0,11,19,8,2,1,0,5373,5407,7
Task 5373,Job 1,14,7,1,12,1,15,26,11,1,4,0,5373,5407,16
Task 5374,Job 0,8,8,3,7,0,11,15,4,3,3,0,5374,5407,15
Task 5374,Job 1,13,10,4,6,0,17,19,2,4,1,1,5374,5407,3
Task 5375,Job 0,8,7,1,6,0,9,14,5,1,4,2,5375,5408,7
Task 5375,Job 1,13,7,1,12,0,14,25,11,1,3,1,5375,5408,17
Task 5376,Job 0,6,5,3,10,0,9,16,7,3,2,2,5376,5409,19
Task 5376,Job 1,11,5,1,7,0,12,18,6,1,3,1,5376,5409,8
Task 5377,Job 0,10,7,1,8,0,11,18,7,1,4,0,5377,5411,13
Task 5377,Job 1,15,4,4,11,0,19,26,7,4,3,2,5377,5411,6
Task 5378,Job 0,5,10,3,6,0,8,11,3,3,3,2,5378,5411,4
Task 5378,Job 1,10,8,3,7,1,13,17,4,3,1,0,5378,5411,6
Task 5379,Job 0,9,8,4,11,1,13,20,7,4,1,1,5379,5413,10
Task 5379,Job 1,14,4,1,6,0,15,20,5,1,3,2,5379,5413,13
Task 5380,Job 0,6,5,1,9,0,7,15,8,1,1,2,5380,5414,15
Task 5380,Job 1,11,6,4,10,0,15,21,6,4,4,2,5380,5414,14
Task 5381,Job 0,8,5,3,9,0,11,17,6,3,1,1,5381,5414,16
Task 5381,Job 1,13,10,1,9,1,14,22,8,1,3,0,5381,5414,4
Task 5382,Job 0,9,7,4,11,0,13,20,7,4,3,2,5382,5415,17
Task 5382,Job 1,14,10,4,7,0,18,21,3,4,4,0,5382,5415,4
Task 5383,Job 0,2,4,2,7,0,4,9,5,2,1,1,5383,5417,7
Task 5383,Job 1,7,4,3,10,1,10,17,7,3,3,1,5383,5417,17
Task 5384,Job 0,3,8,1,11,0,4,14,10,1,3,2,5384,5418,14
Task 5384,Job 1,8,7,3,7,0,11,15,4,3,2,1,5384,5418,18
Task 5385,Job 0,6,10,2,10,1,8,16,8,2,3,0,5385,5418,18
Task 5385,Job 1,11,7,2,9,0,13,20,7,2,1,0,5385,5418,8
Task 5386,Job 0,4,9,1,7,0,5,11,6,1,2,2,5386,5420,7
Task 5386,Job 1,9,9,2,12,0,11,21,10,2,2,2,5386,5420,4
Task 5387,Job 0,4,7,4,11,0,8,15,7,4,4,0,5387,5421,8
Task 5387,Job 1,9,10,4,12,0,13,21,8,4,2,0,5387,5421,6
Task 5388,Job 0,9,7,3,12,0,12,21,9,3,3,2,5388,5421,5
Task 5388,Job 1,14,10,4,12,1,18,26,8,4,3,2,5388,5421,17
Task 5389,Job 0,9,5,3,7,0,12,16,4,3,4,2,5389,5422,4
Task 5389,Job 1,14,6,4,7,0,18,21,3,4,1,1,5389,5422,20
Task 5390,Job 0,9,7,1,10,0,10,19,9,1,3,1,5390,5423,2
Task 5390,Job 1,14,10,1,9,0,15,23,8,1,4,0,5390,5423,14
Task 5391,Job 0,6,8,1,12,0,7,18,11,1,4,1,5391,5424,5
Task 5391,Job 1,11,10,1,11,1,12,22,10,1,1,1,5391,5424,10
Task 5392,Job 0,5,7,2,6,0,7,11,4,2,3,0,5392,5426,4
Task 5392,Job 1,10,6,2,12,0,12,22,10,2,4,2,5392,5426,10
Task 5393,Job 0,1,8,2,10,1,3,11,8,2,3,0,5393,5426,17
Task 5393,Job 1,6,10,4,6,0,10,12,2,4,3,0,5393,5426,4
Task 5394,Job 0,10,6,3,8,0,13,18,5,3,2,0,5394,5428,9
Task 5394,Job 1,15,5,2,11,0,17,26,9,2,2,2,5394,5428,9
Task 5395,Job 0,8,5,2,11,0,10,19,9,2,2,2,5395,5428,20
Task 5395,Job 1,13,6,4,11,1,17,24,7,4,4,2,5395,5428,16
Task 5396,Job 0,8,5,1,6,1,9,14,5,1,3,2,5396,5430,8
Task 5396,Job 1,13,7,2,11,0,15,24,9,2,4,2,5396,5430,9
Task 5397,Job 0,3,7,1,9,0,4,12,8,1,1,2,5397,5431,13
Task 5397,Job 1,8,5,3,7,0,11,15,4,3,1,0,5397,5431,2
Task 5398,Job 0,4,10,1,10,0,5,14,9,1,2,1,5398,5432,18
Task 5398,Job 1,9,6,4,10,0,13,19,6,4,4,1,5398,5432,7
Task 5399,Job 0,6,10,3,6,0,9,12,3,3,1,0,5399,5433,20
Task 5399,Job 1,11,5,4,12,0,15,23,8,4,2,2,5399,5433,7
Task 5400,Job 0,2,10,3,6,0,5,8,3,3,3,2,5400,5433,2
Task 5400,Job 1,7,7,2,12,0,9,19,10,2,3,1,5400,5433,12
Task 5401,Job 0,4,5,2,7,0,6,11,5,2,4,0,5401,5435,8
Task 5401,Job 1,9,9,3,11,0,12,20,8,3,1,2,5401,5435,18
Task 5402,Job 0,1,9,4,8,0,5,9,4,4,2,0,5402,5435,9
Task 5402,Job 1,6,4,4,12,1,10,18,8,4,1,2,5402,5435,12
Task 5403,Job 0,5,7,1,8,0,6,13,7,1,3,0,5403,5436,17
Task 5403,Job 1,10,6,1,7,0,11,17,6,1,4,1,5403,5436,7
Task 5404,Job 0,6,10,1,9,0,7,15,8,1,4,0,5404,5437,20
Task 5404,Job 1,11,9,3,8,0,14,19,5,3,2,2,5404,5437,17
Task 5405,Job 0,5,5,1,10,0,6,15,9,1,4,2,5405,5438,7
Task 5405,Job 1,10,9,1,7,0,11,17,6,1,1,1,5405,5438,17
Task 5406,Job 0,1,9,3,11,1,4,12,8,3,3,2,5406,5440,13
Task 5406,Job 1,6,10,1,10,0,7,16,9,1,3,1,5406,5440,20
Task 5407,Job 0,2,10,3,10,0,5,12,7,3,2,0,5407,5441,7
Task 5407,Job 1,7,6,2,6,1,9,13,4,2,2,0,5407,5441,2
Task 5408,Job 0,5,4,1,9,1,6,14,8,1,2,1,5408,5441,18
Task 5408,Job 1,10,5,4,6,0,14,16,2,4,1,2,5408,5441,16
Task 5409,Job 0,3,8,4,11,1,7,14,7,4,3,1,5409,5442,4
Task 5409,Job 1,8,9,1,12,1,9,20,11,1,3,2,5409,5442,15
Task 5410,Job 0,8,5,2,11,0,10,19,9,2,4,1,5410,5444,5
Task 5410,Job 1,13,5,3,9,0,16,22,6,3,3,2,5410,5444,14
Task 5411,Job 0,7,9,3,12,0,10,19,9,3,1,2,5411,5444,13
Task 5411,Job 1,12,9,4,12,1,16,24,8,4,3,0,5411,5444,5
Task 5412,Job 0,4,9,1,6,0,5,10,5,1,3,1,5412,5446,17
Task 5412,Job 1,9,7,2,8,0,11,17,6,2,2,0,5412,5446,6
Task 5413,Job 0,3,5,1,6,0,4,9,5,1,4,0,5413,5446,16
Task 5413,Job 1,8,7,3,11,0,11,19,8,3,3,2,5413,5446,7
Task 5414,Job 0,7,4,1,6,0,8,13,5,1,2,0,5414,5447,13
Task 5414,Job 1,12,7,2,10,0,14,22,8,2,2,2,5414,5447,16
Task 5415,Job 0,6,9,3,6,0,9,12,3,3,3,0,5415,5448,4
Task 5415,Job 1,11,6,1,10,1,12,21,9,1,3,2,5415,5448,16
Task 5416,Job 0,8,5,2,6,0,10,14,4,2,1,1,5416,5449,13
Task 5416,Job 1,13,10,2,12,0,15,25,10,2,4,1,5416,5449,4
Task 5417,Job 0,3,8,2,10,0,5,13,8,2,2,1,5417,5451,4
Task 5417,Job 1,8,8,4,8,0,12,16,4,4,1,1,5417,5451,11
Task 5418,Job 0,7,8,1,10,0,8,17,9,1,2,2,5418,5452,3
Task 5418,Job 1,12,8,3,6,0,15,18,3,3,2,1,5418,5452,12
Task 5419,Job 0,4,5,4,8,1,8,12,4,4,1,0,5419,5453,8
Task 5419,Job 1,9,9,2,12,0,11,21,10,2,3,1,5419,5453,11
Task 5420,Job 0,1,5,1,10,0,2,11,9,1,3,1,5420,5454,11
Task 5420,Job 1,6,8,1,9,0,7,15,8,1,3,1,5420,5454,18
Task 5421,Job 0,5,4,4,9,0,9,14,5,4,2,1,5421,5455,9
Task 5421,Job 1,10,8,2,7,0,12,17,5,2,2,2,5421,5455,16
Task 5422,Job 0,7,9,1,7,0,8,14,6,1,4,1,5422,5455,6
Task 5422,Job 1,12,5,2,10,0,14,22,8,2,3,0,5422,5455,19
Task 5423,Job 0,10,9,1,12,1,11,22,11,1,1,2,5423,5457,7
Task 5423,Job 1,15,5,1,12,0,16,27,11,1,3,2,5423,5457,11
Task 5424,Job 0,5,5,2,10,0,7,15,8,2,3,0,5424,5458,7
Task 5424,Job 1,10,9,1,9,0,11,19,8,1,3,0,5424,5458,2
Task 5425,Job 0,7,4,3,12,0,10,19,9,3,4,2,5425,5459,12
Task 5425,Job 1,12,5,1,8,0,13,20,7,1,1,2,5425,5459,12
Task 5426,Job 0,4,9,4,10,1,8,14,6,4,2,0,5426,5459,18
Task 5426,Job 1,9,6,2,6,0,11,15,4,2,2,0,5426,5459,20
Task 5427,Job 0,5,5,4,10,0,9,15,6,4,3,2,5427,5460,9
Task 5427,Job 1,10,7,4,6,0,14,16,2,4,3,2,5427,5460,19
Task 5428,Job 0,7,5,1,9,1,8,16,8,1,3,0,5428,5462,17
Task 5428,Job 1,12,4,1,11,0,13,23,10,1,3,0,5428,5462,12
Task 5429,Job 0,3,5,1,11,0,4,14,10,1,1,1,5429,5463,16
Task 5429,Job 1,8,10,4,8,0,12,16,4,4,1,2,5429,5463,18
Task 5430,Job 0,8,10,1,10,0,9,18,9,1,4,1,5430,5464,20
Task 5430,Job 1,13,9,4,12,0,17,25,8,4,4,0,5430,5464,13
Task 5431,Job 0,4,8,3,11,0,7,15,8,3,4,1,5431,5465,8
Task 5431,Job 1,9,9,4,12,0,13,21,8,4,4,2,5431,5465,3
Task 5432,Job 0,1,8,1,10,0,2,11,9,1,4,2,5432,5466,20
Task 5432,Job 1,6,10,1,7,1,7,13,6,1,2,0,5432,5466,7
Task 5433,Job 0,5,7,3,8,1,8,13,5,3,4,1,5433,5466,7
Task 5433,Job 1,10,8,1,11,0,11,21,10,1,2,0,5433,5466,9
Task 5434,Job 0,9,4,1,7,0,10,16,6,1,1,0,5434,5467,9
Task 5434,Job 1,14,4,2,9,0,16,23,7,2,3,1,5434,5467,11
Task 5435,Job 0,5,7,1,9,0,6,14,8,1,4,0,5435,5468,9
Task 5435,Job 1,10,6,2,6,1,12,16,4,2,2,0,5435,5468,16
Task 5436,Job 0,9,9,3,6,0,12,15,3,3,1,0,5436,5470,2
Task 5436,Job 1,14,6,2,11,0,16,25,9,2,1,2,5436,5470,8
Task 5437,Job 0,7,10,3,10,0,10,17,7,3,2,2,5437,5471,20
Task 5437,Job 1,12,7,3,8,0,15,20,5,3,3,2,5437,5471,3
Task 5438,Job 0,8,5,2,8,0,10,16,6,2,2,0,5438,5472,3
Task 5438,Job 1,13,7,3,9,1,16,22,6,3,1,2,5438,5472,5
Task 5439,Job 0,8,4,2,9,0,10,17,7,2,4,2,5439,5473,20
Task 5439,Job 1,13,9,2,11,0,15,24,9,2,1,0,5439,5473,11
Task 5440,Job 0,10,8,3,6,0,13,16,3,3,1,1,5440,5473,11
Task 5440,Job 1,15,8,4,10,0,19,25,6,4,2,1,5440,5473,12
Task 5441,Job 0,5,6,3,12,0,8,17,9,3,2,1,5441,5475,9
Task 5441,Job 1,10,9,1,11,1,11,21,10,1,2,1,5441,5475,12
Task 5442,Job 0,10,6,3,7,1,13,17,4,3,2,1,5442,5476,10
Task 5442,Job 1,15,5,1,9,1,16,24,8,1,4,0,5442,5476,8
Task 5443,Job 0,3,8,2,11,1,5,14,9,2,2,2,5443,5476,2
Task 5443,Job 1,8,9,3,7,0,11,15,4,3,1,1,5443,5476,8
Task 5444,Job 0,7,7,1,12,0,8,19,11,1,1,0,5444,5477,5
Task 5444,Job 1,12,9,1,8,1,13,20,7,1,4,2,5444,5477,20
Task 5445,Job 0,6,5,4,9,0,10,15,5,4,4,0,5445,5478,20
Task 5445,Job 1,11,5,2,10,0,13,21,8,2,1,1,5445,5478,10
Task 5446,Job 0,6,4,1,10,0,7,16,9,1,3,2,5446,5479,9
Task 5446,Job 1,11,5,1,9,0,12,20,8,1,1,1,5446,5479,3
Task 5447,Job 0,7,6,1,11,0,8,18,10,1,2,1,5447,5480,12
Task 5447,Job 1,12,6,1,8,0,13,20,7,1,4,1,5447,5480,20
Task 5448,Job 0,8,7,4,11,1,12,19,7,4,4,2,5448,5481,5
Task 5448,Job 1,13,5,3,9,0,16,22,6,3,2,0,5448,5481,3
Task 5449,Job 0,5,4,3,12,0,8,17,9,3,4,1,5449,5482,4
Task 5449,Job 1,10,5,3,7,0,13,17,4,3,2,0,5449,5482,6
Task 5450,Job 0,6,6,1,11,0,7,17,10,1,2,1,5450,5483,18
Task 5450,Job 1,11,6,1,12,0,12,23,11,1,1,2,5450,5483,12
Task 5451,Job 0,3,4,1,7,0,4,10,6,1,1,1,5451,5484,14
Task 5451,Job 1,8,7,4,10,0,12,18,6,4,3,1,5451,5484,16
Task 5452,Job 0,4,5,4,6,0,8,10,2,4,4,2,5452,5486,13
Task 5452,Job 1,9,7,3,7,0,12,16,4,3,4,0,5452,5486,18
Task 5453,Job 0,7,7,3,11,1,10,18,8,3,4,0,5453,5487,6
Task 5453,Job 1,12,4,2,11,0,14,23,9,2,2,0,5453,5487,17
Task 5454,Job 0,8,10,2,7,1,10,15,5,2,2,1,5454,5487,6
Task 5454,Job 1,13,8,3,11,0,16,24,8,3,3,0,5454,5487,8
Task 5455,Job 0,6,7,4,11,0,10,17,7,4,4,0,5455,5488,4
Task 5455,Job 1,11,5,1,8,0,12,19,7,1,1,0,5455,5488,20
Task 5456,Job 0,4,4,1,12,0,5,16,11,1,2,2,5456,5490,8
Task 5456,Job 1,9,9,4,11,0,13,20,7,4,3,0,5456,5490,9
Task 5457,Job 0,6,8,4,10,0,10,16,6,4,1,1,5457,5490,15
Task 5457,Job 1,11,10,4,7,0,15,18,3,4,2,0,5457,5490,4
Task 5458,Job 0,1,9,2,6,0,3,7,4,2,2,0,5458,5491,17
Task 5458,Job 1,6,7,1,11,0,7,17,10,1,1,2,5458,5491,8
Task 5459,Job 0,8,6,1,9,0,9,17,8,1,1,2,5459,5492,11
Task 5459,Job 1,13,4,2,10,0,15,23,8,2,3,0,5459,5492,11
Task 5460,Job 0,4,4,2,10,1,6,14,8,2,3,0,5460,5494,19
Task 5460,Job 1,9,10,3,7,0,12,16,4,3,2,2,5460,5494,15
Task 5461,Job 0,2,9,4,12,1,6,14,8,4,2,2,5461,5495,10
Task 5461,Job 1,7,4,4,8,1,11,15,4,4,2,0,5461,5495,2
Task 5462,Job 0,1,5,4,12,1,5,13,8,4,1,1,5462,5496,9
Task 5462,Job 1,6,10,2,6,1,8,12,4,2,4,2,5462,5496,20
Task 5463,Job 0,5,8,3,7,0,8,12,4,3,2,1,5463,5496,16
Task 5463,Job 1,10,6,1,11,0,11,21,10,1,4,0,5463,5496,17
Task 5464,Job 0,10,6,2,9,0,12,19,7,2,4,0,5464,5498,13
Task 5464,Job 1,15,5,3,12,0,18,27,9,3,1,2,5464,5498,11
Task 5465,Job 0,5,10,3,7,0,8,12,4,3,1,1,5465,5499,19
Task 5465,Job 1,10,5,3,8,0,13,18,5,3,1,0,5465,5499,5
Task 5466,Job 0,9,8,2,9,0,11,18,7,2,1,0,5466,5499,4
Task 5466,Job 1,14,10,3,11,0,17,25,8,3,2,2,5466,5499,18
Task 5467,Job 0,3,10,1,11,0,4,14,10,1,3,1,5467,5500,10
Task 5467,Job 1,8,7,3,7,0,11,15,4,3,3,0,5467,5500,9
Task 5468,Job 0,9,5,3,6,0,12,15,3,3,3,0,5468,5502,4
Task 5468,Job 1,14,5,2,6,0,16,20,4,2,1,1,5468,5502,6
Task 5469,Job 0,4,6,2,11,1,6,15,9,2,4,0,5469,5503,20
Task 5469,Job 1,9,9,3,7,1,12,16,4,3,4,0,5469,5503,7
Task 5470,Job 0,2,10,1,8,0,3,10,7,1,1,0,5470,5503,12
Task 5470,Job 1,7,7,1,9,1,8,16,8,1,3,2,5470,5503,15
Task 5471,Job 0,4,10,2,7,0,6,11,5,2,1,1,5471,5504,5
Task 5471,Job 1,9,5,1,11,0,10,20,10,1,2,2,5471,5504,2
Task 5472,Job 0,10,9,3,8,1,13,18,5,3,4,1,5472,5505,17
Task 5472,Job 1,15,9,1,11,0,16,26,10,1,1,1,5472,5505,10
Task 5473,Job 0,6,7,3,12,0,9,18,9,3,1,2,5473,5506,5
Task 5473,Job 1,11,9,3,12,0,14,23,9,3,2,0,5473,5506,18
Task 5474,Job 0,8,8,1,6,1,9,14,5,1,1,0,5474,5507,11
Task 5474,Job 1,13,5,1,6,0,14,19,5,1,1,2,5474,5507,10
Task 5475,Job 0,3,10,2,12,0,5,15,10,2,2,1,5475,5509,8
Task 5475,Job 1,8,9,2,10,1,10,18,8,2,3,1,5475,5509,7
Task 5476,Job 0,9,7,3,12,1,12,21,9,3,1,2,5476,5510,9
Task 5476,Job 1,14,8,4,6,0,18,20,2,4,4,0,5476,5510,8
Task 5477,Job 0,6,5,1,10,1,7,16,9,1,3,0,5477,5510,5
Task 5477,Job 1,11,5,1,6,1,12,17,5,1,4,2,5477,5510,16
Task 5478,Job 0,8,10,2,6,1,10,14,4,2,4,2,5478,5512,6
Task 5478,Job 1,13,5,3,11,0,16,24,8,3,4,0,5478,5512,7
Task 5479,Job 0,10,4,3,8,0,13,18,5,3,2,0,5479,5513,13
Task 5479,Job 1,15,9,1,11,1,16,26,10,1,2,1,5479,5513,6
Task 5480,Job 0,4,4,2,10,0,6,14,8,2,4,1,5480,5514,9
Task 5480,Job 1,9,6,1,6,1,10,15,5,1,3,1,5480,5514,16
Task 5481,Job 0,8,4,4,10,0,12,18,6,4,4,2,5481,5515,8
Task 5481,Job 1,13,8,1,9,0,14,22,8,1,2,2,5481,5515,4
Task 5482,Job 0,3,4,4,12,0,7,15,8,4,4,0,5482,5516,15
Task 5482,Job 1,8,5,1,8,0,9,16,7,1,3,0,5482,5516,19
Task 5483,Job 0,10,9,3,10,0,13,20,7,3,2,1,5483,5517,17
Task 5483,Job 1,15,4,4,8,0,19,23,4,4,3,0,5483,5517,10
Task 5484,Job 0,3,9,2,12,0,5,15,10,2,1,0,5484,5518,5
Task 5484,Job 1,8,4,4,12,1,12,20,8,4,3,2,5484,5518,10
Task 5485,Job 0,6,10,1,6,1,7,12,5,1,1,2,5485,5519,10
Task 5485,Job 1,11,5,1,12,0,12,23,11,1,4,0,5485,5519,17
Task 5486,Job 0,10,5,4,6,0,14,16,2,4,1,0,5486,5519,18
Task 5486,Job 1,15,5,3,10,0,18,25,7,3,2,0,5486,5519,9
Task 5487,Job 0,6,4,4,6,1,10,12,2,4,4,1,5487,5520,9
Task 5487,Job 1,11,7,4,8,1,15,19,4,4,2,1,5487,5520,19
Task 5488,Job 0,8,10,3,9,0,11,17,6,3,4,2,5488,5522,7
Task 5488,Job 1,13,8,2,6,0,15,19,4,2,4,1,5488,5522,4
Task 5489,Job 0,8,4,3,11,1,11,19,8,3,2,2,5489,5522,13
Task 5489,Job 1,13,7,4,10,1,17,23,6,4,4,0,5489,5522,9
Task 5490,Job 0,9,7,2,9,0,11,18,7,2,3,2,5490,5524,9
Task 5490,Job 1,14,7,2,7,0,16,21,5,2,1,2,5490,5524,8
Task 5491,Job 0,2,5,3,9,0,5,11,6,3,4,2,5491,5525,19
Task 5491,Job 1,7,4,4,12,1,11,19,8,4,3,2,5491,5525,11
Task 5492,Job 0,6,9,4,6,1,10,12,2,4,2,1,5492,5525,10
Task 5492,Job 1,11,4,2,7,0,13,18,5,2,3,0,5492,5525,2
Task 5493,Job 0,8,9,4,10,0,12,18,6,4,3,2,5493,5527,20
Task 5493,Job 1,13,10,4,11,0,17,24,7,4,4,1,5493,5527,3
Task 5494,Job 0,10,5,3,6,0,13,16,3,3,1,2,5494,5528,15
Task 5494,Job 1,15,6,1,9,0,16,24,8,1,4,1,5494,5528,14
Task 5495,Job 0,6,4,1,7,0,7,13,6,1,1,2,5495,5528,4
Task 5495,Job 1,11,7,4,11,1,15,22,7,4,3,2,5495,5528,20
Task 5496,Job 0,4,5,1,8,0,5,12,7,1,3,0,5496,5529,11
Task 5496,Job 1,9,6,4,10,1,13,19,6,4,4,0,5496,5529,20
Task 5497,Job 0,9,6,1,11,1,10,20,10,1,3,2,5497,5530,9
Task 5497,Job 1,14,9,2,8,0,16,22,6,2,2,0,5497,5530,7
Task 5498,Job 0,7,9,3,11,0,10,18,8,3,3,0,5498,5531,14
Task 5498,Job 1,12,10,4,9,0,16,21,5,4,4,0,5498,5531,2
Task 5499,Job 0,10,6,4,9,0,14,19,5,4,4,2,5499,5533,8
Task 5499,Job 1,15,10,2,9,0,17,24,7,2,2,0,5499,5533,2
Task 5500,Job 0,2,6,3,6,0,5,8,3,3,2,2,5500,5534,17
Task 5500,Job 1,7,4,1,9,0,8,16,8,1,2,1,5500,5534,14
Task 5501,Job 0,6,5,4,12,1,10,18,8,4,3,1,5501,5534,2
Task 5501,Job 1,11,9,2,6,1,13,17,4,2,3,0,5501,5534,11
Task 5502,Job 0,3,4,4,12,0,7,15,8,4,1,2,5502,5536,10
Task 5502,Job 1,8,10,3,7,0,11,15,4,3,3,2,5502,5536,10
Task 5503,Job 0,8,6,1,11,1,9,19,10,1,2,1,5503,5537,11
Task 5503,Job 1,13,9,3,10,0,16,23,7,3,3,2,5503,5537,13
Task 5504,Job 0,5,10,3,10,0,8,15,7,3,2,0,5504,5538,8
Task 5504,Job 1,10,10,1,7,1,11,17,6,1,3,0,5504,5538,3
Task 5505,Job 0,7,5,1,6,0,8,13,5,1,4,1,5505,5538,9
Task 5505,Job 1,12,7,3,11,1,15,23,8,3,2,1,5505,5538,9
Task 5506,Job 0,1,10,1,8,1,2,9,7,1,3,1,5506,5540,18
Task 5506,Job 1,6,4,2,7,0,8,13,5,2,2,1,5506,5540,10
Task 5507,Job 0,5,8,2,6,0,7,11,4,2,4,0,5507,5540,2
Task 5507,Job 1,10,5,3,10,0,13,20,7,3,4,0,5507,5540,12
Task 5508,Job 0,4,7,4,10,0,8,14,6,4,4,0,5508,5542,4
Task 5508,Job 1,9,6,4,11,0,13,20,7,4,4,0,5508,5542,18
Task 5509,Job 0,10,8,4,6,0,14,16,2,4,1,1,5509,5542,15
Task 5509,Job 1,15,6,1,11,0,16,26,10,1,2,1,5509,5542,10
Task 5510,Job 0,2,5,4,12,0,6,14,8,4,3,2,5510,5544,20
Task 5510,Job 1,7,8,2,6,0,9,13,4,2,4,2,5510,5544,20
Task 5511,Job 0,4,6,4,9,0,8,13,5,4,4,0,5511,5544,5
Task 5511,Job 1,9,7,4,7,0,13,16,3,4,4,0,5511,5544,11
Task 5512,Job 0,10,7,4,6,1,14,16,2,4,3,2,5512,5546,11
Task 5512,Job 1,15,9,2,10,0,17,25,8,2,3,2,5512,5546,14
Task 5513,Job 0,3,10,4,8,1,7,11,4,4,4,0,5513,5547,4
Task 5513,Job 1,8,5,1,12,1,9,20,11,1,2,2,5513,5547,6
Task 5514,Job 0,10,4,1,7,0,11,17,6,1,3,2,5514,5548,20
Task 5514,Job 1,15,7,3,8,0,18,23,5,3,2,2,5514,5548,7
Task 5515,Job 0,3,10,1,11,0,4,14,10,1,4,2,5515,5549,19
Task 5515,Job 1,8,7,1,6,0,9,14,5,1,1,1,5515,5549,13
Task 5516,Job 0,4,4,2,11,0,6,15,9,2,2,2,5516,5549,15
Task 5516,Job 1,9,5,3,12,0,12,21,9,3,2,2,5516,5549,15
Task 5517,Job 0,6,6,3,8,0,9,14,5,3,4,2,5517,5551,18
Task 5517,Job 1,11,10,2,8,0,13,19,6,2,1,2,5517,5551,6
Task 5518,Job 0,9,7,3,7,1,12,16,4,3,3,1,5518,5551,15
Task 5518,Job 1,14,7,2,10,0,16,24,8,2,2,0,5518,5551,14
Task 5519,Job 0,9,7,4,9,0,13,18,5,4,2,2,5519,5552,19
Task 5519,Job 1,14,10,3,9,1,17,23,6,3,2,2,5519,5552,10
Task 5520,Job 0,2,9,4,10,0,6,12,6,4,1,1,5520,5553,20
Task 5520,Job 1,7,4,4,11,1,11,18,7,4,2,0,5520,5553,8
Task 5521,Job 0,7,10,1,10,1,8,17,9,1,3,1,5521,5554,14
Task 5521,Job 1,12,7,1,10,1,13,22,9,1,2,0,5521,5554,14
Task 5522,Job 0,9,7,1,11,0,10,20,10,1,2,2,5522,5556,19
Task 5522,Job 1,14,5,4,10,1,18,24,6,4,2,0,5522,5556,6
Task 5523,Job 0,6,4,3,9,0,9,15,6,3,3,2,5523,5557,17
Task 5523,Job 1,11,6,3,6,0,14,17,3,3,2,2,5523,5557,6
Task 5524,Job 0,8,4,2,10,0,10,18,8,2,3,1,5524,5557,6
Task 5524,Job 1,13,10,4,10,0,17,23,6,4,3,0,5524,5557,10
Task 5525,Job 0,2,10,1,9,1,3,11,8,1,2,1,5525,5558,12
Task 5525,Job 1,7,10,1,6,1,8,13,5,1,2,1,5525,5558,3
Task 5526,Job 0,1,9,1,9,0,2,10,8,1,3,0,5526,5559,13
Task 5526,Job 1,6,6,2,11,0,8,17,9,2,2,1,5526,5559,7
Task 5527,Job 0,9,6,1,8,0,10,17,7,1,3,2,5527,5560,11
Task 5527,Job 1,14,7,2,10,1,16,24,8,2,4,0,5527,5560,4
Task 5528,Job 0,1,9,2,12,0,3,13,10,2,1,2,5528,5561,12
Task 5528,Job 1,6,8,4,8,0,10,14,4,4,1,2,5528,5561,8
Task 5529,Job 0,3,9,4,6,0,7,9,2,4,3,1,5529,5563,16
Task 5529,Job 1,8,8,4,12,1,12,20,8,4,4,1,5529,5563,7
Task 5530,Job 0,7,7,2,12,0,9,19,10,2,4,1,5530,5563,18
Task 5530,Job 1,12,5,4,10,0,16,22,6,4,3,1,5530,5563,19
Task 5531,Job 0,1,6,1,6,0,2,7,5,1,4,2,5531,5564,3
Task 5531,Job 1,6,5,1,7,0,7,13,6,1,3,0,5531,5564,19
Task 5532,Job 0,7,8,2,12,0,9,19,10,2,1,1,5532,5566,14
Task 5532,Job 1,12,7,2,12,0,14,24,10,2,4,0,5532,5566,8
Task 5533,Job 0,2,4,4,7,0,6,9,3,4,1,1,5533,5567,19
Task 5533,Job 1,7,7,1,8,1,8,15,7,1,3,0,5533,5567,14
Task 5534,Job 0,4,4,4,8,0,8,12,4,4,3,2,5534,5567,10
Task 5534,Job 1,9,8,4,10,0,13,19,6,4,2,1,5534,5567,6
Task 5535,Job 0,9,5,2,11,0,11,20,9,2,3,0,5535,5569,2
Task 5535,Job 1,14,10,1,11,1,15,25,10,1,2,0,5535,5569,18
Task 5536,Job 0,7,9,4,12,0,11,19,8,4,4,2,5536,5570,20
Task 5536,Job 1,12,8,2,8,0,14,20,6,2,1,2,5536,5570,10
Task 5537,Job 0,9,4,3,7,0,12,16,4,3,2,0,5537,5571,11
Task 5537,Job 1,14,4,4,12,0,18,26,8,4,1,1,5537,5571,16
Task 5538,Job 0,2,7,2,6,1,4,8,4,2,2,2,5538,5571,6
Task 5538,Job 1,7,4,1,12,0,8,19,11,1,1,0,5538,5571,10
Task 5539,Job 0,9,4,1,10,0,10,19,9,1,3,2,5539,5573,3
Task 5539,Job 1,14,5,1,10,0,15,24,9,1,3,1,5539,5573,2
Task 5540,Job 0,2,6,1,11,0,3,13,10,1,1,2,5540,5573,15
Task 5540,Job 1,7,7,3,10,1,10,17,7,3,3,2,5540,5573,13
Task 5541,Job 0,2,10,3,7,0,5,9,4,3,1,2,5541,5574,13
Task 5541,Job 1,7,9,2,8,0,9,15,6,2,4,2,5541,5574,15
Task 5542,Job 0,4,10,3,6,0,7,10,3,3,4,0,5542,5576,5
Task 5542,Job 1,9,9,2,12,1,11,21,10,2,4,0,5542,5576,20
Task 5543,Job 0,6,8,1,12,0,7,18,11,1,1,2,5543,5577,17
Task 5543,Job 1,11,10,4,11,0,15,22,7,4,1,1,5543,5577,12
Task 5544,Job 0,6,9,3,9,0,9,15,6,3,4,1,5544,5578,6
Task 5544,Job 1,11,10,1,11,0,12,22,10,1,4,0,5544,5578,20
Task 5545,Job 0,2,5,2,7,1,4,9,5,2,3,0,5545,5578,14
Task 5545,Job 1,7,7,3,10,0,10,17,7,3,3,2,5545,5578,5
Task 5546,Job 0,5,8,3,8,0,8,13,5,3,4,0,5546,5579,5
Task 5546,Job 1,10,9,1,8,0,11,18,7,1,2,0,5546,5579,20
Task 5547,Job 0,10,9,2,12,1,12,22,10,2,2,2,5547,5581,12
Task 5547,Job 1,15,4,3,9,0,18,24,6,3,1,0,5547,5581,4
Task 5548,Job 0,8,4,1,7,0,9,15,6,1,3,1,5548,5581,15
Task 5548,Job 1,13,7,1,6,0,14,19,5,1,4,2,5548,5581,20
Task 5549,Job 0,5,10,2,6,0,7,11,4,2,4,1,5549,5583,11
Task 5549,Job 1,10,9,2,7,0,12,17,5,2,1,1,5549,5583,19
Task 5550,Job 0,1,5,3,8,0,4,9,5,3,2,2,5550,5583,15
Task 5550,Job 1,6,6,1,6,0,7,12,5,1,3,0,5550,5583,10
Task 5551,Job 0,2,4,3,7,0,5,9,4,3,2,0,5551,5585,17
Task 5551,Job 1,7,8,1,12,1,8,19,11,1,4,0,5551,5585,3
Task 5552,Job 0,4,7,4,12,1,8,16,8,4,2,2,5552,5586,7
Task 5552,Job 1,9,4,2,12,0,11,21,10,2,1,0,5552,5586,5
Task 5553,Job 0,2,5,2,12,0,4,14,10,2,3,0,5553,5586,16
Task 5553,Job 1,7,9,3,10,1,10,17,7,3,2,2,5553,5586,7
Task 5554,Job 0,8,8,4,9,0,12,17,5,4,2,2,5554,5588,7
Task 5554,Job 1,13,4,1,8,0,14,21,7,1,4,0,5554,5588,5
Task 5555,Job 0,8,7,3,10,0,11,18,7,3,2,0,5555,5589,10
Task 5555,Job 1,13,10,1,8,0,14,21,7,1,2,0,5555,5589,9
Task 5556,Job 0,9,7,3,9,0,12,18,6,3,2,0,5556,5590,11
Task 5556,Job 1,14,7,4,7,0,18,21,3,4,1,0,5556,5590,2
Task 5557,Job 0,7,8,1,9,1,8,16,8,1,2,0,5557,5591,19
Task 5557,Job 1,12,7,2,11,0,14,23,9,2,2,2,5557,5591,3
Task 5558,Job 0,4,6,1,8,0,5,12,7,1,4,0,5558,5591,11
Task 5558,Job 1,9,10,1,12,0,10,21,11,1,2,2,5558,5591,3
Task 5559,Job 0,2,7,3,12,0,5,14,9,3,2,0,5559,5593,20
Task 5559,Job 1,7,5,2,12,0,9,19,10,2,2,1,5559,5593,10
Task 5560,Job 0,9,7,2,8,0,11,17,6,2,1,1,5560,5594,8
Task 5560,Job 1,14,10,2,11,0,16,25,9,2,4,2,5560,5594,17
Task 5561,Job 0,1,5,4,12,0,5,13,8,4,2,0,5561,5594,7
Task 5561,Job 1,6,9,4,9,1,10,15,5,4,1,1,5561,5594,5
Task 5562,Job 0,7,8,1,10,0,8,17,9,1,1,1,5562,5595,17
Task 5562,Job 1,12,5,3,6,0,15,18,3,3,2,0,5562,5595,7
Task 5563,Job 0,3,8,1,12,0,4,15,11,1,2,1,5563,5597,13
Task 5563,Job 1,8,7,1,6,0,9,14,5,1,1,1,5563,5597,6
Task 5564,Job 0,4,9,4,10,0,8,14,6,4,3,0,5564,5597,12
Task 5564,Job 1,9,5,1,11,0,10,20,10,1,3,1,5564,5597,11
Task 5565,Job 0,8,10,2,12,0,10,20,10,2,1,2,5565,5599,14
Task 5565,Job 1,13,6,4,6,0,17,19,2,4,2,0,5565,5599,15
Task 5566,Job 0,8,8,3,8,0,11,16,5,3,2,2,5566,5599,13
Task 5566,Job 1,13,10,3,7,0,16,20,4,3,4,0,5566,5599,9
Task 5567,Job 0,9,8,1,8,0,10,17,7,1,1,0,5567,5600,8
Task 5567,Job 1,14,7,4,10,0,18,24,6,4,2,1,5567,5600,17
Task 5568,Job 0,6,8,3,6,0,9,12,3,3,3,2,5568,5601,18
Task 5568,Job 1,11,10,1,12,1,12,23,11,1,2,1,5568,5601,14
Task 5569,Job 0,2,9,2,6,0,4,8,4,2,2,0,5569,5603,7
Task 5569,Job 1,7,5,1,6,1,8,13,5,1,2,2,5569,5603,19
Task 5570,Job 0,10,5,1,10,0,11,20,9,1,3,2,5570,5603,12
Task 5570,Job 1,15,6,2,7,1,17,22,5,2,2,2,5570,5603,10
Task 5571,Job 0,7,7,4,11,0,11,18,7,4,3,1,5571,5605,16
Task 5571,Job 1,12,10,2,10,0,14,22,8,2,2,1,5571,5605,9
Task 5572,Job 0,5,6,1,12,0,6,17,11,1,2,1,5572,5605,4
Task 5572,Job 1,10,4,2,7,0,12,17,5,2,3,2,5572,5605,7
Task 5573,Job 0,4,9,4,12,1,8,16,8,4,4,1,5573,5607,7
Task 5573,Job 1,9,5,4,7,0,13,16,3,4,3,2,5573,5607,13
Task 5574,Job 0,5,4,1,8,1,6,13,7,1,4,1,5574,5608,3
Task 5574,Job 1,10,4,3,8,0,13,18,5,3,4,1,5574,5608,13
Task 5575,Job 0,10,8,2,6,0,12,16,4,2,1,1,5575,5608,8
Task 5575,Job 1,15,4,3,12,1,18,27,9,3,2,1,5575,5608,17
Task 5576,Job 0,2,8,2,11,1,4,13,9,2,4,1,5576,5610,6
Task 5576,Job 1,7,6,3,9,0,10,16,6,3,4,1,5576,5610,5
Task 5577,Job 0,9,4,3,12,0,12,21,9,3,3,1,5577,5610,13
Task 5577,Job 1,14,4,4,10,0,18,24,6,4,3,1,5577,5610,14
Task 5578,Job 0,7,4,3,8,0,10,15,5,3,4,0,5578,5612,13
Task 5578,Job 1,12,10,2,6,1,14,18,4,2,4,1,5578,5612,5
Task 5579,Job 0,8,4,4,12,0,12,20,8,4,2,0,5579,5612,5
Task 5579,Job 1,13,10,4,6,0,17,19,2,4,2,0,5579,5612,11
Task 5580,Job 0,6,10,1,6,0,7,12,5,1,3,0,5580,5614,13
Task 5580,Job 1,11,4,3,8,0,14,19,5,3,4,0,5580,5614,9
Task 5581,Job 0,2,8,1,11,0,3,13,10,1,4,1,5581,5615,17
Task 5581,Job 1,7,9,2,9,0,9,16,7,2,4,0,5581,5615,16
Task 5582,Job 0,5,9,3,8,0,8,13,5,3,2,0,5582,5616,9
Task 5582,Job 1,10,6,2,7,0,12,17,5,2,1,1,5582,5616,15
Task 5583,Job 0,9,10,4,10,0,13,19,6,4,1,0,5583,5616,16
Task 5583,Job 1,14,5,1,11,0,15,25,10,1,3,1,5583,5616,16
Task 5584,Job 0,9,7,2,10,0,11,19,8,2,1,2,5584,5617,14
Task 5584,Job 1,14,8,1,7,0,15,21,6,1,2,0,5584,5617,10
Task 5585,Job 0,1,7,1,12,0,2,13,11,1,3,1,5585,5619,2
Task 5585,Job 1,6,7,1,6,0,7,12,5,1,1,0,5585,5619,8
Task 5586,Job 0,2,9,2,11,0,4,13,9,2,4,2,5586,5620,14
Task 5586,Job 1,7,8,4,12,0,11,19,8,4,2,0,5586,5620,4
Task 5587,Job 0,10,10,4,12,0,14,22,8,4,3,2,5587,5621,8
Task 5587,Job 1,15,9,3,8,0,18,23,5,3,4,2,5587,5621,9
Task 5588,Job 0,8,7,1,6,0,9,14,5,1,2,2,5588,5622,11
Task 5588,Job 1,13,4,4,9,0,17,22,5,4,1,2,5588,5622,6
Task 5589,Job 0,7,7,2,10,1,9,17,8,2,2,1,5589,5622,10
Task 5589,Job 1,12,8,3,11,0,15,23,8,3,3,2,5589,5622,8
Task 5590,Job 0,9,9,2,7,0,11,16,5,2,2,1,5590,5624,2
Task 5590,Job 1,14,8,3,9,0,17,23,6,3,1,0,5590,5624,6
Task 5591,Job 0,6,8,2,6,0,8,12,4,2,3,2,5591,5625,3
Task 5591,Job 1,11,10,3,10,0,14,21,7,3,4,2,5591,5625,8
Task 5592,Job 0,7,10,1,10,0,8,17,9,1,3,0,5592,5625,3
Task 5592,Job 1,12,9,1,7,0,13,19,6,1,3,1,5592,5625,11
Task 5593,Job 0,2,5,1,7,0,3,9,6,1,1,0,5593,5627,9
Task 5593,Job 1,7,6,1,12,0,8,19,11,1,2,1,5593,5627,20
Task 5594,Job 0,5,9,4,8,1,9,13,4,4,3,1,5594,5627,18
Task 5594,Job 1,10,5,4,9,0,14,19,5,4,2,1,5594,5627,2
Task 5595,Job 0,10,5,3,7,0,13,17,4,3,4,0,5595,5628,10
Task 5595,Job 1,15,7,3,10,0,18,25,7,3,4,2,5595,5628,13
Task 5596,Job 0,10,10,2,8,0,12,18,6,2,1,1,5596,5629,9
Task 5596,Job 1,15,10,1,12,0,16,27,11,1,3,0,5596,5629,8
Task 5597,Job 0,8,6,3,10,0,11,18,7,3,3,2,5597,5630,9
Task 5597,Job 1,13,8,4,7,0,17,20,3,4,4,2,5597,5630,16
Task 5598,Job 0,5,7,4,10,0,9,15,6,4,4,0,5598,5632,11
Task 5598,Job 1,10,7,3,12,1,13,22,9,3,2,2,5598,5632,4
Task 5599,Job 0,3,4,3,11,1,6,14,8,3,2,2,5599,5632,7
Task 5599,Job 1,8,7,2,11,0,10,19,9,2,2,1,5599,5632,18
Task 5600,Job 0,8,8,2,7,0,10,15,5,2,4,2,5600,5633,3
Task 5600,Job 1,13,8,1,7,0,14,20,6,1,2,1,5600,5633,15
Task 5601,Job 0,2,8,4,9,0,6,11,5,4,4,2,5601,5634,15
Task 5601,Job 1,7,10,1,9,0,8,16,8,1,2,1,5601,5634,19
Task 5602,Job 0,4,5,3,7,0,7,11,4,3,4,1,5602,5636,14
Task 5602,Job 1,9,10,3,8,0,12,17,5,3,1,0,5602,5636,16
Task 5603,Job 0,5,7,3,12,0,8,17,9,3,2,1,5603,5636,18
Task 5603,Job 1,10,6,2,9,1,12,19,7,2,1,1,5603,5636,3
Task 5604,Job 0,2,6,3,9,1,5,11,6,3,1,2,5604,5637,15
Task 5604,Job 1,7,8,4,8,0,11,15,4,4,2,2,5604,5637,17
Task 5605,Job 0,10,8,4,12,1,14,22,8,4,4,0,5605,5639,13
Task 5605,Job 1,15,8,2,8,0,17,23,6,2,1,2,5605,5639,20
Task 5606,Job 0,1,7,2,12,0,3,13,10,2,2,0,5606,5640,8
Task 5606,Job 1,6,9,4,9,1,10,15,5,4,1,0,5606,5640,16
Task 5607,Job 0,10,8,3,9,0,13,19,6,3,2,1,5607,5640,13
Task 5607,Job 1,15,4,3,8,0,18,23,5,3,4,0,5607,5640,8
Task 5608,Job 0,5,5,3,6,0,8,11,3,3,2,1,5608,5642,15
Task 5608,Job 1,10,7,3,12,0,13,22,9,3,1,2,5608,5642,17
Task 5609,Job 0,3,8,3,11,0,6,14,8,3,2,1,5609,5642,4
Task 5609,Job 1,8,9,4,12,0,12,20,8,4,4,1,5609,5642,3
Task 5610,Job 0,3,4,3,11,0,6,14,8,3,1,0,5610,5644,2
Task 5610,Job 1,8,4,4,9,0,12,17,5,4,1,2,5610,5644,14
Task 5611,Job 0,7,6,3,12,1,10,19,9,3,1,1,5611,5644,17
Task 5611,Job 1,12,8,1,10,1,13,22,9,1,1,2,5611,5644,10
Task 5612,Job 0,1,7,4,10,0,5,11,6,4,2,1,5612,5646,13
Task 5612,Job 1,6,5,4,9,1,10,15,5,4,4,2,5612,5646,20
Task 5613,Job 0,3,6,4,9,0,7,12,5,4,3,0,5613,5646,14
Task 5613,Job 1,8,10,4,12,0,12,20,8,4,4,1,5613,5646,18
Task 5614,Job 0,2,6,2,7,0,4,9,5,2,4,0,5614,5647,8
Task 5614,Job 1,7,8,3,12,0,10,19,9,3,3,0,5614,5647,18
Task 5615,Job 0,4,10,4,9,1,8,13,5,4,4,2,5615,5649,11
Task 5615,Job 1,9,10,4,11,1,13,20,7,4,3,1,5615,5649,11
Task 5616,Job 0,2,5,3,7,0,5,9,4,3,3,1,5616,5649,12
Task 5616,Job 1,7,5,4,8,0,11,15,4,4,1,2,5616,5649,3
Task 5617,Job 0,6,8,4,10,1,10,16,6,4,3,0,5617,5650,8
Task 5617,Job 1,11,10,4,9,0,15,20,5,4,2,1,5617,5650,5
Task 5618,Job 0,10,4,1,11,0,11,21,10,1,4,1,5618,5651,3
Task 5618,Job 1,15,10,4,10,0,19,25,6,4,3,1,5618,5651,11
Task 5619,Job 0,1,8,4,9,1,5,10,5,4,3,1,5619,5652,10
Task 5619,Job 1,6,10,2,11,0,8,17,9,2,2,0,5619,5652,6
Task 5620,Job 0,9,9,4,6,0,13,15,2,4,1,0,5620,5653,20
Task 5620,Job 1,14,4,2,8,1,16,22,6,2,2,1,5620,5653,8
Task 5621,Job 0,8,9,3,8,1,11,16,5,3,3,2,5621,5655,4
Task 5621,Job 1,13,6,1,6,0,14,19,5,1,4,0,5621,5655,14
Task 5622,Job 0,4,5,2,12,1,6,16,10,2,1,2,5622,5655,10
Task 5622,Job 1,9,10,1,7,1,10,16,6,1,2,1,5622,5655,15
Task 5623,Job 0,2,4,4,8,0,6,10,4,4,3,1,5623,5656,15
Task 5623,Job 1,7,6,1,12,0,8,19,11,1,1,0,5623,5656,20
Task 5624,Job 0,3,4,4,12,1,7,15,8,4,2,1,5624,5658,13
Task 5624,Job 1,8,4,3,10,0,11,18,7,3,3,1,5624,5658,20
Task 5625,Job 0,8,10,3,7,0,11,15,4,3,4,1,5625,5658,17
Task 5625,Job 1,13,10,3,12,0,16,25,9,3,1,1,5625,5658,9
Task 5626,Job 0,9,7,3,9,0,12,18,6,3,1,2,5626,5659,5
Task 5626,Job 1,14,4,3,8,0,17,22,5,3,4,1,5626,5659,13
Task 5627,Job 0,7,5,3,12,0,10,19,9,3,2,0,5627,5661,19
Task 5627,Job 1,12,8,1,10,0,13,22,9,1,3,2,5627,5661,9
Task 5628,Job 0,2,6,1,9,0,3,11,8,1,2,0,5628,5661,7
Task 5628,Job 1,7,4,1,11,0,8,18,10,1,3,2,5628,5661,7
Task 5629,Job 0,7,8,2,6,0,9,13,4,2,4,0,5629,5663,10
Task 5629,Job 1,12,4,3,10,0,15,22,7,3,4,1,5629,5663,6
Task 5630,Job 0,6,7,2,8,1,8,14,6,2,4,1,5630,5664,9
Task 5630,Job 1,11,10,3,7,0,14,18,4,3,3,2,5630,5664,4
Task 5631,Job 0,3,10,2,8,0,5,11,6,2,4,0,5631,5665,6
Task 5631,Job 1,8,5,1,12,0,9,20,11,1,2,0,5631,5665,12
Task 5632,Job 0,8,6,4,12,0,12,20,8,4,3,0,5632,5666,10
Task 5632,Job 1,13,8,3,6,1,16,19,3,3,2,1,5632,5666,8
Task 5633,Job 0,3,10,3,12,0,6,15,9,3,1,1,5633,5667,3
Task 5633,Job 1,8,9,2,10,0,10,18,8,2,4,2,5633,5667,4
Task 5634,Job 0,2,9,1,7,0,3,9,6,1,1,1,5634,5668,20
Task 5634,Job 1,7,10,2,7,0,9,14,5,2,2,1,5634,5668,12
Task 5635,Job 0,3,9,3,12,0,6,15,9,3,4,0,5635,5669,9
Task 5635,Job 1,8,10,2,10,0,10,18,8,2,1,2,5635,5669,13
Task 5636,Job 0,2,8,3,10,0,5,12,7,3,2,0,5636,5669,6
Task 5636,Job 1,7,8,1,8,0,8,15,7,1,2,0,5636,5669,2
Task 5637,Job 0,4,5,4,12,0,8,16,8,4,4,1,5637,5671,11
Task 5637,Job 1,9,10,1,9,0,10,18,8,1,2,1,5637,5671,6
Task 5638,Job 0,4,5,2,10,1,6,14,8,2,1,1,5638,5672,15
Task 5638,Job 1,9,4,1,10,0,10,19,9,1,1,2,5638,5672,15
Task 5639,Job 0,7,8,2,6,1,9,13,4,2,1,2,5639,5672,8
Task 5639,Job 1,12,10,3,10,0,15,22,7,3,2,0,5639,5672,13
Task 5640,Job 0,2,9,1,10,0,3,12,9,1,3,2,5640,5673,9
Task 5640,Job 1,7,4,2,9,0,9,16,7,2,1,2,5640,5673,13
Task 5641,Job 0,9,10,1,12,0,10,21,11,1,1,1,5641,5674,12
Task 5641,Job 1,14,8,3,9,0,17,23,6,3,4,2,5641,5674,5
Task 5642,Job 0,3,7,2,11,1,5,14,9,2,3,2,5642,5675,19
Task 5642,Job 1,8,10,3,10,0,11,18,7,3,2,2,5642,5675,12
Task 5643,Job 0,7,5,2,8,1,9,15,6,2,4,0,5643,5677,8
Task 5643,Job 1,12,8,2,7,1,14,19,5,2,4,2,5643,5677,12
Task 5644,Job 0,7,6,3,9,1,10,16,6,3,2,2,5644,5678,9
Task 5644,Job 1,12,8,2,8,0,14,20,6,2,1,2,5644,5678,16
Task 5645,Job 0,10,10,1,7,0,11,17,6,1,4,2,5645,5679,19
Task 5645,Job 1,15,7,4,6,0,19,21,2,4,2,2,5645,5679,5
Task 5646,Job 0,6,9,3,12,0,9,18,9,3,4,1,5646,5679,6
Task 5646,Job 1,11,10,2,8,0,13,19,6,2,3,2,5646,5679,11
Task 5647,Job 0,4,8,1,7,0,5,11,6,1,1,1,5647,5680,15
Task 5647,Job 1,9,4,4,12,1,13,21,8,4,1,0,5647,5680,10
Task 5648,Job 0,5,8,4,10,1,9,15,6,4,1,0,5648,5681,7
Task 5648,Job 1,10,10,3,7,0,13,17,4,3,3,2,5648,5681,15
Task 5649,Job 0,5,5,4,9,0,9,14,5,4,2,0,5649,5683,14
Task 5649,Job 1,10,6,3,12,0,13,22,9,3,4,2,5649,5683,11
Task 5650,Job 0,1,7,3,12,0,4,13,9,3,2,0,5650,5684,11
Task 5650,Job 1,6,10,4,12,0,10,18,8,4,1,2,5650,5684,18
Task 5651,Job 0,8,6,3,9,0,11,17,6,3,1,0,5651,5685,17
Task 5651,Job 1,13,4,3,12,0,16,25,9,3,1,1,5651,5685,5
Task 5652,Job 0,9,6,2,6,0,11,15,4,2,3,2,5652,5685,7
Task 5652,Job 1,14,5,2,11,0,16,25,9,2,2,0,5652,5685,12
Task 5653,Job 0,10,8,1,10,0,11,20,9,1,1,1,5653,5686,19
Task 5653,Job 1,15,7,2,7,0,17,22,5,2,2,0,5653,5686,2
Task 5654,Job 0,6,9,4,11,1,10,17,7,4,4,1,5654,5688,2
Task 5654,Job 1,11,6,3,9,0,14,20,6,3,4,1,5654,5688,10
Task 5655,Job 0,5,5,4,7,0,9,12,3,4,1,0,5655,5688,3
Task 5655,Job 1,10,9,2,8,0,12,18,6,2,3,2,5655,5688,3
Task 5656,Job 0,1,10,3,8,0,4,9,5,3,4,2,5656,5689,11
Task 5656,Job 1,6,5,1,8,1,7,14,7,1,4,2,5656,5689,8
Task 5657,Job 0,6,6,4,10,0,10,16,6,4,3,1,5657,5690,6
Task 5657,Job 1,11,9,1,8,0,12,19,7,1,3,1,5657,5690,19
Task 5658,Job 0,8,9,4,12,0,12,20,8,4,2,1,5658,5691,18
Task 5658,Job 1,13,4,1,8,0,14,21,7,1,3,0,5658,5691,9
Task 5659,Job 0,6,7,2,10,1,8,16,8,2,2,1,5659,5693,7
Task 5659,Job 1,11,7,1,6,0,12,17,5,1,4,0,5659,5693,8
Task 5660,Job 0,3,9,3,6,0,6,9,3,3,2,0,5660,5694,17
Task 5660,Job 1,8,5,2,11,0,10,19,9,2,4,2,5660,5694,15
Task 5661,Job 0,10,4,3,12,0,13,22,9,3,3,0,5661,5695,18
Task 5661,Job 1,15,10,4,6,1,19,21,2,4,1,1,5661,5695,14
Task 5662,Job 0,3,7,4,6,0,7,9,2,4,4,2,5662,5695,6
Task 5662,Job 1,8,8,1,12,1,9,20,11,1,2,1,5662,5695,18
Task 5663,Job 0,4,10,2,12,1,6,16,10,2,3,2,5663,5697,7
Task 5663,Job 1,9,7,4,7,1,13,16,3,4,1,1,5663,5697,15
Task 5664,Job 0,9,5,4,7,1,13,16,3,4,1,0,5664,5697,9
Task 5664,Job 1,14,9,4,11,1,18,25,7,4,2,0,5664,5697,11
Task 5665,Job 0,1,5,2,10,1,3,11,8,2,2,0,5665,5699,13
Task 5665,Job 1,6,9,1,11,0,7,17,10,1,4,1,5665,5699,3
Task 5666,Job 0,6,10,1,11,0,7,17,10,1,1,0,5666,5700,7
Task 5666,Job 1,11,9,4,10,0,15,21,6,4,3,0,5666,5700,7
Task 5667,Job 0,7,6,4,8,1,11,15,4,4,4,2,5667,5700,3
Task 5667,Job 1,12,10,1,10,0,13,22,9,1,3,1,5667,5700,19
Task 5668,Job 0,6,8,3,7,0,9,13,4,3,3,0,5668,5702,8
Task 5668,Job 1,11,4,2,9,0,13,20,7,2,2,0,5668,5702,2
Task 5669,Job 0,8,8,4,7,0,12,15,3,4,4,1,5669,5702,9
Task 5669,Job 1,13,10,4,8,0,17,21,4,4,2,1,5669,5702,14
Task 5670,Job 0,5,10,3,6,0,8,11,3,3,3,0,5670,5703,8
Task 5670,Job 1,10,5,1,9,0,11,19,8,1,1,1,5670,5703,7
Task 5671,Job 0,10,6,1,11,0,11,21,10,1,1,2,5671,5705,2
Task 5671,Job 1,15,10,2,11,0,17,26,9,2,2,2,5671,5705,7
Task 5672,Job 0,4,7,4,6,0,8,10,2,4,2,0,5672,5706,6
Task 5672,Job 1,9,4,4,10,0,13,19,6,4,3,2,5672,5706,11
Task 5673,Job 0,9,9,2,6,0,11,15,4,2,4,0,5673,5707,18
Task 5673,Job 1,14,9,2,10,0,16,24,8,2,2,2,5673,5707,11
Task 5674,Job 0,1,4,4,11,0,5,12,7,4,4,2,5674,5708,10
Task 5674,Job 1,6,8,2,10,0,8,16,8,2,3,0,5674,5708,9
Task 5675,Job 0,10,8,1,6,0,11,16,5,1,1,2,5675,5708,16
Task 5675,Job 1,15,5,2,8,0,17,23,6,2,4,1,5675,5708,20
Task 5676,Job 0,10,4,2,7,0,12,17,5,2,4,2,5676,5709,19
Task 5676,Job 1,15,5,3,6,0,18,21,3,3,2,0,5676,5709,19
Task 5677,Job 0,7,5,4,9,0,11,16,5,4,3,1,5677,5710,19
Task 5677,Job 1,12,4,1,8,0,13,20,7,1,2,2,5677,5710,20
Task 5678,Job 0,4,5,1,12,0,5,16,11,1,4,2,5678,5712,18
Task 5678,Job 1,9,10,3,6,1,12,15,3,3,4,2,5678,5712,11
Task 5679,Job 0,10,10,4,8,0,14,18,4,4,1,1,5679,5713,16
Task 5679,Job 1,15,7,4,10,0,19,25,6,4,2,1,5679,5713,13
Task 5680,Job 0,6,7,3,11,1,9,17,8,3,4,1,5680,5713,4
Task 5680,Job 1,11,10,3,10,0,14,21,7,3,4,0,5680,5713,3
Task 5681,Job 0,7,5,3,10,0,10,17,7,3,4,2,5681,5715,20
Task 5681,Job 1,12,9,1,9,0,13,21,8,1,3,0,5681,5715,4
Task 5682,Job 0,6,9,1,6,1,7,12,5,1,4,1,5682,5716,8
Task 5682,Job 1,11,9,4,11,1,15,22,7,4,2,2,5682,5716,15
Task 5683,Job 0,6,4,1,12,0,7,18,11,1,2,2,5683,5716,19
Task 5683,Job 1,11,10,2,10,1,13,21,8,2,3,0,5683,5716,17
Task 5684,Job 0,2,10,3,7,0,5,9,4,3,1,2,5684,5717,12
Task 5684,Job 1,7,5,1,12,0,8,19,11,1,1,2,5684,5717,19
Task 5685,Job 0,10,7,2,10,1,12,20,8,2,3,0,5685,5718,5
Task 5685,Job 1,15,4,4,12,1,19,27,8,4,1,0,5685,5718,9
Task 5686,Job 0,8,6,4,10,0,12,18,6,4,2,0,5686,5720,16
Task 5686,Job 1,13,9,4,8,0,17,21,4,4,1,1,5686,5720,16
Task 5687,Job 0,2,4,1,12,0,3,14,11,1,1,1,5687,5721,2
Task 5687,Job 1,7,9,4,7,1,11,14,3,4,4,2,5687,5721,16
Task 5688,Job 0,9,8,1,10,0,10,19,9,1,4,2,5688,5722,9
Task 5688,Job 1,14,10,4,7,0,18,21,3,4,1,1,5688,5722,17
Task 5689,Job 0,10,8,4,10,0,14,20,6,4,1,0,5689,5723,17
Task 5689,Job 1,15,7,3,12,0,18,27,9,3,4,1,5689,5723,12
Task 5690,Job 0,3,10,3,8,1,6,11,5,3,3,0,5690,5724,6
Task 5690,Job 1,8,5,4,8,0,12,16,4,4,2,1,5690,5724,10
Task 5691,Job 0,9,5,3,12,0,12,21,9,3,1,0,5691,5725,7
Task 5691,Job 1,14,6,2,8,0,16,22,6,2,1,0,5691,5725,16
Task 5692,Job 0,4,6,3,9,0,7,13,6,3,2,0,5692,5726,10
Task 5692,Job 1,9,9,2,12,1,11,21,10,2,2,2,5692,5726,2
Task 5693,Job 0,2,10,3,10,0,5,12,7,3,3,0,5693,5727,20
Task 5693,Job 1,7,6,4,12,0,11,19,8,4,3,0,5693,5727,7
Task 5694,Job 0,6,6,2,11,0,8,17,9,2,1,1,5694,5727,3
Task 5694,Job 1,11,9,1,7,0,12,18,6,1,3,2,5694,5727,4
Task 5695,Job 0,8,6,4,9,0,12,17,5,4,4,0,5695,5729,5
Task 5695,Job 1,13,6,4,12,0,17,25,8,4,4,1,5695,5729,3
Task 5696,Job 0,1,6,3,8,0,4,9,5,3,4,1,5696,5730,3
Task 5696,Job 1,6,4,2,8,1,8,14,6,2,1,1,5696,5730,7
Task 5697,Job 0,6,7,1,12,0,7,18,11,1,1,2,5697,5731,2
Task 5697,Job 1,11,10,1,11,1,12,22,10,1,3,1,5697,5731,18
Task 5698,Job 0,8,4,1,11,0,9,19,10,1,4,0,5698,5731,11
Task 5698,Job 1,13,6,3,8,0,16,21,5,3,4,2,5698,5731,20
Task 5699,Job 0,2,4,4,11,0,6,13,7,4,3,2,5699,5733,17
Task 5699,Job 1,7,9,2,12,0,9,19,10,2,3,2,5699,5733,18
Task 5700,Job 0,3,10,1,7,0,4,10,6,1,3,2,5700,5734,8
Task 5700,Job 1,8,6,2,7,1,10,15,5,2,1,1,5700,5734,3
Task 5701,Job 0,7,6,1,10,0,8,17,9,1,2,1,5701,5734,19
Task 5701,Job 1,12,7,1,8,0,13,20,7,1,1,1,5701,5734,20
Task 5702,Job 0,8,5,2,9,0,10,17,7,2,3,0,5702,5736,15
Task 5702,Job 1,13,8,2,8,0,15,21,6,2,2,2,5702,5736,17
Task 5703,Job 0,10,7,4,11,1,14,21,7,4,2,0,5703,5737,20
Task 5703,Job 1,15,5,4,7,0,19,22,3,4,2,1,5703,5737,12
Task 5704,Job 0,7,8,1,11,0,8,18,10,1,3,2,5704,5738,19
Task 5704,Job 1,12,9,2,9,0,14,21,7,2,4,2,5704,5738,5
Task 5705,Job 0,9,7,4,11,0,13,20,7,4,2,2,5705,5738,8
Task 5705,Job 1,14,9,4,11,0,18,25,7,4,1,1,5705,5738,6
Task 5706,Job 0,7,10,4,12,0,11,19,8,4,3,2,5706,5739,4
Task 5706,Job 1,12,6,3,7,0,15,19,4,3,3,0,5706,5739,3
Task 5707,Job 0,9,7,2,11,0,11,20,9,2,4,2,5707,5741,9
Task 5707,Job 1,14,5,1,7,1,15,21,6,1,4,0,5707,5741,3
Task 5708,Job 0,7,7,4,9,0,11,16,5,4,4,1,5708,5741,7
Task 5708,Job 1,12,8,2,7,0,14,19,5,2,3,0,5708,5741,5
Task 5709,Job 0,1,6,4,10,0,5,11,6,4,2,1,5709,5743,11
Task 5709,Job 1,6,10,4,7,0,10,13,3,4,3,1,5709,5743,6
Task 5710,Job 0,4,7,4,6,1,8,10,2,4,2,1,5710,5744,17
Task 5710,Job 1,9,7,3,8,1,12,17,5,3,1,1,5710,5744,13
Task 5711,Job 0,3,4,3,10,0,6,13,7,3,1,2,5711,5745,13
Task 5711,Job 1,8,5,2,11,0,10,19,9,2,3,1,5711,5745,2
Task 5712,Job 0,7,4,4,9,0,11,16,5,4,3,0,5712,5745,3
Task 5712,Job 1,12,5,1,12,1,13,24,11,1,2,1,5712,5745,2
Task 5713,Job 0,4,9,1,11,0,5,15,10,1,4,2,5713,5747,12
Task 5713,Job 1,9,10,2,7,1,11,16,5,2,4,2,5713,5747,3
Task 5714,Job 0,2,5,1,9,0,3,11,8,1,4,0,5714,5747,16
Task 5714,Job 1,7,7,3,6,1,10,13,3,3,2,1,5714,5747,7
Task 5715,Job 0,9,4,4,8,0,13,17,4,4,3,2,5715,5749,16
Task 5715,Job 1,14,10,2,6,0,16,20,4,2,4,1,5715,5749,2
Task 5716,Job 0,8,8,1,6,0,9,14,5,1,1,1,5716,5749,6
Task 5716,Job 1,13,4,1,7,0,14,20,6,1,1,2,5716,5749,15
Task 5717,Job 0,8,10,2,11,1,10,19,9,2,4,2,5717,5751,5
Task 5717,Job 1,13,10,3,11,0,16,24,8,3,3,1,5717,5751,18
Task 5718,Job 0,8,4,4,9,0,12,17,5,4,4,2,5718,5752,10
Task 5718,Job 1,13,4,1,12,0,14,25,11,1,1,2,5718,5752,7
Task 5719,Job 0,6,4,4,8,0,10,14,4,4,1,0,5719,5753,15
Task 5719,Job 1,11,9,4,8,0,15,19,4,4,4,2,5719,5753,2
Task 5720,Job 0,9,4,3,11,0,12,20,8,3,4,2,5720,5754,7
Task 5720,Job 1,14,10,4,9,0,18,23,5,4,1,0,5720,5754,11
Task 5721,Job 0,5,7,2,7,1,7,12,5,2,1,1,5721,5754,17
Task 5721,Job 1,10,7,1,12,1,11,22,11,1,4,0,5721,5754,5
Task 5722,Job 0,9,6,4,8,1,13,17,4,4,3,0,5722,5755,3
Task 5722,Job 1,14,7,3,11,0,17,25,8,3,4,0,5722,5755,15
Task 5723,Job 0,5,6,3,8,0,8,13,5,3,2,1,5723,5757,18
Task 5723,Job 1,10,8,4,12,0,14,22,8,4,2,1,5723,5757,9
Task 5724,Job 0,9,6,2,11,1,11,20,9,2,1,2,5724,5758,8
Task 5724,Job 1,14,9,1,7,0,15,21,6,1,3,0,5724,5758,14
Task 5725,Job 0,9,6,4,12,0,13,21,8,4,4,2,5725,5758,19
Task 5725,Job 1,14,9,4,8,0,18,22,4,4,4,0,5725,5758,18
Task 5726,Job 0,6,6,4,11,0,10,17,7,4,2,2,5726,5759,15
Task 5726,Job 1,11,6,2,8,0,13,19,6,2,2,1,5726,5759,2
Task 5727,Job 0,2,7,2,6,0,4,8,4,2,3,0,5727,5761,16
Task 5727,Job 1,7,5,3,6,0,10,13,3,3,4,1,5727,5761,3
Task 5728,Job 0,4,4,4,7,1,8,11,3,4,2,0,5728,5761,13
Task 5728,Job 1,9,10,2,10,0,11,19,8,2,2,2,5728,5761,6
Task 5729,Job 0,10,5,2,7,0,12,17,5,2,3,1,5729,5762,19
Task 5729,Job 1,15,5,3,8,0,18,23,5,3,2,0,5729,5762,12
Task 5730,Job 0,5,8,4,9,0,9,14,5,4,4,1,5730,5764,20
Task 5730,Job 1,10,10,3,9,0,13,19,6,3,1,2,5730,5764,15
Task 5731,Job 0,9,10,2,8,0,11,17,6,2,1,1,5731,5765,15
Task 5731,Job 1,14,7,4,8,1,18,22,4,4,1,0,5731,5765,11
Task 5732,Job 0,3,4,1,9,0,4,12,8,1,1,1,5732,5766,9
Task 5732,Job 1,8,9,4,8,0,12,16,4,4,1,0,5732,5766,6
Task 5733,Job 0,10,9,4,6,0,14,16,2,4,2,0,5733,5767,10
Task 5733,Job 1,15,9,4,7,0,19,22,3,4,3,0,5733,5767,15
Task 5734,Job 0,5,5,2,12,0,7,17,10,2,2,2,5734,5767,10
Task 5734,Job 1,10,9,3,8,0,13,18,5,3,4,2,5734,5767,2
Task 5735,Job 0,8,9,4,9,0,12,17,5,4,2,2,5735,5768,4
Task 5735,Job 1,13,5,1,12,1,14,25,11,1,3,1,5735,5768,18
Task 5736,Job 0,10,4,3,10,1,13,20,7,3,2,0,5736,5770,11
Task 5736,Job 1,15,4,2,10,0,17,25,8,2,1,0,5736,5770,3
Task 5737,Job 0,9,5,2,9,0,11,18,7,2,1,2,5737,5770,11
Task 5737,Job 1,14,9,3,10,0,17,24,7,3,3,2,5737,5770,12
Task 5738,Job 0,7,9,4,8,0,11,15,4,4,2,0,5738,5771,10
Task 5738,Job 1,12,4,1,8,0,13,20,7,1,3,2,5738,5771,10
Task 5739,Job 0,1,4,2,11,0,3,12,9,2,3,1,5739,5772,14
Task 5739,Job 1,6,9,2,6,0,8,12,4,2,3,0,5739,5772,13
Task 5740,Job 0,6,6,4,12,0,10,18,8,4,4,2,5740,5773,11
Task 5740,Job 1,11,6,3,8,0,14,19,5,3,3,1,5740,5773,4
Task 5741,Job 0,3,7,4,12,0,7,15,8,4,2,2,5741,5774,17
Task 5741,Job 1,8,8,3,9,0,11,17,6,3,3,2,5741,5774,5
Task 5742,Job 0,9,7,4,10,0,13,19,6,4,1,0,5742,5776,12
Task 5742,Job 1,14,9,4,12,0,18,26,8,4,1,2,5742,5776,17
Task 5743,Job 0,7,9,1,9,0,8,16,8,1,3,2,5743,5776,3
Task 5743,Job 1,12,10,3,8,0,15,20,5,3,2,2,5743,5776,6
Task 5744,Job 0,7,5,1,8,1,8,15,7,1,1,0,5744,5778,4
Task 5744,Job 1,12,7,1,12,0,13,24,11,1,4,2,5744,5778,16
Task 5745,Job 0,8,8,4,9,0,12,17,5,4,3,1,5745,5779,8
Task 5745,Job 1,13,5,2,7,0,15,20,5,2,3,2,5745,5779,13
Task 5746,Job 0,1,4,1,7,1,2,8,6,1,2,2,5746,5780,15
Task 5746,Job 1,6,6,2,7,0,8,13,5,2,3,0,5746,5780,10
Task 5747,Job 0,8,9,1,6,0,9,14,5,1,3,1,5747,5781,14
Task 5747,Job 1,13,7,2,6,0,15,19,4,2,4,2,5747,5781,20
Task 5748,Job 0,1,8,1,8,0,2,9,7,1,2,2,5748,5781,8
Task 5748,Job 1,6,6,3,11,0,9,17,8,3,4,0,5748,5781,4
Task 5749,Job 0,10,10,1,8,0,11,18,7,1,3,2,5749,5783,7
Task 5749,Job 1,15,7,4,8,1,19,23,4,4,1,0,5749,5783,19
Task 5750,Job 0,10,6,4,11,1,14,21,7,4,3,1,5750,5784,10
Task 5750,Job 1,15,10,2,8,0,17,23,6,2,3,0,5750,5784,5
Task 5751,Job 0,8,4,1,12,0,9,20,11,1,4,0,5751,5785,4
Task 5751,Job 1,13,8,1,9,1,14,22,8,1,2,0,5751,5785,17
Task 5752,Job 0,1,4,1,9,0,2,10,8,1,2,0,5752,5785,20
Task 5752,Job 1,6,6,2,10,1,8,16,8,2,4,2,5752,5785,17
Task 5753,Job 0,5,5,3,8,0,8,13,5,3,4,2,5753,5787,13
Task 5753,Job 1,10,8,3,12,0,13,22,9,3,1,1,5753,5787,16
Task 5754,Job 0,9,6,1,12,1,10,21,11,1,2,1,5754,5788,16
Task 5754,Job 1,14,4,1,8,0,15,22,7,1,3,2,5754,5788,14
Task 5755,Job 0,1,7,4,7,0,5,8,3,4,1,1,5755,5789,3
Task 5755,Job 1,6,4,4,8,0,10,14,4,4,3,2,5755,5789,19
Task 5756,Job 0,6,4,3,8,0,9,14,5,3,3,0,5756,5789,12
Task 5756,Job 1,11,9,3,7,0,14,18,4,3,1,2,5756,5789,9
Task 5757,Job 0,2,7,3,11,0,5,13,8,3,3,1,5757,5790,20
Task 5757,Job 1,7,8,3,8,1,10,15,5,3,3,2,5757,5790,11
Task 5758,Job 0,2,4,4,11,0,6,13,7,4,2,1,5758,5792,16
Task 5758,Job 1,7,7,4,8,0,11,15,4,4,2,2,5758,5792,13
Task 5759,Job 0,4,10,1,9,0,5,13,8,1,2,2,5759,5793,7
Task 5759,Job 1,9,6,3,7,0,12,16,4,3,3,2,5759,5793,20
Task 5760,Job 0,10,10,2,9,0,12,19,7,2,1,1,5760,5794,20
Task 5760,Job 1,15,7,1,10,0,16,25,9,1,1,2,5760,5794,11
Task 5761,Job 0,3,8,3,6,1,6,9,3,3,3,1,5761,5794,16
Task 5761,Job 1,8,7,2,12,0,10,20,10,2,2,0,5761,5794,10
Task 5762,Job 0,8,10,1,11,1,9,19,10,1,1,1,5762,5795,20
Task 5762,Job 1,13,4,3,10,0,16,23,7,3,4,0,5762,5795,10
Task 5763,Job 0,6,10,1,11,0,7,17,10,1,4,1,5763,5796,17
Task 5763,Job 1,11,10,2,10,0,13,21,8,2,4,0,5763,5796,11
Task 5764,Job 0,6,6,4,12,0,10,18,8,4,2,0,5764,5797,12
Task 5764,Job 1,11,6,3,7,1,14,18,4,3,3,2,5764,5797,16
Task 5765,Job 0,7,10,4,10,0,11,17,6,4,4,0,5765,5798,11
Task 5765,Job 1,12,10,2,12,0,14,24,10,2,1,0,5765,5798,14
Task 5766,Job 0,2,10,1,6,0,3,8,5,1,1,0,5766,5800,10
Task 5766,Job 1,7,5,3,12,0,10,19,9,3,2,0,5766,5800,20
Task 5767,Job 0,4,10,4,8,0,8,12,4,4,2,0,5767,5800,10
Task 5767,Job 1,9,9,3,6,0,12,15,3,3,4,2,5767,5800,8
Task 5768,Job 0,2,5,2,6,0,4,8,4,2,4,0,5768,5802,8
Task 5768,Job 1,7,10,1,7,1,8,14,6,1,3,1,5768,5802,5
Task 5769,Job 0,10,6,2,10,0,12,20,8,2,3,1,5769,5802,12
Task 5769,Job 1,15,9,4,12,0,19,27,8,4,4,0,5769,5802,10
Task 5770,Job 0,4,9,1,11,1,5,15,10,1,3,0,5770,5804,15
Task 5770,Job 1,9,8,4,12,0,13,21,8,4,1,1,5770,5804,7
Task 5771,Job 0,6,6,1,10,0,7,16,9,1,3,0,5771,5804,10
Task 5771,Job 1,11,4,1,7,0,12,18,6,1,2,0,5771,5804,16
Task 5772,Job 0,9,9,3,8,0,12,17,5,3,3,2,5772,5806,8
Task 5772,Job 1,14,9,2,9,0,16,23,7,2,2,1,5772,5806,3
Task 5773,Job 0,6,5,4,11,0,10,17,7,4,1,2,5773,5806,13
Task 5773,Job 1,11,6,1,9,0,12,20,8,1,1,1,5773,5806,8
Task 5774,Job 0,10,6,1,10,0,11,20,9,1,1,1,5774,5807,10
Task 5774,Job 1,15,10,1,6,0,16,21,5,1,3,1,5774,5807,4
Task 5775,Job 0,9,7,3,6,0,12,15,3,3,1,2,5775,5808,17
Task 5775,Job 1,14,4,1,11,0,15,25,10,1,2,2,5775,5808,5
Task 5776,Job 0,8,5,4,8,0,12,16,4,4,2,2,5776,5809,6
Task 5776,Job 1,13,10,4,9,0,17,22,5,4,2,2,5776,5809,3
Task 5777,Job 0,3,9,2,12,0,5,15,10,2,4,2,5777,5810,15
Task 5777,Job 1,8,5,2,11,0,10,19,9,2,4,1,5777,5810,17
Task 5778,Job 0,3,8,3,7,0,6,10,4,3,3,1,5778,5812,17
Task 5778,Job 1,8,8,1,7,0,9,15,6,1,4,1,5778,5812,15
Task 5779,Job 0,3,9,3,8,0,6,11,5,3,3,2,5779,5813,15
Task 5779,Job 1,8,5,2,9,0,10,17,7,2,4,2,5779,5813,5
Task 5780,Job 0,6,6,2,12,0,8,18,10,2,1,1,5780,5814,18
Task 5780,Job 1,11,9,3,12,1,14,23,9,3,3,1,5780,5814,16
Task 5781,Job 0,9,9,3,6,0,12,15,3,3,4,1,5781,5814,3
Task 5781,Job 1,14,9,3,9,0,17,23,6,3,3,0,5781,5814,10
Task 5782,Job 0,10,10,1,10,1,11,20,9,1,2,2,5782,5816,15
Task 5782,Job 1,15,6,3,6,0,18,21,3,3,1,2,5782,5816,8
Task 5783,Job 0,10,10,1,11,0,11,21,10,1,1,1,5783,5816,11
Task 5783,Job 1,15,9,2,8,0,17,23,6,2,1,0,5783,5816,5
Task 5784,Job 0,9,4,1,7,0,10,16,6,1,3,0,5784,5818,20
Task 5784,Job 1,14,7,3,11,1,17,25,8,3,2,2,5784,5818,5
Task 5785,Job 0,4,4,3,11,0,7,15,8,3,1,0,5785,5819,4
Task 5785,Job 1,9,4,3,11,0,12,20,8,3,4,1,5785,5819,13
Task 5786,Job 0,3,4,1,10,0,4,13,9,1,1,1,5786,5820,9
Task 5786,Job 1,8,4,4,9,0,12,17,5,4,1,1,5786,5820,14
Task 5787,Job 0,3,10,4,7,1,7,10,3,4,4,1,5787,5820,4
Task 5787,Job 1,8,5,2,8,0,10,16,6,2,4,2,5787,5820,14
Task 5788,Job 0,6,7,2,9,0,8,15,7,2,2,2,5788,5822,19
Task 5788,Job 1,11,6,2,8,1,13,19,6,2,3,2,5788,5822,8
Task 5789,Job 0,5,9,4,12,0,9,17,8,4,4,2,5789,5822,13
Task 5789,Job 1,10,9,4,8,0,14,18,4,4,3,0,5789,5822,13
Task 5790,Job 0,2,8,3,11,0,5,13,8,3,1,2,5790,5824,3
Task 5790,Job 1,7,5,1,10,0,8,17,9,1,4,1,5790,5824,10
Task 5791,Job 0,2,9,1,11,0,3,13,10,1,1,0,5791,5825,18
Task 5791,Job 1,7,6,3,12,0,10,19,9,3,1,1,5791,5825,18
Task 5792,Job 0,8,6,3,7,0,11,15,4,3,1,1,5792,5826,7
Task 5792,Job 1,13,4,3,11,1,16,24,8,3,2,2,5792,5826,10
Task 5793,Job 0,10,5,4,7,0,14,17,3,4,4,1,5793,5827,4
Task 5793,Job 1,15,5,4,8,0,19,23,4,4,4,2,5793,5827,5
Task 5794,Job 0,8,9,2,11,1,10,19,9,2,1,0,5794,5827,11
Task 5794,Job 1,13,9,1,8,0,14,21,7,1,2,0,5794,5827,17
Task 5795,Job 0,2,5,4,10,0,6,12,6,4,1,0,5795,5828,18
Task 5795,Job 1,7,7,2,6,0,9,13,4,2,3,1,5795,5828,20
Task 5796,Job 0,10,7,3,6,1,13,16,3,3,2,1,5796,5829,11
Task 5796,Job 1,15,9,3,10,1,18,25,7,3,3,0,5796,5829,10
Task 5797,Job 0,4,6,2,11,0,6,15,9,2,2,1,5797,5830,20
Task 5797,Job 1,9,10,4,11,0,13,20,7,4,3,0,5797,5830,3
Task 5798,Job 0,4,6,1,9,0,5,13,8,1,1,1,5798,5831,19
Task 5798,Job 1,9,4,1,8,0,10,17,7,1,1,2,5798,5831,12
Task 5799,Job 0,6,10,1,11,1,7,17,10,1,2,1,5799,5833,19
Task 5799,Job 1,11,4,2,6,0,13,17,4,2,2,0,5799,5833,20
Task 5800,Job 0,6,6,3,9,0,9,15,6,3,2,2,5800,5834,13
Task 5800,Job 1,11,5,3,7,0,14,18,4,3,4,0,5800,5834,17
Task 5801,Job 0,6,5,3,7,0,9,13,4,3,4,1,5801,5835,14
Task 5801,Job 1,11,8,3,9,1,14,20,6,3,1,0,5801,5835,2
Task 5802,Job 0,1,4,2,12,0,3,13,10,2,2,2,5802,5835,12
Task 5802,Job 1,6,6,4,12,1,10,18,8,4,3,1,5802,5835,2
Task 5803,Job 0,1,7,3,10,0,4,11,7,3,2,1,5803,5836,17
Task 5803,Job 1,6,4,3,11,0,9,17,8,3,3,1,5803,5836,14
Task 5804,Job 0,2,7,1,6,0,3,8,5,1,3,2,5804,5838,16
Task 5804,Job 1,7,5,2,12,0,9,19,10,2,1,2,5804,5838,8
Task 5805,Job 0,1,7,1,12,0,2,13,11,1,3,0,5805,5838,14
Task 5805,Job 1,6,8,3,9,0,9,15,6,3,1,1,5805,5838,4
Task 5806,Job 0,2,5,3,9,0,5,11,6,3,3,1,5806,5840,3
Task 5806,Job 1,7,5,1,8,0,8,15,7,1,1,0,5806,5840,7
Task 5807,Job 0,1,5,3,11,0,4,12,8,3,4,1,5807,5840,19
Task 5807,Job 1,6,6,4,11,0,10,17,7,4,4,2,5807,5840,9
Task 5808,Job 0,8,6,1,10,0,9,18,9,1,3,0,5808,5842,14
Task 5808,Job 1,13,8,3,11,0,16,24,8,3,1,0,5808,5842,16
Task 5809,Job 0,3,10,1,10,0,4,13,9,1,3,2,5809,5843,4
Task 5809,Job 1,8,8,4,10,0,12,18,6,4,2,0,5809,5843,20
Task 5810,Job 0,6,4,1,6,0,7,12,5,1,4,1,5810,5844,18
Task 5810,Job 1,11,6,1,12,0,12,23,11,1,4,2,5810,5844,8
Task 5811,Job 0,9,8,3,10,0,12,19,7,3,2,0,5811,5845,4
Task 5811,Job 1,14,5,3,10,0,17,24,7,3,2,2,5811,5845,19
Task 5812,Job 0,3,5,4,7,0,7,10,3,4,3,1,5812,5845,5
Task 5812,Job 1,8,8,4,10,1,12,18,6,4,3,1,5812,5845,6
Task 5813,Job 0,7,9,3,12,0,10,19,9,3,4,0,5813,5846,20
Task 5813,Job 1,12,4,4,9,0,16,21,5,4,1,2,5813,5846,20
Task 5814,Job 0,5,5,1,8,0,6,13,7,1,1,2,5814,5848,12
Task 5814,Job 1,10,8,2,12,0,12,22,10,2,2,0,5814,5848,11
Task 5815,Job 0,5,9,2,7,1,7,12,5,2,4,1,5815,5848,18
Task 5815,Job 1,10,8,3,7,0,13,17,4,3,4,2,5815,5848,6
Task 5816,Job 0,8,5,4,11,0,12,19,7,4,2,2,5816,5849,18
Task 5816,Job 1,13,10,2,7,0,15,20,5,2,1,2,5816,5849,2
Task 5817,Job 0,6,4,4,6,0,10,12,2,4,1,2,5817,5851,16
Task 5817,Job 1,11,7,1,6,0,12,17,5,1,4,2,5817,5851,6
Task 5818,Job 0,6,5,2,9,1,8,15,7,2,3,0,5818,5851,4
Task 5818,Job 1,11,7,3,11,0,14,22,8,3,4,2,5818,5851,15
Task 5819,Job 0,8,9,4,11,0,12,19,7,4,4,0,5819,5853,16
Task 5819,Job 1,13,5,4,7,0,17,20,3,4,2,0,5819,5853,15
Task 5820,Job 0,10,7,4,10,0,14,20,6,4,2,2,5820,5853,19
Task 5820,Job 1,15,9,3,9,0,18,24,6,3,3,2,5820,5853,6
Task 5821,Job 0,6,6,3,6,0,9,12,3,3,2,1,5821,5854,15
Task 5821,Job 1,11,7,3,9,0,14,20,6,3,4,0,5821,5854,18
Task 5822,Job 0,5,8,3,6,1,8,11,3,3,1,1,5822,5855,19
Task 5822,Job 1,10,8,4,10,0,14,20,6,4,1,0,5822,5855,12
Task 5823,Job 0,5,8,1,8,0,6,13,7,1,4,0,5823,5856,17
Task 5823,Job 1,10,5,3,11,0,13,21,8,3,2,2,5823,5856,4
Task 5824,Job 0,10,9,1,8,0,11,18,7,1,2,2,5824,5858,16
Task 5824,Job 1,15,10,1,6,0,16,21,5,1,2,1,5824,5858,8
Task 5825,Job 0,4,10,4,12,1,8,16,8,4,3,1,5825,5858,13
Task 5825,Job 1,9,7,4,12,0,13,21,8,4,1,0,5825,5858,19
Task 5826,Job 0,4,9,3,11,0,7,15,8,3,2,2,5826,5860,7
Task 5826,Job 1,9,8,2,10,0,11,19,8,2,3,1,5826,5860,11
Task 5827,Job 0,9,7,2,12,1,11,21,10,2,1,0,5827,5860,5
Task 5827,Job 1,14,8,2,10,0,16,24,8,2,4,1,5827,5860,12
Task 5828,Job 0,8,9,3,10,1,11,18,7,3,2,0,5828,5861,14
Task 5828,Job 1,13,6,4,8,1,17,21,4,4,3,1,5828,5861,20
Task 5829,Job 0,5,7,2,11,0,7,16,9,2,4,0,5829,5862,11
Task 5829,Job 1,10,8,3,7,0,13,17,4,3,3,0,5829,5862,19
Task 5830,Job 0,2,8,3,10,0,5,12,7,3,3,1,5830,5864,6
Task 5830,Job 1,7,10,4,10,0,11,17,6,4,3,2,5830,5864,9
Task 5831,Job 0,3,6,2,10,0,5,13,8,2,3,0,5831,5864,3
Task 5831,Job 1,8,10,3,8,0,11,16,5,3,1,0,5831,5864,18
Task 5832,Job 0,6,7,2,7,0,8,13,5,2,1,1,5832,5866,16
Task 5832,Job 1,11,7,1,8,1,12,19,7,1,4,1,5832,5866,16
Task 5833,Job 0,3,4,3,8,1,6,11,5,3,2,1,5833,5867,4
Task 5833,Job 1,8,8,3,10,1,11,18,7,3,1,2,5833,5867,8
Task 5834,Job 0,10,4,4,12,0,14,22,8,4,2,0,5834,5867,3
Task 5834,Job 1,15,4,1,12,0,16,27,11,1,2,0,5834,5867,17
Task 5835,Job 0,1,8,2,11,1,3,12,9,2,1,1,5835,5869,19
Task 5835,Job 1,6,7,3,11,0,9,17,8,3,4,1,5835,5869,10
Task 5836,Job 0,1,6,2,9,0,3,10,7,2,3,0,5836,5869,17
Task 5836,Job 1,6,8,2,12,0,8,18,10,2,4,2,5836,5869,16
Task 5837,Job 0,5,5,4,6,1,9,11,2,4,3,0,5837,5871,7
Task 5837,Job 1,10,7,1,12,1,11,22,11,1,3,1,5837,5871,10
Task 5838,Job 0,1,4,1,12,0,2,13,11,1,1,0,5838,5871,6
Task 5838,Job 1,6,5,3,11,1,9,17,8,3,1,2,5838,5871,10
Task 5839,Job 0,7,8,2,7,0,9,14,5,2,4,2,5839,5873,10
Task 5839,Job 1,12,5,2,10,0,14,22,8,2,3,0,5839,5873,12
Task 5840,Job 0,10,6,1,7,0,11,17,6,1,4,2,5840,5873,20
Task 5840,Job 1,15,7,2,7,1,17,22,5,2,4,0,5840,5873,5
Task 5841,Job 0,3,7,3,8,0,6,11,5,3,2,1,5841,5874,18
Task 5841,Job 1,8,4,2,7,0,10,15,5,2,1,1,5841,5874,8
Task 5842,Job 0,5,7,4,9,0,9,14,5,4,1,2,5842,5876,14
Task 5842,Job 1,10,5,3,12,0,13,22,9,3,1,0,5842,5876,11
Task 5843,Job 0,5,4,1,10,0,6,15,9,1,2,0,5843,5876,10
Task 5843,Job 1,10,5,1,6,0,11,16,5,1,2,1,5843,5876,6
Task 5844,Job 0,3,4,4,8,0,7,11,4,4,4,2,5844,5878,12
Task 5844,Job 1,8,8,3,11,0,11,19,8,3,3,1,5844,5878,12
Task 5845,Job 0,2,10,3,12,0,5,14,9,3,3,0,5845,5879,8
Task 5845,Job 1,7,10,2,7,1,9,14,5,2,3,0,5845,5879,2
Task 5846,Job 0,9,5,4,8,1,13,17,4,4,2,0,5846,5880,18
Task 5846,Job 1,14,8,1,12,0,15,26,11,1,4,1,5846,5880,4
Task 5847,Job 0,4,9,3,11,1,7,15,8,3,4,1,5847,5880,5
Task 5847,Job 1,9,7,2,9,0,11,18,7,2,2,1,5847,5880,2
Task 5848,Job 0,7,6,2,12,1,9,19,10,2,1,1,5848,5882,12
Task 5848,Job 1,12,6,3,11,0,15,23,8,3,1,2,5848,5882,3
Task 5849,Job 0,7,9,2,12,0,9,19,10,2,3,1,5849,5883,13
Task 5849,Job 1,12,6,1,10,0,13,22,9,1,3,0,5849,5883,5
Task 5850,Job 0,1,4,3,8,0,4,9,5,3,2,0,5850,5883,3
Task 5850,Job 1,6,10,3,9,0,9,15,6,3,4,0,5850,5883,12
Task 5851,Job 0,9,5,1,12,0,10,21,11,1,1,2,5851,5884,6
Task 5851,Job 1,14,9,2,11,1,16,25,9,2,2,1,5851,5884,15
Task 5852,Job 0,8,9,2,7,1,10,15,5,2,3,1,5852,5885,6
Task 5852,Job 1,13,9,1,11,0,14,24,10,1,1,0,5852,5885,11
Task 5853,Job 0,2,8,3,9,0,5,11,6,3,3,2,5853,5887,20
Task 5853,Job 1,7,8,1,9,0,8,16,8,1,4,0,5853,5887,14
Task 5854,Job 0,7,4,2,10,0,9,17,8,2,2,0,5854,5888,2
Task 5854,Job 1,12,10,4,12,0,16,24,8,4,1,0,5854,5888,15
Task 5855,Job 0,1,7,1,9,0,2,10,8,1,1,2,5855,5888,3
Task 5855,Job 1,6,5,4,12,0,10,18,8,4,3,1,5855,5888,17
Task 5856,Job 0,2,9,2,12,0,4,14,10,2,4,2,5856,5890,9
Task 5856,Job 1,7,8,2,9,0,9,16,7,2,1,0,5856,5890,6
Task 5857,Job 0,3,8,3,10,0,6,13,7,3,1,2,5857,5890,18
Task 5857,Job 1,8,9,2,9,0,10,17,7,2,3,0,5857,5890,4
Task 5858,Job 0,5,10,1,9,0,6,14,8,1,2,2,5858,5892,7
Task 5858,Job 1,10,10,1,11,0,11,21,10,1,4,0,5858,5892,19
Task 5859,Job 0,8,8,1,6,1,9,14,5,1,1,2,5859,5892,5
Task 5859,Job 1,13,8,3,10,0,16,23,7,3,3,2,5859,5892,6
Task 5860,Job 0,7,5,3,7,0,10,14,4,3,1,0,5860,5894,5
Task 5860,Job 1,12,9,3,6,0,15,18,3,3,2,1,5860,5894,12
Task 5861,Job 0,4,8,1,11,0,5,15,10,1,2,0,5861,5894,5
Task 5861,Job 1,9,7,3,10,0,12,19,7,3,4,0,5861,5894,2
Task 5862,Job 0,7,5,3,9,0,10,16,6,3,1,1,5862,5896,15
Task 5862,Job 1,12,4,4,12,0,16,24,8,4,2,1,5862,5896,5
Task 5863,Job 0,4,6,4,10,1,8,14,6,4,3,2,5863,5897,11
Task 5863,Job 1,9,4,2,11,1,11,20,9,2,1,0,5863,5897,8
Task 5864,Job 0,3,9,2,7,1,5,10,5,2,2,2,5864,5898,20
Task 5864,Job 1,8,9,4,7,0,12,15,3,4,3,2,5864,5898,19
Task 5865,Job 0,5,5,2,10,0,7,15,8,2,1,1,5865,5898,10
Task 5865,Job 1,10,7,2,8,0,12,18,6,2,3,1,5865,5898,11
Task 5866,Job 0,1,4,2,6,0,3,7,4,2,1,2,5866,5900,17
Task 5866,Job 1,6,4,4,6,0,10,12,2,4,3,2,5866,5900,19
Task 5867,Job 0,2,4,1,7,0,3,9,6,1,1,2,5867,5900,11
Task 5867,Job 1,7,10,4,10,0,11,17,6,4,4,2,5867,5900,13
Task 5868,Job 0,9,4,2,7,0,11,16,5,2,3,0,5868,5901,13
Task 5868,Job 1,14,5,2,9,0,16,23,7,2,4,0,5868,5901,5
Task 5869,Job 0,4,7,3,11,0,7,15,8,3,1,0,5869,5902,9
Task 5869,Job 1,9,5,3,9,0,12,18,6,3,2,0,5869,5902,3
Task 5870,Job 0,9,7,3,6,0,12,15,3,3,4,1,5870,5903,9
Task 5870,Job 1,14,5,4,6,0,18,20,2,4,1,0,5870,5903,2
Task 5871,Job 0,3,6,1,12,1,4,15,11,1,3,2,5871,5904,7
Task 5871,Job 1,8,6,3,6,1,11,14,3,3,4,0,5871,5904,6
Task 5872,Job 0,3,5,3,8,1,6,11,5,3,3,2,5872,5905,14
Task 5872,Job 1,8,8,3,12,1,11,20,9,3,3,2,5872,5905,18
Task 5873,Job 0,5,8,4,10,0,9,15,6,4,2,1,5873,5907,9
Task 5873,Job 1,10,6,4,11,0,14,21,7,4,4,0,5873,5907,10
Task 5874,Job 0,10,10,2,7,0,12,17,5,2,4,2,5874,5907,16
Task 5874,Job 1,15,9,3,7,0,18,22,4,3,1,2,5874,5907,8
Task 5875,Job 0,8,10,3,9,0,11,17,6,3,3,2,5875,5908,5
Task 5875,Job 1,13,10,3,8,0,16,21,5,3,2,1,5875,5908,9
Task 5876,Job 0,3,6,4,12,0,7,15,8,4,1,1,5876,5910,14
Task 5876,Job 1,8,6,3,7,0,11,15,4,3,1,1,5876,5910,16
Task 5877,Job 0,3,10,3,12,0,6,15,9,3,2,0,5877,5910,11
Task 5877,Job 1,8,9,3,6,0,11,14,3,3,4,2,5877,5910,3
Task 5878,Job 0,5,10,2,10,0,7,15,8,2,3,2,5878,5912,10
Task 5878,Job 1,10,4,2,8,1,12,18,6,2,2,2,5878,5912,19
Task 5879,Job 0,4,6,2,11,0,6,15,9,2,4,1,5879,5912,2
Task 5879,Job 1,9,9,1,6,1,10,15,5,1,4,2,5879,5912,17
Task 5880,Job 0,9,9,3,10,1,12,19,7,3,2,2,5880,5914,4
Task 5880,Job 1,14,9,4,7,0,18,21,3,4,4,1,5880,5914,7
Task 5881,Job 0,9,10,4,8,1,13,17,4,4,1,2,5881,5914,2
Task 5881,Job 1,14,7,4,12,0,18,26,8,4,4,0,5881,5914,4
Task 5882,Job 0,5,5,2,9,1,7,14,7,2,4,2,5882,5916,15
Task 5882,Job 1,10,8,3,7,0,13,17,4,3,3,1,5882,5916,14
Task 5883,Job 0,10,4,3,12,0,13,22,9,3,2,0,5883,5916,13
Task 5883,Job 1,15,5,1,11,0,16,26,10,1,3,1,5883,5916,9
Task 5884,Job 0,7,7,1,9,0,8,16,8,1,4,1,5884,5917,13
Task 5884,Job 1,12,6,2,11,1,14,23,9,2,3,0,5884,5917,8
Task 5885,Job 0,6,4,3,8,0,9,14,5,3,3,0,5885,5918,2
Task 5885,Job 1,11,10,3,11,0,14,22,8,3,3,2,5885,5918,5
Task 5886,Job 0,6,5,4,7,0,10,13,3,4,3,2,5886,5920,18
Task 5886,Job 1,11,7,2,10,0,13,21,8,2,3,2,5886,5920,10
Task 5887,Job 0,9,10,1,8,0,10,17,7,1,2,0,5887,5921,6
Task 5887,Job 1,14,4,2,7,0,16,21,5,2,3,2,5887,5921,14
Task 5888,Job 0,6,9,3,11,1,9,17,8,3,3,0,5888,5921,8
Task 5888,Job 1,11,8,2,9,1,13,20,7,2,1,2,5888,5921,11
Task 5889,Job 0,9,6,4,12,0,13,21,8,4,2,2,5889,5922,13
Task 5889,Job 1,14,8,1,11,0,15,25,10,1,2,0,5889,5922,13
Task 5890,Job 0,9,9,4,12,0,13,21,8,4,3,2,5890,5923,4
Task 5890,Job 1,14,7,2,11,1,16,25,9,2,2,2,5890,5923,12
Task 5891,Job 0,3,10,2,12,0,5,15,10,2,4,2,5891,5925,8
Task 5891,Job 1,8,9,1,10,0,9,18,9,1,4,1,5891,5925,17
Task 5892,Job 0,10,6,1,7,0,11,17,6,1,1,0,5892,5925,10
Task 5892,Job 1,15,6,4,6,1,19,21,2,4,3,0,5892,5925,3
Task 5893,Job 0,10,10,1,12,0,11,22,11,1,4,2,5893,5927,10
Task 5893,Job 1,15,5,3,7,0,18,22,4,3,2,0,5893,5927,8
Task 5894,Job 0,1,8,3,6,1,4,7,3,3,3,2,5894,5927,14
Task 5894,Job 1,6,10,1,7,0,7,13,6,1,4,2,5894,5927,12
Task 5895,Job 0,3,8,4,12,0,7,15,8,4,4,2,5895,5929,13
Task 5895,Job 1,8,7,3,11,0,11,19,8,3,2,2,5895,5929,16
Task 5896,Job 0,1,7,1,9,1,2,10,8,1,1,1,5896,5929,16
Task 5896,Job 1,6,4,1,8,0,7,14,7,1,1,2,5896,5929,20
Task 5897,Job 0,4,5,2,7,0,6,11,5,2,2,2,5897,5930,17
Task 5897,Job 1,9,10,1,12,1,10,21,11,1,3,2,5897,5930,13
Task 5898,Job 0,6,7,2,7,0,8,13,5,2,4,2,5898,5932,15
Task 5898,Job 1,11,6,2,9,1,13,20,7,2,1,0,5898,5932,8
Task 5899,Job 0,4,8,2,7,0,6,11,5,2,4,0,5899,5932,5
Task 5899,Job 1,9,5,1,10,0,10,19,9,1,1,2,5899,5932,15
Task 5900,Job 0,10,4,1,8,0,11,18,7,1,4,1,5900,5934,4
Task 5900,Job 1,15,7,3,7,1,18,22,4,3,2,1,5900,5934,7
Task 5901,Job 0,5,9,4,12,0,9,17,8,4,4,2,5901,5935,9
Task 5901,Job 1,10,8,1,8,0,11,18,7,1,1,2,5901,5935,19
Task 5902,Job 0,1,6,2,10,1,3,11,8,2,2,2,5902,5936,10
Task 5902,Job 1,6,4,2,9,0,8,15,7,2,4,0,5902,5936,9
Task 5903,Job 0,2,9,3,12,1,5,14,9,3,2,1,5903,5936,20
Task 5903,Job 1,7,5,1,8,0,8,15,7,1,4,1,5903,5936,14
Task 5904,Job 0,8,6,1,8,0,9,16,7,1,1,0,5904,5938,6
Task 5904,Job 1,13,5,1,7,0,14,20,6,1,1,0,5904,5938,20
Task 5905,Job 0,5,4,1,6,0,6,11,5,1,2,2,5905,5939,3
Task 5905,Job 1,10,9,3,12,0,13,22,9,3,2,2,5905,5939,18
Task 5906,Job 0,8,8,3,9,0,11,17,6,3,4,0,5906,5940,17
Task 5906,Job 1,13,9,3,11,1,16,24,8,3,4,2,5906,5940,19
Task 5907,Job 0,8,9,3,10,0,11,18,7,3,2,0,5907,5940,17
Task 5907,Job 1,13,7,3,8,1,16,21,5,3,3,0,5907,5940,8
Task 5908,Job 0,2,4,2,7,0,4,9,5,2,4,0,5908,5941,14
Task 5908,Job 1,7,4,4,8,1,11,15,4,4,2,1,5908,5941,20
Task 5909,Job 0,9,5,3,10,0,12,19,7,3,3,1,5909,5942,16
Task 5909,Job 1,14,6,3,10,0,17,24,7,3,1,2,5909,5942,16
Task 5910,Job 0,10,8,2,12,1,12,22,10,2,3,1,5910,5944,8
Task 5910,Job 1,15,7,3,10,0,18,25,7,3,1,2,5910,5944,11
Task 5911,Job 0,2,4,1,11,0,3,13,10,1,1,2,5911,5945,13
Task 5911,Job 1,7,7,4,9,0,11,16,5,4,1,0,5911,5945,9
Task 5912,Job 0,3,5,1,12,0,4,15,11,1,3,2,5912,5945,9
Task 5912,Job 1,8,8,4,6,0,12,14,2,4,3,1,5912,5945,12
Task 5913,Job 0,3,6,4,6,0,7,9,2,4,1,2,5913,5947,20
Task 5913,Job 1,8,7,4,7,1,12,15,3,4,4,1,5913,5947,8
Task 5914,Job 0,5,9,2,8,0,7,13,6,2,1,1,5914,5948,8
Task 5914,Job 1,10,9,3,12,0,13,22,9,3,3,1,5914,5948,4
Task 5915,Job 0,3,6,1,6,0,4,9,5,1,1,1,5915,5949,4
Task 5915,Job 1,8,5,4,6,0,12,14,2,4,2,0,5915,5949,8
Task 5916,Job 0,3,10,1,7,0,4,10,6,1,1,1,5916,5949,9
Task 5916,Job 1,8,4,4,9,0,12,17,5,4,4,2,5916,5949,9
Task 5917,Job 0,8,6,2,9,0,10,17,7,2,4,0,5917,5951,3
Task 5917,Job 1,13,10,3,10,1,16,23,7,3,1,2,5917,5951,15
Task 5918,Job 0,3,4,3,7,1,6,10,4,3,3,0,5918,5952,6
Task 5918,Job 1,8,9,3,10,0,11,18,7,3,3,0,5918,5952,15
Task 5919,Job 0,4,5,3,6,0,7,10,3,3,4,1,5919,5952,20
Task 5919,Job 1,9,6,3,7,0,12,16,4,3,1,1,5919,5952,3
Task 5920,Job 0,10,9,2,9,0,12,19,7,2,2,0,5920,5954,11
Task 5920,Job 1,15,9,4,6,0,19,21,2,4,4,1,5920,5954,11
Task 5921,Job 0,3,4,4,11,0,7,14,7,4,4,0,5921,5955,7
Task 5921,Job 1,8,9,4,9,1,12,17,5,4,3,0,5921,5955,14
Task 5922,Job 0,3,5,4,11,1,7,14,7,4,1,0,5922,5956,14
Task 5922,Job 1,8,6,3,9,0,11,17,6,3,2,0,5922,5956,20
Task 5923,Job 0,1,8,3,9,0,4,10,6,3,1,1,5923,5956,12
Task 5923,Job 1,6,10,1,11,0,7,17,10,1,3,2,5923,5956,15
Task 5924,Job 0,10,4,3,6,0,13,16,3,3,4,0,5924,5957,5
Task 5924,Job 1,15,5,1,7,0,16,22,6,1,2,1,5924,5957,18
Task 5925,Job 0,4,7,2,9,0,6,13,7,2,2,0,5925,5958,15
Task 5925,Job 1,9,6,2,9,1,11,18,7,2,2,0,5925,5958,9
Task 5926,Job 0,2,4,4,8,0,6,10,4,4,2,0,5926,5960,11
Task 5926,Job 1,7,6,4,7,1,11,14,3,4,1,2,5926,5960,7
Task 5927,Job 0,8,7,4,11,1,12,19,7,4,2,0,5927,5961,10
Task 5927,Job 1,13,5,3,9,0,16,22,6,3,1,1,5927,5961,7
Task 5928,Job 0,10,9,1,9,0,11,19,8,1,3,0,5928,5961,19
Task 5928,Job 1,15,10,3,12,0,18,27,9,3,4,1,5928,5961,8
Task 5929,Job 0,7,10,1,8,0,8,15,7,1,2,1,5929,5963,18
Task 5929,Job 1,12,10,4,11,0,16,23,7,4,1,2,5929,5963,17
Task 5930,Job 0,6,9,4,7,0,10,13,3,4,2,2,5930,5964,16
Task 5930,Job 1,11,9,1,7,0,12,18,6,1,4,1,5930,5964,17
Task 5931,Job 0,1,6,3,8,1,4,9,5,3,2,1,5931,5964,6
Task 5931,Job 1,6,7,4,6,0,10,12,2,4,3,1,5931,5964,14
Task 5932,Job 0,4,10,2,10,0,6,14,8,2,1,1,5932,5965,7
Task 5932,Job 1,9,5,2,6,1,11,15,4,2,4,1,5932,5965,12
Task 5933,Job 0,5,9,3,12,0,8,17,9,3,1,0,5933,5967,6
Task 5933,Job 1,10,10,1,7,0,11,17,6,1,3,0,5933,5967,5
Task 5934,Job 0,3,5,3,11,0,6,14,8,3,4,0,5934,5967,17
Task 5934,Job 1,8,6,1,9,0,9,17,8,1,3,2,5934,5967,9
Task 5935,Job 0,9,9,4,6,0,13,15,2,4,3,2,5935,5968,20
Task 5935,Job 1,14,9,4,6,1,18,20,2,4,2,0,5935,5968,3
Task 5936,Job 0,5,5,2,8,0,7,13,6,2,4,1,5936,5970,10
Task 5936,Job 1,10,4,4,10,0,14,20,6,4,4,0,5936,5970,20
Task 5937,Job 0,8,7,1,12,0,9,20,11,1,2,1,5937,5970,12
Task 5937,Job 1,13,5,2,9,0,15,22,7,2,3,1,5937,5970,20
Task 5938,Job 0,7,6,1,7,0,8,14,6,1,2,2,5938,5971,14
Task 5938,Job 1,12,5,2,6,1,14,18,4,2,1,2,5938,5971,18
Task 5939,Job 0,8,10,3,7,0,11,15,4,3,4,2,5939,5973,13
Task 5939,Job 1,13,9,2,12,0,15,25,10,2,3,0,5939,5973,6
Task 5940,Job 0,10,7,2,12,1,12,22,10,2,1,2,5940,5974,6
Task 5940,Job 1,15,6,1,12,0,16,27,11,1,3,2,5940,5974,18
Task 5941,Job 0,4,4,4,11,0,8,15,7,4,3,1,5941,5974,7
Task 5941,Job 1,9,7,4,6,0,13,15,2,4,4,1,5941,5974,16
Task 5942,Job 0,8,4,3,8,0,11,16,5,3,1,1,5942,5976,16
Task 5942,Job 1,13,5,1,8,0,14,21,7,1,2,0,5942,5976,12
Task 5943,Job 0,9,6,1,12,0,10,21,11,1,4,0,5943,5977,15
Task 5943,Job 1,14,7,4,7,1,18,21,3,4,3,2,5943,5977,14
Task 5944,Job 0,5,10,1,6,0,6,11,5,1,2,0,5944,5978,13
Task 5944,Job 1,10,9,3,7,0,13,17,4,3,4,1,5944,5978,18
Task 5945,Job 0,4,5,4,11,0,8,15,7,4,2,2,5945,5979,19
Task 5945,Job 1,9,10,4,7,0,13,16,3,4,4,2,5945,5979,11
Task 5946,Job 0,5,9,2,6,1,7,11,4,2,3,0,5946,5979,10
Task 5946,Job 1,10,5,1,6,0,11,16,5,1,2,2,5946,5979,20
Task 5947,Job 0,6,9,1,12,1,7,18,11,1,2,1,5947,5980,19
Task 5947,Job 1,11,9,2,7,0,13,18,5,2,2,0,5947,5980,8
Task 5948,Job 0,4,10,3,10,1,7,14,7,3,4,0,5948,5981,9
Task 5948,Job 1,9,10,1,7,0,10,16,6,1,4,2,5948,5981,16
Task 5949,Job 0,1,9,3,10,0,4,11,7,3,2,0,5949,5982,2
Task 5949,Job 1,6,7,3,6,1,9,12,3,3,3,2,5949,5982,18
Task 5950,Job 0,10,7,3,6,0,13,16,3,3,1,0,5950,5983,13
Task 5950,Job 1,15,6,3,6,0,18,21,3,3,1,0,5950,5983,14
Task 5951,Job 0,6,8,1,6,0,7,12,5,1,3,1,5951,5984,18
Task 5951,Job 1,11,10,1,9,1,12,20,8,1,1,2,5951,5984,9
Task 5952,Job 0,5,6,2,9,0,7,14,7,2,1,2,5952,5985,8
Task 5952,Job 1,10,8,3,12,0,13,22,9,3,4,0,5952,5985,16
Task 5953,Job 0,9,7,4,12,0,13,21,8,4,3,0,5953,5986,17
Task 5953,Job 1,14,9,4,8,0,18,22,4,4,4,0,5953,5986,2
Task 5954,Job 0,8,4,1,7,0,9,15,6,1,1,2,5954,5987,9
Task 5954,Job 1,13,9,3,12,0,16,25,9,3,2,0,5954,5987,13
Task 5955,Job 0,7,7,4,6,0,11,13,2,4,1,0,5955,5989,11
Task 5955,Job 1,12,4,3,11,0,15,23,8,3,3,0,5955,5989,16
Task 5956,Job 0,2,6,2,8,0,4,10,6,2,1,0,5956,5990,10
Task 5956,Job 1,7,7,3,7,0,10,14,4,3,3,2,5956,5990,5
Task 5957,Job 0,1,8,1,6,0,2,7,5,1,2,1,5957,5990,3
Task 5957,Job 1,6,6,4,6,0,10,12,2,4,3,0,5957,5990,9
Task 5958,Job 0,5,5,2,6,0,7,11,4,2,4,1,5958,5992,3
Task 5958,Job 1,10,6,3,11,0,13,21,8,3,2,1,5958,5992,13
Task 5959,Job 0,10,5,2,6,0,12,16,4,2,1,1,5959,5992,2
Task 5959,Job 1,15,5,2,12,0,17,27,10,2,4,1,5959,5992,20
Task 5960,Job 0,7,9,1,10,1,8,17,9,1,4,0,5960,5994,16
Task 5960,Job 1,12,7,4,10,0,16,22,6,4,4,1,5960,5994,16
Task 5961,Job 0,2,5,4,12,0,6,14,8,4,3,0,5961,5994,9
Task 5961,Job 1,7,4,1,7,0,8,14,6,1,4,0,5961,5994,18
Task 5962,Job 0,10,7,1,7,1,11,17,6,1,2,2,5962,5996,20
Task 5962,Job 1,15,4,1,11,0,16,26,10,1,1,2,5962,5996,8
Task 5963,Job 0,8,8,2,11,0,10,19,9,2,3,0,5963,5997,2
Task 5963,Job 1,13,6,1,9,1,14,22,8,1,3,2,5963,5997,6
Task 5964,Job 0,1,9,2,8,0,3,9,6,2,3,1,5964,5997,19
Task 5964,Job 1,6,5,2,9,1,8,15,7,2,4,2,5964,5997,19
Task 5965,Job 0,10,6,3,8,0,13,18,5,3,4,0,5965,5998,18
Task 5965,Job 1,15,9,3,10,1,18,25,7,3,3,2,5965,5998,16
Task 5966,Job 0,4,8,2,9,1,6,13,7,2,2,0,5966,5999,15
Task 5966,Job 1,9,6,1,8,1,10,17,7,1,3,0,5966,5999,8
Task 5967,Job 0,10,7,3,6,1,13,16,3,3,4,1,5967,6000,12
Task 5967,Job 1,15,7,2,11,0,17,26,9,2,3,2,5967,6000,4
Task 5968,Job 0,9,7,3,11,0,12,20,8,3,3,0,5968,6002,4
Task 5968,Job 1,14,4,2,6,1,16,20,4,2,1,2,5968,6002,11
Task 5969,Job 0,4,6,4,11,0,8,15,7,4,1,0,5969,6002,8
Task 5969,Job 1,9,10,4,9,0,13,18,5,4,1,0,5969,6002,15
Task 5970,Job 0,10,4,1,9,0,11,19,8,1,4,2,5970,6004,19
Task 5970,Job 1,15,4,2,12,0,17,27,10,2,1,0,5970,6004,6
Task 5971,Job 0,8,5,1,10,0,9,18,9,1,4,1,5971,6004,3
Task 5971,Job 1,13,9,1,8,0,14,21,7,1,1,0,5971,6004,19
Task 5972,Job 0,2,7,4,11,0,6,13,7,4,2,2,5972,6006,19
Task 5972,Job 1,7,4,2,8,0,9,15,6,2,1,2,5972,6006,19
Task 5973,Job 0,6,5,4,10,1,10,16,6,4,4,1,5973,6006,3
Task 5973,Job 1,11,6,2,12,1,13,23,10,2,1,0,5973,6006,13
Task 5974,Job 0,2,10,4,8,0,6,10,4,4,3,0,5974,6008,4
Task 5974,Job 1,7,9,1,10,1,8,17,9,1,3,0,5974,6008,8
Task 5975,Job 0,9,9,1,6,0,10,15,5,1,4,2,5975,6009,4
Task 5975,Job 1,14,5,1,6,0,15,20,5,1,1,2,5975,6009,17
Task 5976,Job 0,10,9,2,11,1,12,21,9,2,4,1,5976,6010,20
Task 5976,Job 1,15,4,4,6,0,19,21,2,4,3,0,5976,6010,2
Task 5977,Job 0,9,5,2,7,1,11,16,5,2,1,0,5977,6010,4
Task 5977,Job 1,14,6,4,12,0,18,26,8,4,4,0,5977,6010,10
Task 5978,Job 0,5,8,2,10,0,7,15,8,2,1,2,5978,6012,15
Task 5978,Job 1,10,7,4,10,0,14,20,6,4,2,1,5978,6012,3
Task 5979,Job 0,4,7,4,11,1,8,15,7,4,4,0,5979,6012,13
Task 5979,Job 1,9,8,2,8,1,11,17,6,2,3,1,5979,6012,7
Task 5980,Job 0,2,4,2,9,0,4,11,7,2,4,1,5980,6014,13
Task 5980,Job 1,7,7,1,9,1,8,16,8,1,2,1,5980,6014,3
Task 5981,Job 0,5,5,3,12,1,8,17,9,3,4,0,5981,6014,5
Task 5981,Job 1,10,10,2,9,0,12,19,7,2,2,0,5981,6014,14
Task 5982,Job 0,5,7,1,11,0,6,16,10,1,3,0,5982,6015,15
Task 5982,Job 1,10,4,3,10,1,13,20,7,3,3,2,5982,6015,11
Task 5983,Job 0,8,5,2,10,1,10,18,8,2,2,2,5983,6016,15
Task 5983,Job 1,13,7,2,6,0,15,19,4,2,3,2,5983,6016,18
Task 5984,Job 0,1,8,3,8,0,4,9,5,3,1,1,5984,6017,20
Task 5984,Job 1,6,5,2,6,1,8,12,4,2,2,1,5984,6017,11
Task 5985,Job 0,8,8,2,7,1,10,15,5,2,1,0,5985,6018,17
Task 5985,Job 1,13,10,2,7,0,15,20,5,2,3,1,5985,6018,13
Task 5986,Job 0,1,9,4,8,0,5,9,4,4,4,2,5986,6019,12
Task 5986,Job 1,6,5,4,11,0,10,17,7,4,1,2,5986,6019,3
Task 5987,Job 0,2,9,2,9,0,4,11,7,2,1,2,5987,6021,8
Task 5987,Job 1,7,6,2,11,0,9,18,9,2,2,0,5987,6021,14
Task 5988,Job 0,3,8,4,7,0,7,10,3,4,1,0,5988,6021,2
Task 5988,Job 1,8,6,1,6,0,9,14,5,1,1,1,5988,6021,6
Task 5989,Job 0,9,6,1,7,0,10,16,6,1,4,2,5989,6022,12
Task 5989,Job 1,14,6,4,8,0,18,22,4,4,3,1,5989,6022,5
Task 5990,Job 0,2,4,1,12,0,3,14,11,1,1,2,5990,6023,12
Task 5990,Job 1,7,8,4,12,1,11,19,8,4,2,0,5990,6023,7
Task 5991,Job 0,9,7,4,10,0,13,19,6,4,2,0,5991,6025,10
Task 5991,Job 1,14,6,1,11,1,15,25,10,1,3,0,5991,6025,2
Task 5992,Job 0,10,8,3,12,0,13,22,9,3,3,0,5992,6025,14
Task 5992,Job 1,15,10,3,11,0,18,26,8,3,4,1,5992,6025,11
Task 5993,Job 0,6,4,2,8,0,8,14,6,2,2,1,5993,6027,6
Task 5993,Job 1,11,10,2,9,0,13,20,7,2,4,1,5993,6027,7
Task 5994,Job 0,6,6,2,7,1,8,13,5,2,2,0,5994,6027,4
Task 5994,Job 1,11,4,1,11,0,12,22,10,1,2,0,5994,6027,16
Task 5995,Job 0,1,8,2,8,0,3,9,6,2,2,2,5995,6029,9
Task 5995,Job 1,6,9,2,9,0,8,15,7,2,2,2,5995,6029,19
Task 5996,Job 0,6,9,2,10,0,8,16,8,2,1,0,5996,6030,17
Task 5996,Job 1,11,10,3,11,0,14,22,8,3,3,0,5996,6030,12
Task 5997,Job 0,6,10,4,11,0,10,17,7,4,3,2,5997,6030,12
Task 5997,Job 1,11,4,3,10,0,14,21,7,3,4,0,5997,6030,11
Task 5998,Job 0,6,5,1,11,0,7,17,10,1,4,2,5998,6032,13
Task 5998,Job 1,11,6,3,10,1,14,21,7,3,4,2,5998,6032,4
Task 5999,Job 0,3,7,4,9,0,7,12,5,4,3,0,5999,6032,12
Task 5999,Job 1,8,6,3,11,0,11,19,8,3,4,1,5999,6032,17
Task 6000,Job 0,2,9,1,12,0,3,14,11,1,4,2,6000,6033,6
Task 6000,Job 1,7,8,3,8,0,10,15,5,3,4,2,6000,6033,13
Task 6001,Job 0,9,6,1,10,0,10,19,9,1,1,0,6001,6035,10
Task 6001,Job 1,14,5,2,11,1,16,25,9,2,4,0,6001,6035,13
Task 6002,Job 0,5,10,1,11,0,6,16,10,1,1,2,6002,6035,13
Task 6002,Job 1,10,8,4,12,0,14,22,8,4,1,1,6002,6035,10
Task 6003,Job 0,5,9,1,6,0,6,11,5,1,2,0,6003,6037,19
Task 6003,Job 1,10,4,3,9,1,13,19,6,3,4,1,6003,6037,16
Task 6004,Job 0,8,4,3,8,0,11,16,5,3,3,1,6004,6038,13
Task 6004,Job 1,13,9,3,8,0,16,21,5,3,3,2,6004,6038,4
Task 6005,Job 0,4,5,2,6,0,6,10,4,2,1,1,6005,6039,8
Task 6005,Job 1,9,5,3,9,0,12,18,6,3,4,2,6005,6039,17
Task 6006,Job 0,5,9,3,6,0,8,11,3,3,4,2,6006,6040,11
Task 6006,Job 1,10,9,2,8,0,12,18,6,2,4,2,6006,6040,16
Task 6007,Job 0,4,8,4,12,0,8,16,8,4,2,2,6007,6041,6
Task 6007,Job 1,9,9,4,11,0,13,20,7,4,2,1,6007,6041,4
Task 6008,Job 0,6,8,1,12,0,7,18,11,1,1,1,6008,6041,10
Task 6008,Job 1,11,7,4,11,0,15,22,7,4,4,2,6008,6041,20
Task 6009,Job 0,3,7,4,10,0,7,13,6,4,2,2,6009,6043,19
Task 6009,Job 1,8,5,4,6,0,12,14,2,4,2,2,6009,6043,11
Task 6010,Job 0,10,5,2,6,1,12,16,4,2,2,0,6010,6043,15
Task 6010,Job 1,15,7,2,7,0,17,22,5,2,4,0,6010,6043,11
Task 6011,Job 0,4,4,2,8,0,6,12,6,2,1,1,6011,6044,11
Task 6011,Job 1,9,5,2,11,0,11,20,9,2,4,2,6011,6044,12
Task 6012,Job 0,4,7,1,12,0,5,16,11,1,1,2,6012,6045,8
Task 6012,Job 1,9,4,4,12,0,13,21,8,4,2,0,6012,6045,18
Task 6013,Job 0,3,6,4,11,1,7,14,7,4,4,0,6013,6047,4
Task 6013,Job 1,8,4,2,10,1,10,18,8,2,3,1,6013,6047,14
Task 6014,Job 0,10,7,1,12,0,11,22,11,1,3,0,6014,6048,8
Task 6014,Job 1,15,8,2,10,0,17,25,8,2,4,2,6014,6048,14
Task 6015,Job 0,2,6,4,10,0,6,12,6,4,3,2,6015,6048,10
Task 6015,Job 1,7,5,1,10,0,8,17,9,1,3,0,6015,6048,7
Task 6016,Job 0,6,10,1,10,0,7,16,9,1,3,1,6016,6049,7
Task 6016,Job 1,11,4,1,11,0,12,22,10,1,1,0,6016,6049,8
Task 6017,Job 0,3,10,4,7,0,7,10,3,4,2,2,6017,6050,17
Task 6017,Job 1,8,10,4,9,0,12,17,5,4,1,2,6017,6050,19
Task 6018,Job 0,1,10,3,9,0,4,10,6,3,2,1,6018,6052,15
Task 6018,Job 1,6,5,3,7,0,9,13,4,3,3,1,6018,6052,6
Task 6019,Job 0,8,7,4,8,0,12,16,4,4,1,0,6019,6053,3
Task 6019,Job 1,13,7,4,9,0,17,22,5,4,1,2,6019,6053,17
Task 6020,Job 0,7,8,2,12,0,9,19,10,2,4,2,6020,6053,14
Task 6020,Job 1,12,6,4,9,0,16,21,5,4,1,1,6020,6053,12
Task 6021,Job 0,4,5,3,8,1,7,12,5,3,4,0,6021,6055,9
Task 6021,Job 1,9,8,3,6,0,12,15,3,3,3,1,6021,6055,18
Task 6022,Job 0,2,6,4,12,0,6,14,8,4,2,0,6022,6055,3
Task 6022,Job 1,7,5,2,6,0,9,13,4,2,3,0,6022,6055,10
Task 6023,Job 0,5,9,4,12,0,9,17,8,4,3,2,6023,6057,4
Task 6023,Job 1,10,6,3,9,1,13,19,6,3,2,2,6023,6057,19
Task 6024,Job 0,3,7,2,8,0,5,11,6,2,1,0,6024,6057,12
Task 6024,Job 1,8,6,1,9,1,9,17,8,1,2,2,6024,6057,18
Task 6025,Job 0,1,7,3,8,0,4,9,5,3,4,0,6025,6058,17
Task 6025,Job 1,6,4,4,9,0,10,15,5,4,1,0,6025,6058,16
Task 6026,Job 0,10,5,4,11,0,14,21,7,4,4,0,6026,6060,7
Task 6026,Job 1,15,7,3,9,0,18,24,6,3,3,2,6026,6060,6
Task 6027,Job 0,6,10,1,12,0,7,18,11,1,2,2,6027,6061,11
Task 6027,Job 1,11,4,1,11,0,12,22,10,1,1,0,6027,6061,17
Task 6028,Job 0,7,6,2,11,0,9,18,9,2,1,2,6028,6062,12
Task 6028,Job 1,12,7,4,8,1,16,20,4,4,1,2,6028,6062,10
Task 6029,Job 0,8,6,3,7,0,11,15,4,3,1,1,6029,6062,17
Task 6029,Job 1,13,5,1,11,1,14,24,10,1,2,2,6029,6062,10
Task 6030,Job 0,4,8,1,11,0,5,15,10,1,1,1,6030,6063,14
Task 6030,Job 1,9,7,4,11,0,13,20,7,4,4,0,6030,6063,14
Task 6031,Job 0,2,9,1,9,0,3,11,8,1,2,0,6031,6064,14
Task 6031,Job 1,7,6,1,8,1,8,15,7,1,4,1,6031,6064,12
Task 6032,Job 0,10,6,2,7,0,12,17,5,2,3,1,6032,6065,18
Task 6032,Job 1,15,4,4,6,0,19,21,2,4,2,0,6032,6065,3
Task 6033,Job 0,1,9,3,7,0,4,8,4,3,2,0,6033,6066,14
Task 6033,Job 1,6,8,4,8,0,10,14,4,4,2,1,6033,6066,12
Task 6034,Job 0,5,8,1,11,0,6,16,10,1,1,2,6034,6067,3
Task 6034,Job 1,10,10,2,7,0,12,17,5,2,3,2,6034,6067,14
Task 6035,Job 0,3,9,2,7,0,5,10,5,2,2,2,6035,6068,12
Task 6035,Job 1,8,8,4,10,0,12,18,6,4,2,2,6035,6068,18
Task 6036,Job 0,10,10,3,11,0,13,21,8,3,2,0,6036,6070,3
Task 6036,Job 1,15,8,4,10,0,19,25,6,4,3,2,6036,6070,7
Task 6037,Job 0,10,5,3,7,0,13,17,4,3,2,2,6037,6071,4
Task 6037,Job 1,15,9,3,8,0,18,23,5,3,1,1,6037,6071,8
Task 6038,Job 0,10,7,1,6,0,11,16,5,1,4,2,6038,6072,2
Task 6038,Job 1,15,9,2,9,0,17,24,7,2,1,0,6038,6072,18
Task 6039,Job 0,10,4,2,8,1,12,18,6,2,4,0,6039,6072,8
Task 6039,Job 1,15,7,4,11,0,19,26,7,4,1,1,6039,6072,6
Task 6040,Job 0,9,9,4,6,1,13,15,2,4,4,2,6040,6074,4
Task 6040,Job 1,14,6,2,12,1,16,26,10,2,3,2,6040,6074,10
Task 6041,Job 0,8,5,3,10,0,11,18,7,3,2,1,6041,6074,18
Task 6041,Job 1,13,10,1,12,0,14,25,11,1,3,0,6041,6074,6
Task 6042,Job 0,3,7,1,9,0,4,12,8,1,4,1,6042,6075,12
Task 6042,Job 1,8,6,1,11,1,9,19,10,1,3,0,6042,6075,11
Task 6043,Job 0,7,10,3,12,0,10,19,9,3,1,2,6043,6077,4
Task 6043,Job 1,12,8,1,8,0,13,20,7,1,3,2,6043,6077,7
Task 6044,Job 0,10,9,2,8,0,12,18,6,2,2,1,6044,6077,8
Task 6044,Job 1,15,7,3,9,0,18,24,6,3,1,1,6044,6077,4
Task 6045,Job 0,5,10,4,6,0,9,11,2,4,3,2,6045,6078,15
Task 6045,Job 1,10,9,3,11,0,13,21,8,3,4,1,6045,6078,7
Task 6046,Job 0,1,5,4,7,0,5,8,3,4,4,1,6046,6080,10
Task 6046,Job 1,6,9,2,7,0,8,13,5,2,4,1,6046,6080,2
Task 6047,Job 0,1,6,4,8,0,5,9,4,4,4,0,6047,6080,14
Task 6047,Job 1,6,9,2,12,0,8,18,10,2,4,2,6047,6080,9
Task 6048,Job 0,6,10,1,7,0,7,13,6,1,4,2,6048,6082,5
Task 6048,Job 1,11,5,4,7,0,15,18,3,4,1,1,6048,6082,3
Task 6049,Job 0,7,7,2,10,1,9,17,8,2,2,2,6049,6083,10
Task 6049,Job 1,12,4,2,9,0,14,21,7,2,4,2,6049,6083,18
Task 6050,Job 0,3,5,1,6,0,4,9,5,1,1,0,6050,6083,16
Task 6050,Job 1,8,6,2,10,1,10,18,8,2,3,1,6050,6083,12
Task 6051,Job 0,5,8,3,8,0,8,13,5,3,4,1,6051,6085,12
Task 6051,Job 1,10,10,3,9,1,13,19,6,3,2,1,6051,6085,3
Task 6052,Job 0,5,4,1,9,1,6,14,8,1,3,1,6052,6086,13
Task 6052,Job 1,10,8,1,12,0,11,22,11,1,2,0,6052,6086,5
Task 6053,Job 0,7,10,4,11,1,11,18,7,4,4,2,6053,6086,13
Task 6053,Job 1,12,7,1,7,0,13,19,6,1,2,0,6053,6086,19
Task 6054,Job 0,1,7,4,8,0,5,9,4,4,3,2,6054,6088,16
Task 6054,Job 1,6,8,2,10,0,8,16,8,2,1,1,6054,6088,19
Task 6055,Job 0,5,10,1,12,0,6,17,11,1,1,1,6055,6089,2
Task 6055,Job 1,10,8,4,12,0,14,22,8,4,1,2,6055,6089,2
Task 6056,Job 0,8,9,4,6,0,12,14,2,4,3,0,6056,6089,12
Task 6056,Job 1,13,10,4,6,0,17,19,2,4,1,2,6056,6089,2
Task 6057,Job 0,10,9,1,11,0,11,21,10,1,4,2,6057,6090,6
Task 6057,Job 1,15,7,2,6,0,17,21,4,2,1,0,6057,6090,10
Task 6058,Job 0,6,9,2,12,0,8,18,10,2,3,1,6058,6091,5
Task 6058,Job 1,11,4,3,6,0,14,17,3,3,4,2,6058,6091,20
Task 6059,Job 0,7,9,2,11,0,9,18,9,2,2,0,6059,6093,13
Task 6059,Job 1,12,8,1,7,0,13,19,6,1,1,2,6059,6093,8
Task 6060,Job 0,4,10,4,7,0,8,11,3,4,1,1,6060,6093,19
Task 6060,Job 1,9,7,3,12,0,12,21,9,3,2,1,6060,6093,20
Task 6061,Job 0,1,4,4,7,0,5,8,3,4,4,0,6061,6094,11
Task 6061,Job 1,6,7,1,8,0,7,14,7,1,4,1,6061,6094,17
Task 6062,Job 0,5,8,4,9,0,9,14,5,4,1,1,6062,6095,15
Task 6062,Job 1,10,8,2,7,1,12,17,5,2,2,2,6062,6095,9
Task 6063,Job 0,4,9,4,8,1,8,12,4,4,1,0,6063,6096,5
Task 6063,Job 1,9,4,4,7,1,13,16,3,4,4,2,6063,6096,15
Task 6064,Job 0,9,8,4,11,0,13,20,7,4,3,1,6064,6097,5
Task 6064,Job 1,14,6,1,12,1,15,26,11,1,1,1,6064,6097,14
Task 6065,Job 0,8,7,3,12,0,11,20,9,3,4,2,6065,6099,19
Task 6065,Job 1,13,9,2,11,0,15,24,9,2,4,2,6065,6099,16
Task 6066,Job 0,8,5,1,10,0,9,18,9,1,3,1,6066,6099,16
Task 6066,Job 1,13,10,3,8,0,16,21,5,3,4,2,6066,6099,11
Task 6067,Job 0,3,6,2,12,0,5,15,10,2,2,1,6067,6100,10
Task 6067,Job 1,8,6,2,10,0,10,18,8,2,4,2,6067,6100,11
Task 6068,Job 0,2,9,4,8,0,6,10,4,4,4,0,6068,6101,7
Task 6068,Job 1,7,5,2,7,0,9,14,5,2,3,1,6068,6101,18
Task 6069,Job 0,9,9,2,7,1,11,16,5,2,1,2,6069,6102,11
Task 6069,Job 1,14,9,3,6,0,17,20,3,3,4,2,6069,6102,8
Task 6070,Job 0,8,4,1,7,0,9,15,6,1,1,0,6070,6104,4
Task 6070,Job 1,13,5,3,12,1,16,25,9,3,4,0,6070,6104,12
Task 6071,Job 0,2,6,2,11,0,4,13,9,2,4,1,6071,6104,4
Task 6071,Job 1,7,10,3,9,1,10,16,6,3,4,0,6071,6104,7
Task 6072,Job 0,8,8,1,9,0,9,17,8,1,2,1,6072,6106,17
Task 6072,Job 1,13,6,3,10,0,16,23,7,3,2,2,6072,6106,14
Task 6073,Job 0,5,8,1,12,0,6,17,11,1,1,2,6073,6106,11
Task 6073,Job 1,10,10,2,7,0,12,17,5,2,4,0,6073,6106,13
Task 6074,Job 0,5,8,3,9,0,8,14,6,3,1,1,6074,6107,8
Task 6074,Job 1,10,6,4,6,0,14,16,2,4,4,2,6074,6107,17
Task 6075,Job 0,4,6,4,8,0,8,12,4,4,2,1,6075,6109,12
Task 6075,Job 1,9,6,1,9,1,10,18,8,1,2,2,6075,6109,8
Task 6076,Job 0,6,9,3,9,0,9,15,6,3,2,1,6076,6109,15
Task 6076,Job 1,11,4,2,6,1,13,17,4,2,2,2,6076,6109,5
Task 6077,Job 0,5,10,1,9,0,6,14,8,1,1,2,6077,6110,2
Task 6077,Job 1,10,6,1,6,0,11,16,5,1,4,0,6077,6110,4
Task 6078,Job 0,7,7,3,8,0,10,15,5,3,3,0,6078,6111,10
Task 6078,Job 1,12,8,3,6,0,15,18,3,3,2,0,6078,6111,16
Task 6079,Job 0,8,8,3,8,0,11,16,5,3,1,2,6079,6113,3
Task 6079,Job 1,13,10,4,6,0,17,19,2,4,2,1,6079,6113,18
Task 6080,Job 0,8,4,4,9,0,12,17,5,4,2,2,6080,6113,18
Task 6080,Job 1,13,7,2,8,0,15,21,6,2,4,0,6080,6113,16
Task 6081,Job 0,2,7,3,11,0,5,13,8,3,3,1,6081,6115,4
Task 6081,Job 1,7,4,4,6,0,11,13,2,4,3,2,6081,6115,11
Task 6082,Job 0,4,5,1,12,1,5,16,11,1,1,0,6082,6115,15
Task 6082,Job 1,9,4,2,7,0,11,16,5,2,3,2,6082,6115,18
Task 6083,Job 0,6,5,2,10,0,8,16,8,2,2,2,6083,6117,9
Task 6083,Job 1,11,8,3,6,1,14,17,3,3,3,1,6083,6117,9
Task 6084,Job 0,4,4,3,7,0,7,11,4,3,3,2,6084,6117,3
Task 6084,Job 1,9,8,4,12,0,13,21,8,4,3,0,6084,6117,14
Task 6085,Job 0,9,6,4,11,0,13,20,7,4,3,1,6085,6119,8
Task 6085,Job 1,14,4,2,10,1,16,24,8,2,4,0,6085,6119,15
Task 6086,Job 0,5,5,4,10,0,9,15,6,4,4,0,6086,6120,20
Task 6086,Job 1,10,8,4,6,1,14,16,2,4,2,1,6086,6120,15
Task 6087,Job 0,5,6,2,10,0,7,15,8,2,4,1,6087,6120,17
Task 6087,Job 1,10,4,2,9,0,12,19,7,2,2,2,6087,6120,12
Task 6088,Job 0,10,4,1,8,0,11,18,7,1,2,1,6088,6122,6
Task 6088,Job 1,15,10,4,10,0,19,25,6,4,4,2,6088,6122,8
Task 6089,Job 0,6,9,4,11,0,10,17,7,4,2,1,6089,6123,8
Task 6089,Job 1,11,10,3,7,0,14,18,4,3,3,2,6089,6123,12
Task 6090,Job 0,5,5,1,6,0,6,11,5,1,3,0,6090,6124,8
Task 6090,Job 1,10,4,1,12,0,11,22,11,1,2,2,6090,6124,16
Task 6091,Job 0,7,5,2,9,0,9,16,7,2,1,0,6091,6124,17
Task 6091,Job 1,12,7,1,11,0,13,23,10,1,3,0,6091,6124,6
Task 6092,Job 0,9,8,4,7,0,13,16,3,4,3,1,6092,6126,10
Task 6092,Job 1,14,4,1,11,0,15,25,10,1,2,2,6092,6126,13
Task 6093,Job 0,5,7,1,12,1,6,17,11,1,2,0,6093,6126,10
Task 6093,Job 1,10,5,1,7,1,11,17,6,1,4,1,6093,6126,19
Task 6094,Job 0,1,5,1,9,0,2,10,8,1,1,2,6094,6128,7
Task 6094,Job 1,6,6,1,8,0,7,14,7,1,1,1,6094,6128,3
Task 6095,Job 0,2,7,2,6,0,4,8,4,2,3,0,6095,6129,8
Task 6095,Job 1,7,4,4,10,0,11,17,6,4,1,2,6095,6129,3
Task 6096,Job 0,5,9,3,12,0,8,17,9,3,2,2,6096,6129,15
Task 6096,Job 1,10,7,3,7,1,13,17,4,3,1,1,6096,6129,7
Task 6097,Job 0,6,4,3,10,1,9,16,7,3,3,1,6097,6130,16
Task 6097,Job 1,11,8,4,9,0,15,20,5,4,2,2,6097,6130,2
Task 6098,Job 0,7,7,4,8,0,11,15,4,4,4,2,6098,6132,14
Task 6098,Job 1,12,7,1,7,0,13,19,6,1,4,0,6098,6132,20
Task 6099,Job 0,4,5,2,8,0,6,12,6,2,2,0,6099,6132,5
Task 6099,Job 1,9,6,2,10,0,11,19,8,2,2,0,6099,6132,12
Task 6100,Job 0,6,6,3,11,0,9,17,8,3,2,1,6100,6133,6
Task 6100,Job 1,11,9,4,7,0,15,18,3,4,1,1,6100,6133,3
Task 6101,Job 0,6,9,1,10,0,7,16,9,1,4,1,6101,6135,16
Task 6101,Job 1,11,10,4,10,0,15,21,6,4,2,1,6101,6135,15
Task 6102,Job 0,10,8,2,7,0,12,17,5,2,3,2,6102,6135,8
Task 6102,Job 1,15,5,3,6,0,18,21,3,3,3,2,6102,6135,11
Task 6103,Job 0,9,7,3,7,1,12,16,4,3,4,2,6103,6136,19
Task 6103,Job 1,14,9,2,10,0,16,24,8,2,3,1,6103,6136,13
Task 6104,Job 0,2,9,1,6,1,3,8,5,1,2,2,6104,6137,17
Task 6104,Job 1,7,4,4,7,1,11,14,3,4,2,1,6104,6137,11
Task 6105,Job 0,8,8,1,8,1,9,16,7,1,3,2,6105,6139,13
Task 6105,Job 1,13,8,3,12,0,16,25,9,3,2,0,6105,6139,11
Task 6106,Job 0,9,9,3,7,0,12,16,4,3,1,0,6106,6139,2
Task 6106,Job 1,14,10,1,8,0,15,22,7,1,3,2,6106,6139,11
Task 6107,Job 0,5,9,3,6,0,8,11,3,3,3,0,6107,6140,18
Task 6107,Job 1,10,5,3,6,0,13,16,3,3,1,0,6107,6140,7
Task 6108,Job 0,4,6,3,12,0,7,16,9,3,4,1,6108,6142,20
Task 6108,Job 1,9,8,4,9,1,13,18,5,4,2,0,6108,6142,18
Task 6109,Job 0,7,8,4,7,0,11,14,3,4,3,2,6109,6143,16
Task 6109,Job 1,12,6,3,12,0,15,24,9,3,2,0,6109,6143,2
Task 6110,Job 0,1,9,4,10,1,5,11,6,4,4,0,6110,6143,20
Task 6110,Job 1,6,8,1,7,0,7,13,6,1,1,1,6110,6143,8
Task 6111,Job 0,7,4,2,11,0,9,18,9,2,2,0,6111,6144,5
Task 6111,Job 1,12,9,2,8,1,14,20,6,2,2,1,6111,6144,11
Task 6112,Job 0,8,7,4,12,0,12,20,8,4,1,2,6112,6145,9
Task 6112,Job 1,13,7,2,10,0,15,23,8,2,4,2,6112,6145,18
Task 6113,Job 0,6,4,4,11,0,10,17,7,4,3,0,6113,6146,20
Task 6113,Job 1,11,9,2,11,1,13,22,9,2,1,2,6113,6146,8
Task 6114,Job 0,10,6,4,11,0,14,21,7,4,3,0,6114,6147,16
Task 6114,Job 1,15,10,1,6,0,16,21,5,1,1,2,6114,6147,19
Task 6115,Job 0,6,7,2,11,0,8,17,9,2,4,2,6115,6148,19
Task 6115,Job 1,11,9,3,8,0,14,19,5,3,3,0,6115,6148,16
Task 6116,Job 0,10,4,4,10,0,14,20,6,4,1,1,6116,6150,8
Task 6116,Job 1,15,7,4,10,0,19,25,6,4,1,1,6116,6150,2
Task 6117,Job 0,10,7,2,9,0,12,19,7,2,1,0,6117,6151,2
Task 6117,Job 1,15,10,4,7,0,19,22,3,4,4,0,6117,6151,4
Task 6118,Job 0,7,8,1,10,1,8,17,9,1,2,0,6118,6152,4
Task 6118,Job 1,12,5,4,10,1,16,22,6,4,3,0,6118,6152,2
Task 6119,Job 0,9,5,3,10,0,12,19,7,3,2,2,6119,6152,18
Task 6119,Job 1,14,10,3,12,0,17,26,9,3,4,0,6119,6152,9
Task 6120,Job 0,10,5,2,12,0,12,22,10,2,2,2,6120,6153,18
Task 6120,Job 1,15,7,3,7,0,18,22,4,3,3,0,6120,6153,10
Task 6121,Job 0,4,5,3,7,1,7,11,4,3,2,2,6121,6155,4
Task 6121,Job 1,9,5,2,7,0,11,16,5,2,1,0,6121,6155,12
Task 6122,Job 0,5,9,2,6,0,7,11,4,2,3,0,6122,6155,20
Task 6122,Job 1,10,8,3,10,0,13,20,7,3,3,1,6122,6155,12
Task 6123,Job 0,7,7,1,10,1,8,17,9,1,3,0,6123,6157,13
Task 6123,Job 1,12,8,1,7,0,13,19,6,1,2,0,6123,6157,9
Task 6124,Job 0,9,10,3,10,0,12,19,7,3,2,0,6124,6158,18
Task 6124,Job 1,14,7,3,9,0,17,23,6,3,2,0,6124,6158,11
Task 6125,Job 0,7,4,2,12,0,9,19,10,2,1,1,6125,6159,2
Task 6125,Job 1,12,6,4,7,0,16,19,3,4,4,0,6125,6159,11
Task 6126,Job 0,8,6,2,8,1,10,16,6,2,3,2,6126,6160,15
Task 6126,Job 1,13,5,3,11,1,16,24,8,3,2,2,6126,6160,9
Task 6127,Job 0,9,9,4,9,0,13,18,5,4,1,2,6127,6160,11
Task 6127,Job 1,14,5,2,12,1,16,26,10,2,1,2,6127,6160,20
Task 6128,Job 0,3,10,4,12,1,7,15,8,4,2,0,6128,6162,11
Task 6128,Job 1,8,8,2,6,0,10,14,4,2,2,2,6128,6162,3
Task 6129,Job 0,6,9,4,6,0,10,12,2,4,1,1,6129,6163,5
Task 6129,Job 1,11,6,4,7,1,15,18,3,4,4,2,6129,6163,16
Task 6130,Job 0,9,4,4,9,0,13,18,5,4,1,2,6130,6164,7
Task 6130,Job 1,14,4,2,12,0,16,26,10,2,3,0,6130,6164,19
Task 6131,Job 0,9,7,4,9,0,13,18,5,4,2,2,6131,6164,13
Task 6131,Job 1,14,6,1,9,1,15,23,8,1,1,0,6131,6164,16
Task 6132,Job 0,1,10,3,9,1,4,10,6,3,2,2,6132,6166,10
Task 6132,Job 1,6,9,1,7,1,7,13,6,1,4,1,6132,6166,12
Task 6133,Job 0,3,10,2,8,0,5,11,6,2,1,0,6133,6166,5
Task 6133,Job 1,8,5,3,7,0,11,15,4,3,2,1,6133,6166,13
Task 6134,Job 0,2,10,1,9,0,3,11,8,1,1,1,6134,6168,9
Task 6134,Job 1,7,7,4,9,0,11,16,5,4,2,0,6134,6168,14
Task 6135,Job 0,4,10,4,11,0,8,15,7,4,1,1,6135,6168,13
Task 6135,Job 1,9,9,3,6,0,12,15,3,3,2,2,6135,6168,6
Task 6136,Job 0,7,4,2,9,1,9,16,7,2,3,1,6136,6170,20
Task 6136,Job 1,12,10,3,10,0,15,22,7,3,2,1,6136,6170,11
Task 6137,Job 0,3,8,4,12,0,7,15,8,4,1,2,6137,6171,14
Task 6137,Job 1,8,5,3,10,0,11,18,7,3,2,0,6137,6171,15
Task 6138,Job 0,2,6,1,6,1,3,8,5,1,3,2,6138,6171,17
Task 6138,Job 1,7,5,4,12,0,11,19,8,4,3,0,6138,6171,2
Task 6139,Job 0,7,4,1,12,0,8,19,11,1,2,1,6139,6173,4
Task 6139,Job 1,12,5,3,10,0,15,22,7,3,4,2,6139,6173,5
Task 6140,Job 0,9,8,2,7,1,11,16,5,2,4,1,6140,6174,17
Task 6140,Job 1,14,9,3,6,0,17,20,3,3,4,1,6140,6174,4
Task 6141,Job 0,9,9,3,10,0,12,19,7,3,4,2,6141,6174,16
Task 6141,Job 1,14,8,4,10,0,18,24,6,4,2,0,6141,6174,12
Task 6142,Job 0,7,9,3,10,1,10,17,7,3,1,2,6142,6175,12
Task 6142,Job 1,12,5,2,11,0,14,23,9,2,2,0,6142,6175,12
Task 6143,Job 0,3,4,2,8,0,5,11,6,2,1,2,6143,6176,18
Task 6143,Job 1,8,5,3,7,1,11,15,4,3,4,0,6143,6176,3
Task 6144,Job 0,7,5,3,11,0,10,18,8,3,1,2,6144,6178,10
Task 6144,Job 1,12,6,3,12,0,15,24,9,3,3,0,6144,6178,19
Task 6145,Job 0,4,4,3,6,1,7,10,3,3,2,1,6145,6178,5
Task 6145,Job 1,9,7,3,10,0,12,19,7,3,2,2,6145,6178,13
Task 6146,Job 0,1,6,3,9,0,4,10,6,3,2,0,6146,6180,5
Task 6146,Job 1,6,8,3,6,0,9,12,3,3,3,2,6146,6180,11
Task 6147,Job 0,2,4,2,6,0,4,8,4,2,4,1,6147,6181,13
Task 6147,Job 1,7,10,1,10,0,8,17,9,1,1,1,6147,6181,15
Task 6148,Job 0,9,10,4,9,1,13,18,5,4,3,2,6148,6181,8
Task 6148,Job 1,14,5,1,6,0,15,20,5,1,3,1,6148,6181,14
Task 6149,Job 0,7,4,4,12,0,11,19,8,4,4,0,6149,6182,3
Task 6149,Job 1,12,10,1,11,0,13,23,10,1,3,0,6149,6182,18
Task 6150,Job 0,2,6,4,11,0,6,13,7,4,3,0,6150,6184,6
Task 6150,Job 1,7,10,1,8,0,8,15,7,1,4,2,6150,6184,7
Task 6151,Job 0,7,5,1,6,1,8,13,5,1,2,1,6151,6184,9
Task 6151,Job 1,12,5,4,8,0,16,20,4,4,4,1,6151,6184,2
Task 6152,Job 0,10,6,4,9,0,14,19,5,4,4,2,6152,6186,3
Task 6152,Job 1,15,9,1,8,1,16,23,7,1,3,2,6152,6186,7
Task 6153,Job 0,2,4,3,7,0,5,9,4,3,4,0,6153,6186,9
Task 6153,Job 1,7,8,2,11,0,9,18,9,2,3,1,6153,6186,20
Task 6154,Job 0,8,4,4,11,0,12,19,7,4,3,0,6154,6187,19
Task 6154,Job 1,13,4,3,12,0,16,25,9,3,3,2,6154,6187,13
Task 6155,Job 0,4,9,1,12,1,5,16,11,1,2,2,6155,6188,18
Task 6155,Job 1,9,8,2,12,1,11,21,10,2,1,0,6155,6188,11
Task 6156,Job 0,8,6,3,12,0,11,20,9,3,2,2,6156,6189,14
Task 6156,Job 1,13,5,1,10,0,14,23,9,1,4,0,6156,6189,13
Task 6157,Job 0,4,5,4,10,0,8,14,6,4,2,1,6157,6190,18
Task 6157,Job 1,9,5,1,7,0,10,16,6,1,1,1,6157,6190,9
Task 6158,Job 0,5,5,4,12,0,9,17,8,4,2,0,6158,6192,3
Task 6158,Job 1,10,7,2,9,0,12,19,7,2,2,0,6158,6192,10
Task 6159,Job 0,6,7,1,12,0,7,18,11,1,4,0,6159,6193,18
Task 6159,Job 1,11,8,4,10,0,15,21,6,4,1,1,6159,6193,17
Task 6160,Job 0,9,5,2,11,0,11,20,9,2,3,0,6160,6194,11
Task 6160,Job 1,14,6,4,7,1,18,21,3,4,4,0,6160,6194,20
Task 6161,Job 0,4,10,4,7,0,8,11,3,4,2,2,6161,6195,4
Task 6161,Job 1,9,10,4,7,0,13,16,3,4,1,1,6161,6195,13
Task 6162,Job 0,7,6,3,11,0,10,18,8,3,3,1,6162,6195,16
Task 6162,Job 1,12,7,4,10,0,16,22,6,4,4,2,6162,6195,8
Task 6163,Job 0,4,10,2,8,0,6,12,6,2,2,0,6163,6197,11
Task 6163,Job 1,9,4,3,9,1,12,18,6,3,3,2,6163,6197,9
Task 6164,Job 0,2,6,4,10,0,6,12,6,4,1,2,6164,6197,17
Task 6164,Job 1,7,8,1,6,1,8,13,5,1,3,2,6164,6197,12
Task 6165,Job 0,10,8,3,6,0,13,16,3,3,3,0,6165,6199,2
Task 6165,Job 1,15,6,2,6,1,17,21,4,2,1,0,6165,6199,17
Task 6166,Job 0,9,8,2,10,1,11,19,8,2,2,2,6166,6199,18
Task 6166,Job 1,14,8,1,7,0,15,21,6,1,4,1,6166,6199,5
Task 6167,Job 0,10,9,3,8,0,13,18,5,3,1,1,6167,6201,15
Task 6167,Job 1,15,6,2,6,0,17,21,4,2,3,0,6167,6201,9
Task 6168,Job 0,6,7,3,11,0,9,17,8,3,2,0,6168,6202,2
Task 6168,Job 1,11,8,1,9,1,12,20,8,1,3,2,6168,6202,18
Task 6169,Job 0,3,10,2,9,0,5,12,7,2,3,1,6169,6203,13
Task 6169,Job 1,8,10,2,12,0,10,20,10,2,3,0,6169,6203,5
Task 6170,Job 0,4,7,2,9,0,6,13,7,2,3,0,6170,6204,20
Task 6170,Job 1,9,4,3,7,0,12,16,4,3,1,2,6170,6204,14
Task 6171,Job 0,10,4,3,6,0,13,16,3,3,3,2,6171,6205,9
Task 6171,Job 1,15,4,3,11,0,18,26,8,3,4,2,6171,6205,20
Task 6172,Job 0,7,9,4,9,0,11,16,5,4,1,1,6172,6205,11
Task 6172,Job 1,12,5,1,7,0,13,19,6,1,4,2,6172,6205,7
Task 6173,Job 0,4,7,2,11,1,6,15,9,2,2,1,6173,6207,12
Task 6173,Job 1,9,10,4,11,0,13,20,7,4,4,1,6173,6207,13
Task 6174,Job 0,10,10,1,9,0,11,19,8,1,3,0,6174,6208,5
Task 6174,Job 1,15,6,4,8,1,19,23,4,4,2,0,6174,6208,12
Task 6175,Job 0,8,4,2,10,0,10,18,8,2,2,2,6175,6208,2
Task 6175,Job 1,13,7,1,10,1,14,23,9,1,4,2,6175,6208,12
Task 6176,Job 0,4,4,4,12,0,8,16,8,4,2,2,6176,6209,4
Task 6176,Job 1,9,7,4,6,0,13,15,2,4,4,2,6176,6209,2
Task 6177,Job 0,7,5,3,11,0,10,18,8,3,2,1,6177,6210,12
Task 6177,Job 1,12,9,2,10,0,14,22,8,2,3,2,6177,6210,20
Task 6178,Job 0,10,7,1,6,0,11,16,5,1,4,0,6178,6212,9
Task 6178,Job 1,15,8,1,12,0,16,27,11,1,3,2,6178,6212,14
Task 6179,Job 0,3,6,4,7,0,7,10,3,4,2,2,6179,6213,13
Task 6179,Job 1,8,6,4,7,0,12,15,3,4,4,1,6179,6213,5
Task 6180,Job 0,4,9,4,12,0,8,16,8,4,2,2,6180,6213,4
Task 6180,Job 1,9,10,1,6,1,10,15,5,1,4,2,6180,6213,5
Task 6181,Job 0,6,4,3,7,0,9,13,4,3,4,0,6181,6215,11
Task 6181,Job 1,11,8,1,12,0,12,23,11,1,4,1,6181,6215,19
Task 6182,Job 0,5,9,2,11,0,7,16,9,2,4,2,6182,6215,14
Task 6182,Job 1,10,5,2,12,1,12,22,10,2,2,2,6182,6215,9
Task 6183,Job 0,6,9,4,6,1,10,12,2,4,2,0,6183,6216,11
Task 6183,Job 1,11,4,1,8,1,12,19,7,1,3,1,6183,6216,10
Task 6184,Job 0,10,4,2,12,0,12,22,10,2,2,1,6184,6218,12
Task 6184,Job 1,15,6,1,8,0,16,23,7,1,4,0,6184,6218,14
Task 6185,Job 0,4,4,4,10,1,8,14,6,4,2,2,6185,6219,4
Task 6185,Job 1,9,6,1,7,1,10,16,6,1,4,2,6185,6219,6
Task 6186,Job 0,1,5,1,8,0,2,9,7,1,1,1,6186,6220,9
Task 6186,Job 1,6,4,4,9,0,10,15,5,4,1,1,6186,6220,11
Task 6187,Job 0,6,9,1,6,0,7,12,5,1,2,1,6187,6220,12
Task 6187,Job 1,11,9,2,12,0,13,23,10,2,3,2,6187,6220,18
Task 6188,Job 0,1,6,1,12,1,2,13,11,1,4,0,6188,6222,20
Task 6188,Job 1,6,10,4,6,0,10,12,2,4,3,2,6188,6222,2
Task 6189,Job 0,5,7,2,9,0,7,14,7,2,2,1,6189,6222,7
Task 6189,Job 1,10,6,2,12,0,12,22,10,2,4,2,6189,6222,4
Task 6190,Job 0,9,9,4,12,0,13,21,8,4,3,0,6190,6223,14
Task 6190,Job 1,14,10,3,12,1,17,26,9,3,1,1,6190,6223,3
Task 6191,Job 0,5,4,1,8,1,6,13,7,1,2,0,6191,6224,15
Task 6191,Job 1,10,7,1,11,1,11,21,10,1,1,0,6191,6224,20
Task 6192,Job 0,6,7,3,10,0,9,16,7,3,1,0,6192,6225,18
Task 6192,Job 1,11,4,2,6,0,13,17,4,2,4,2,6192,6225,6
Task 6193,Job 0,9,7,4,11,0,13,20,7,4,4,1,6193,6226,20
Task 6193,Job 1,14,4,3,7,0,17,21,4,3,4,2,6193,6226,5
Task 6194,Job 0,10,9,4,11,0,14,21,7,4,2,1,6194,6228,11
Task 6194,Job 1,15,4,4,6,1,19,21,2,4,3,0,6194,6228,20
Task 6195,Job 0,8,5,4,8,0,12,16,4,4,3,2,6195,6228,4
Task 6195,Job 1,13,9,2,10,0,15,23,8,2,1,0,6195,6228,14
Task 6196,Job 0,10,4,2,8,1,12,18,6,2,3,1,6196,6229,5
Task 6196,Job 1,15,7,2,11,0,17,26,9,2,3,0,6196,6229,3
Task 6197,Job 0,4,5,3,8,0,7,12,5,3,1,0,6197,6230,12
Task 6197,Job 1,9,8,2,12,0,11,21,10,2,1,0,6197,6230,8
Task 6198,Job 0,6,8,1,10,0,7,16,9,1,3,2,6198,6231,15
Task 6198,Job 1,11,8,3,8,1,14,19,5,3,1,1,6198,6231,14
Task 6199,Job 0,2,6,2,8,0,4,10,6,2,1,1,6199,6232,20
Task 6199,Job 1,7,8,4,11,1,11,18,7,4,2,1,6199,6232,11
Task 6200,Job 0,8,10,1,8,1,9,16,7,1,2,0,6200,6233,5
Task 6200,Job 1,13,9,4,9,0,17,22,5,4,3,0,6200,6233,18
Task 6201,Job 0,2,7,3,7,0,5,9,4,3,3,1,6201,6235,12
Task 6201,Job 1,7,5,3,8,1,10,15,5,3,3,2,6201,6235,3
Task 6202,Job 0,7,4,2,10,0,9,17,8,2,4,1,6202,6236,4
Task 6202,Job 1,12,5,1,9,1,13,21,8,1,4,0,6202,6236,20
Task 6203,Job 0,4,8,4,7,0,8,11,3,4,1,0,6203,6236,14
Task 6203,Job 1,9,7,2,10,0,11,19,8,2,2,1,6203,6236,6
Task 6204,Job 0,3,5,2,6,0,5,9,4,2,4,2,6204,6237,10
Task 6204,Job 1,8,5,1,10,0,9,18,9,1,2,2,6204,6237,3
Task 6205,Job 0,2,6,3,10,0,5,12,7,3,2,1,6205,6238,15
Task 6205,Job 1,7,8,4,11,0,11,18,7,4,3,1,6205,6238,15
Task 6206,Job 0,2,10,1,8,0,3,10,7,1,1,0,6206,6240,15
Task 6206,Job 1,7,6,3,8,0,10,15,5,3,2,0,6206,6240,7
Task 6207,Job 0,5,8,2,8,1,7,13,6,2,3,0,6207,6240,11
Task 6207,Job 1,10,10,1,7,1,11,17,6,1,2,0,6207,6240,15
Task 6208,Job 0,1,6,2,6,0,3,7,4,2,2,1,6208,6241,10
Task 6208,Job 1,6,10,4,11,0,10,17,7,4,2,2,6208,6241,15
Task 6209,Job 0,5,4,1,12,0,6,17,11,1,1,2,6209,6242,5
Task 6209,Job 1,10,8,1,6,1,11,16,5,1,1,0,6209,6242,13
Task 6210,Job 0,4,6,4,9,1,8,13,5,4,2,2,6210,6244,4
Task 6210,Job 1,9,6,4,12,0,13,21,8,4,4,2,6210,6244,4
Task 6211,Job 0,7,9,3,11,1,10,18,8,3,4,0,6211,6244,20
Task 6211,Job 1,12,4,3,10,0,15,22,7,3,3,2,6211,6244,14
Task 6212,Job 0,8,8,4,8,1,12,16,4,4,3,2,6212,6246,17
Task 6212,Job 1,13,9,3,7,0,16,20,4,3,4,1,6212,6246,19
Task 6213,Job 0,7,10,3,12,0,10,19,9,3,2,2,6213,6246,3
Task 6213,Job 1,12,5,4,10,0,16,22,6,4,1,0,6213,6246,14
Task 6214,Job 0,10,6,2,6,0,12,16,4,2,3,1,6214,6247,12
Task 6214,Job 1,15,7,3,9,0,18,24,6,3,2,0,6214,6247,18
Task 6215,Job 0,6,5,3,9,0,9,15,6,3,3,1,6215,6249,4
Task 6215,Job 1,11,4,2,12,1,13,23,10,2,3,0,6215,6249,14
Task 6216,Job 0,10,10,4,10,0,14,20,6,4,4,2,6216,6250,5
Task 6216,Job 1,15,5,1,7,0,16,22,6,1,1,2,6216,6250,20
Task 6217,Job 0,6,6,1,12,0,7,18,11,1,3,0,6217,6250,16
Task 6217,Job 1,11,9,3,7,1,14,18,4,3,1,2,6217,6250,18
Task 6218,Job 0,8,7,2,8,0,10,16,6,2,2,0,6218,6252,3
Task 6218,Job 1,13,8,3,6,0,16,19,3,3,3,2,6218,6252,3
Task 6219,Job 0,10,9,4,8,1,14,18,4,4,4,0,6219,6252,6
Task 6219,Job 1,15,8,2,10,1,17,25,8,2,1,2,6219,6252,3
Task 6220,Job 0,6,4,2,7,0,8,13,5,2,4,0,6220,6253,10
Task 6220,Job 1,11,8,3,8,0,14,19,5,3,1,2,6220,6253,20
Task 6221,Job 0,5,6,1,6,0,6,11,5,1,4,1,6221,6254,6
Task 6221,Job 1,10,10,1,11,0,11,21,10,1,3,0,6221,6254,6
Task 6222,Job 0,3,4,3,10,0,6,13,7,3,1,1,6222,6255,11
Task 6222,Job 1,8,8,4,9,1,12,17,5,4,3,2,6222,6255,9
Task 6223,Job 0,5,9,2,10,1,7,15,8,2,3,2,6223,6257,11
Task 6223,Job 1,10,8,1,12,0,11,22,11,1,4,0,6223,6257,20
Task 6224,Job 0,8,4,1,8,0,9,16,7,1,1,1,6224,6258,10
Task 6224,Job 1,13,4,3,7,1,16,20,4,3,4,1,6224,6258,8
Task 6225,Job 0,10,5,1,9,1,11,19,8,1,4,0,6225,6258,3
Task 6225,Job 1,15,4,3,10,0,18,25,7,3,1,0,6225,6258,7
Task 6226,Job 0,6,4,2,12,0,8,18,10,2,1,0,6226,6260,4
Task 6226,Job 1,11,10,4,6,0,15,17,2,4,1,0,6226,6260,6
Task 6227,Job 0,6,5,1,7,0,7,13,6,1,2,1,6227,6260,7
Task 6227,Job 1,11,7,2,11,0,13,22,9,2,1,1,6227,6260,6
Task 6228,Job 0,3,8,3,11,0,6,14,8,3,3,0,6228,6262,17
Task 6228,Job 1,8,5,4,6,0,12,14,2,4,3,0,6228,6262,6
Task 6229,Job 0,10,6,2,11,0,12,21,9,2,1,2,6229,6263,16
Task 6229,Job 1,15,10,1,6,0,16,21,5,1,1,0,6229,6263,7
Task 6230,Job 0,10,10,1,9,1,11,19,8,1,3,1,6230,6264,8
Task 6230,Job 1,15,7,4,7,0,19,22,3,4,3,1,6230,6264,9
Task 6231,Job 0,2,9,2,9,0,4,11,7,2,3,1,6231,6264,17
Task 6231,Job 1,7,10,4,10,0,11,17,6,4,1,0,6231,6264,3
Task 6232,Job 0,9,10,3,12,0,12,21,9,3,4,0,6232,6265,13
Task 6232,Job 1,14,4,4,7,1,18,21,3,4,3,1,6232,6265,19
Task 6233,Job 0,4,7,1,12,1,5,16,11,1,4,0,6233,6267,4
Task 6233,Job 1,9,9,3,7,0,12,16,4,3,3,2,6233,6267,16
Task 6234,Job 0,5,8,3,12,0,8,17,9,3,4,1,6234,6267,14
Task 6234,Job 1,10,7,1,9,0,11,19,8,1,1,1,6234,6267,12
Task 6235,Job 0,2,10,2,6,0,4,8,4,2,2,0,6235,6268,5
Task 6235,Job 1,7,4,1,11,0,8,18,10,1,4,1,6235,6268,7
Task 6236,Job 0,9,4,1,9,1,10,18,8,1,3,1,6236,6270,9
Task 6236,Job 1,14,10,1,11,0,15,25,10,1,3,1,6236,6270,12
Task 6237,Job 0,7,4,3,9,1,10,16,6,3,1,1,6237,6271,18
Task 6237,Job 1,12,9,4,10,0,16,22,6,4,1,0,6237,6271,16
Task 6238,Job 0,4,7,2,9,0,6,13,7,2,3,1,6238,6272,13
Task 6238,Job 1,9,4,2,11,1,11,20,9,2,4,0,6238,6272,12
Task 6239,Job 0,9,10,4,7,0,13,16,3,4,2,2,6239,6272,11
Task 6239,Job 1,14,7,3,8,1,17,22,5,3,3,1,6239,6272,17
Task 6240,Job 0,4,8,4,12,0,8,16,8,4,2,0,6240,6274,14
Task 6240,Job 1,9,6,3,11,0,12,20,8,3,3,1,6240,6274,3
Task 6241,Job 0,5,9,4,6,0,9,11,2,4,2,1,6241,6275,6
Task 6241,Job 1,10,8,4,6,0,14,16,2,4,2,0,6241,6275,7
Task 6242,Job 0,7,9,1,8,0,8,15,7,1,1,0,6242,6275,2
Task 6242,Job 1,12,10,2,12,0,14,24,10,2,3,0,6242,6275,2
Task 6243,Job 0,5,8,3,6,0,8,11,3,3,4,1,6243,6276,12
Task 6243,Job 1,10,7,4,11,0,14,21,7,4,1,0,6243,6276,2
Task 6244,Job 0,4,10,2,10,0,6,14,8,2,3,2,6244,6277,6
Task 6244,Job 1,9,6,4,12,1,13,21,8,4,1,2,6244,6277,17
Task 6245,Job 0,6,4,2,6,0,8,12,4,2,1,2,6245,6279,10
Task 6245,Job 1,11,7,4,6,0,15,17,2,4,1,0,6245,6279,8
Task 6246,Job 0,1,9,1,8,0,2,9,7,1,2,2,6246,6280,4
Task 6246,Job 1,6,5,2,6,0,8,12,4,2,4,1,6246,6280,16
Task 6247,Job 0,10,7,2,9,1,12,19,7,2,4,1,6247,6281,14
Task 6247,Job 1,15,7,3,11,0,18,26,8,3,1,1,6247,6281,15
Task 6248,Job 0,2,8,2,11,0,4,13,9,2,3,2,6248,6281,6
Task 6248,Job 1,7,4,3,12,0,10,19,9,3,3,1,6248,6281,10
Task 6249,Job 0,3,5,2,6,0,5,9,4,2,1,1,6249,6282,11
Task 6249,Job 1,8,10,1,7,0,9,15,6,1,4,1,6249,6282,11
Task 6250,Job 0,1,4,1,11,0,2,12,10,1,4,0,6250,6283,3
Task 6250,Job 1,6,8,1,11,0,7,17,10,1,1,0,6250,6283,20
Task 6251,Job 0,4,8,3,12,1,7,16,9,3,2,0,6251,6285,4
Task 6251,Job 1,9,7,3,11,1,12,20,8,3,3,2,6251,6285,8
Task 6252,Job 0,6,6,4,12,0,10,18,8,4,4,1,6252,6286,8
Task 6252,Job 1,11,5,2,6,0,13,17,4,2,4,1,6252,6286,16
Task 6253,Job 0,2,6,1,12,0,3,14,11,1,1,1,6253,6286,9
Task 6253,Job 1,7,4,1,8,0,8,15,7,1,3,1,6253,6286,19
Task 6254,Job 0,3,7,2,7,0,5,10,5,2,1,1,6254,6288,7
Task 6254,Job 1,8,7,1,12,1,9,20,11,1,2,1,6254,6288,16
Task 6255,Job 0,5,6,2,11,0,7,16,9,2,4,2,6255,6288,13
Task 6255,Job 1,10,10,1,10,0,11,20,9,1,2,1,6255,6288,12
Task 6256,Job 0,2,7,4,11,0,6,13,7,4,1,1,6256,6290,12
Task 6256,Job 1,7,9,4,6,0,11,13,2,4,2,1,6256,6290,4
Task 6257,Job 0,3,7,3,6,0,6,9,3,3,4,2,6257,6290,8
Task 6257,Job 1,8,5,4,7,1,12,15,3,4,4,0,6257,6290,7
Task 6258,Job 0,7,8,4,8,0,11,15,4,4,4,0,6258,6292,17
Task 6258,Job 1,12,7,3,10,0,15,22,7,3,2,1,6258,6292,15
Task 6259,Job 0,9,5,4,11,1,13,20,7,4,2,2,6259,6293,12
Task 6259,Job 1,14,8,2,12,0,16,26,10,2,2,2,6259,6293,8
Task 6260,Job 0,10,7,4,7,0,14,17,3,4,4,2,6260,6293,3
Task 6260,Job 1,15,6,3,10,0,18,25,7,3,1,1,6260,6293,7
Task 6261,Job 0,1,5,2,10,0,3,11,8,2,4,2,6261,6294,8
Task 6261,Job 1,6,6,2,10,0,8,16,8,2,2,0,6261,6294,5
Task 6262,Job 0,4,9,4,11,0,8,15,7,4,1,1,6262,6296,11
Task 6262,Job 1,9,6,2,9,1,11,18,7,2,4,2,6262,6296,20
Task 6263,Job 0,1,5,4,12,0,5,13,8,4,4,0,6263,6296,3
Task 6263,Job 1,6,5,1,10,0,7,16,9,1,4,2,6263,6296,14
Task 6264,Job 0,2,6,2,12,0,4,14,10,2,4,2,6264,6298,15
Task 6264,Job 1,7,8,1,11,0,8,18,10,1,2,2,6264,6298,13
Task 6265,Job 0,3,10,2,9,1,5,12,7,2,2,0,6265,6298,5
Task 6265,Job 1,8,5,3,6,0,11,14,3,3,2,0,6265,6298,8
Task 6266,Job 0,4,8,3,10,0,7,14,7,3,4,1,6266,6300,4
Task 6266,Job 1,9,7,2,6,0,11,15,4,2,2,2,6266,6300,18
Task 6267,Job 0,10,10,2,9,0,12,19,7,2,3,0,6267,6301,13
Task 6267,Job 1,15,5,3,10,0,18,25,7,3,3,0,6267,6301,3
Task 6268,Job 0,2,10,2,9,0,4,11,7,2,2,2,6268,6302,8
Task 6268,Job 1,7,8,4,10,1,11,17,6,4,1,1,6268,6302,13
Task 6269,Job 0,3,8,3,6,0,6,9,3,3,2,2,6269,6303,14
Task 6269,Job 1,8,8,4,7,0,12,15,3,4,2,1,6269,6303,9
Task 6270,Job 0,6,5,3,8,0,9,14,5,3,2,1,6270,6304,20
Task 6270,Job 1,11,9,1,8,0,12,19,7,1,1,0,6270,6304,8
Task 6271,Job 0,2,10,4,12,1,6,14,8,4,4,0,6271,6304,17
Task 6271,Job 1,7,10,4,11,0,11,18,7,4,2,1,6271,6304,7
Task 6272,Job 0,6,4,1,7,0,7,13,6,1,4,1,6272,6306,2
Task 6272,Job 1,11,10,4,7,0,15,18,3,4,4,1,6272,6306,15
Task 6273,Job 0,2,8,3,6,0,5,8,3,3,3,1,6273,6306,3
Task 6273,Job 1,7,10,2,11,0,9,18,9,2,2,1,6273,6306,9
Task 6274,Job 0,10,4,2,10,0,12,20,8,2,1,0,6274,6308,18
Task 6274,Job 1,15,8,4,10,0,19,25,6,4,1,2,6274,6308,9
Task 6275,Job 0,4,6,3,10,0,7,14,7,3,1,0,6275,6309,13
Task 6275,Job 1,9,6,1,12,0,10,21,11,1,2,2,6275,6309,16
Task 6276,Job 0,9,4,3,10,0,12,19,7,3,2,0,6276,6310,11
Task 6276,Job 1,14,8,3,7,0,17,21,4,3,1,1,6276,6310,20
Task 6277,Job 0,6,7,4,11,0,10,17,7,4,1,2,6277,6311,18
Task 6277,Job 1,11,7,2,6,1,13,17,4,2,3,2,6277,6311,12
Task 6278,Job 0,2,9,4,8,0,6,10,4,4,4,0,6278,6311,13
Task 6278,Job 1,7,9,1,10,0,8,17,9,1,4,1,6278,6311,7
Task 6279,Job 0,5,5,1,12,0,6,17,11,1,3,1,6279,6313,19
Task 6279,Job 1,10,8,4,8,1,14,18,4,4,1,0,6279,6313,4
Task 6280,Job 0,5,6,1,8,0,6,13,7,1,1,2,6280,6314,8
Task 6280,Job 1,10,4,4,9,0,14,19,5,4,4,0,6280,6314,6
Task 6281,Job 0,4,6,1,10,0,5,14,9,1,3,2,6281,6315,13
Task 6281,Job 1,9,4,3,9,0,12,18,6,3,2,1,6281,6315,6
Task 6282,Job 0,3,6,4,10,0,7,13,6,4,1,0,6282,6315,7
Task 6282,Job 1,8,10,3,7,1,11,15,4,3,3,1,6282,6315,11
Task 6283,Job 0,2,10,1,10,1,3,12,9,1,1,0,6283,6317,5
Task 6283,Job 1,7,6,3,7,0,10,14,4,3,3,2,6283,6317,9
Task 6284,Job 0,9,6,2,8,0,11,17,6,2,2,0,6284,6317,9
Task 6284,Job 1,14,10,2,11,0,16,25,9,2,1,1,6284,6317,16
Task 6285,Job 0,8,10,1,6,1,9,14,5,1,2,2,6285,6318,19
Task 6285,Job 1,13,10,3,6,0,16,19,3,3,2,0,6285,6318,13
Task 6286,Job 0,10,5,4,12,0,14,22,8,4,1,2,6286,6319,9
Task 6286,Job 1,15,4,2,12,0,17,27,10,2,3,0,6286,6319,10
Task 6287,Job 0,4,4,2,12,0,6,16,10,2,4,2,6287,6321,7
Task 6287,Job 1,9,10,2,7,0,11,16,5,2,3,2,6287,6321,14
Task 6288,Job 0,3,10,4,12,1,7,15,8,4,4,1,6288,6322,13
Task 6288,Job 1,8,5,3,11,0,11,19,8,3,1,2,6288,6322,17
Task 6289,Job 0,8,10,1,11,0,9,19,10,1,3,1,6289,6322,3
Task 6289,Job 1,13,4,4,11,0,17,24,7,4,3,2,6289,6322,18
Task 6290,Job 0,6,7,2,12,0,8,18,10,2,3,1,6290,6323,17
Task 6290,Job 1,11,8,4,8,0,15,19,4,4,2,2,6290,6323,8
Task 6291,Job 0,3,8,1,12,0,4,15,11,1,1,2,6291,6324,17
Task 6291,Job 1,8,9,2,8,0,10,16,6,2,3,0,6291,6324,19
Task 6292,Job 0,7,10,3,9,0,10,16,6,3,3,0,6292,6325,18
Task 6292,Job 1,12,5,3,8,0,15,20,5,3,1,2,6292,6325,6
Task 6293,Job 0,1,8,1,9,1,2,10,8,1,4,2,6293,6327,15
Task 6293,Job 1,6,5,2,8,0,8,14,6,2,2,0,6293,6327,13
Task 6294,Job 0,2,5,3,11,1,5,13,8,3,2,1,6294,6328,8
Task 6294,Job 1,7,8,4,7,0,11,14,3,4,3,1,6294,6328,18
Task 6295,Job 0,10,10,3,12,1,13,22,9,3,4,2,6295,6328,18
Task 6295,Job 1,15,10,1,11,0,16,26,10,1,1,1,6295,6328,2
Task 6296,Job 0,2,10,2,9,0,4,11,7,2,2,2,6296,6329,7
Task 6296,Job 1,7,8,1,7,1,8,14,6,1,1,2,6296,6329,13
Task 6297,Job 0,10,9,1,9,0,11,19,8,1,3,1,6297,6331,12
Task 6297,Job 1,15,4,1,12,0,16,27,11,1,3,0,6297,6331,4
Task 6298,Job 0,7,5,2,12,0,9,19,10,2,4,0,6298,6332,7
Task 6298,Job 1,12,10,3,10,0,15,22,7,3,4,0,6298,6332,5
Task 6299,Job 0,5,8,1,7,0,6,12,6,1,1,0,6299,6333,9
Task 6299,Job 1,10,4,1,12,0,11,22,11,1,2,0,6299,6333,5
Task 6300,Job 0,10,7,2,10,1,12,20,8,2,3,2,6300,6333,14
Task 6300,Job 1,15,5,3,8,0,18,23,5,3,2,0,6300,6333,19
Task 6301,Job 0,6,7,1,7,1,7,13,6,1,2,1,6301,6334,8
Task 6301,Job 1,11,5,3,9,0,14,20,6,3,1,2,6301,6334,14
Task 6302,Job 0,2,10,3,7,0,5,9,4,3,1,1,6302,6336,7
Task 6302,Job 1,7,6,4,8,0,11,15,4,4,3,2,6302,6336,18
Task 6303,Job 0,10,8,4,8,0,14,18,4,4,2,0,6303,6336,13
Task 6303,Job 1,15,9,2,12,1,17,27,10,2,2,2,6303,6336,17
Task 6304,Job 0,3,7,3,7,0,6,10,4,3,4,0,6304,6337,4
Task 6304,Job 1,8,4,1,7,0,9,15,6,1,3,0,6304,6337,17
Task 6305,Job 0,7,9,1,6,0,8,13,5,1,4,2,6305,6338,17
Task 6305,Job 1,12,8,1,6,0,13,18,5,1,3,0,6305,6338,2
Task 6306,Job 0,1,10,2,8,1,3,9,6,2,4,1,6306,6339,6
Task 6306,Job 1,6,4,4,10,0,10,16,6,4,4,0,6306,6339,16
Task 6307,Job 0,10,9,1,7,1,11,17,6,1,1,2,6307,6340,2
Task 6307,Job 1,15,7,1,12,0,16,27,11,1,2,1,6307,6340,9
Task 6308,Job 0,9,7,4,10,0,13,19,6,4,3,0,6308,6342,15
Task 6308,Job 1,14,5,2,7,0,16,21,5,2,2,1,6308,6342,11
Task 6309,Job 0,4,4,2,10,0,6,14,8,2,4,1,6309,6342,14
Task 6309,Job 1,9,8,4,9,1,13,18,5,4,1,1,6309,6342,12
Task 6310,Job 0,10,4,3,7,0,13,17,4,3,1,1,6310,6343,3
Task 6310,Job 1,15,6,2,12,0,17,27,10,2,4,0,6310,6343,17
Task 6311,Job 0,6,5,3,12,0,9,18,9,3,2,1,6311,6344,18
Task 6311,Job 1,11,10,2,10,0,13,21,8,2,4,2,6311,6344,12
Task 6312,Job 0,2,8,1,7,0,3,9,6,1,3,1,6312,6346,17
Task 6312,Job 1,7,7,3,7,0,10,14,4,3,3,2,6312,6346,16
Task 6313,Job 0,5,6,4,9,1,9,14,5,4,3,1,6313,6346,19
Task 6313,Job 1,10,5,1,10,0,11,20,9,1,2,2,6313,6346,15
Task 6314,Job 0,5,9,2,10,1,7,15,8,2,2,1,6314,6348,16
Task 6314,Job 1,10,9,4,7,0,14,17,3,4,3,2,6314,6348,9
Task 6315,Job 0,6,9,2,10,0,8,16,8,2,1,0,6315,6349,7
Task 6315,Job 1,11,6,2,8,0,13,19,6,2,2,0,6315,6349,2
Task 6316,Job 0,7,8,4,10,0,11,17,6,4,4,2,6316,6350,10
Task 6316,Job 1,12,10,2,7,0,14,19,5,2,1,0,6316,6350,20
Task 6317,Job 0,4,5,3,12,1,7,16,9,3,4,0,6317,6350,7
Task 6317,Job 1,9,10,1,11,1,10,20,10,1,4,2,6317,6350,3
Task 6318,Job 0,6,6,1,10,1,7,16,9,1,2,2,6318,6352,5
Task 6318,Job 1,11,6,2,7,1,13,18,5,2,3,1,6318,6352,5
Task 6319,Job 0,3,10,1,12,0,4,15,11,1,3,1,6319,6353,19
Task 6319,Job 1,8,9,3,6,0,11,14,3,3,2,2,6319,6353,15
Task 6320,Job 0,5,8,2,11,0,7,16,9,2,2,1,6320,6354,12
Task 6320,Job 1,10,10,3,11,0,13,21,8,3,1,2,6320,6354,18
Task 6321,Job 0,4,9,3,10,0,7,14,7,3,4,0,6321,6354,10
Task 6321,Job 1,9,9,3,6,0,12,15,3,3,2,0,6321,6354,5
Task 6322,Job 0,2,4,3,12,0,5,14,9,3,3,0,6322,6356,5
Task 6322,Job 1,7,7,1,10,1,8,17,9,1,1,1,6322,6356,4
Task 6323,Job 0,5,4,4,6,0,9,11,2,4,4,2,6323,6357,15
Task 6323,Job 1,10,5,1,6,1,11,16,5,1,4,2,6323,6357,4
Task 6324,Job 0,6,8,1,11,0,7,17,10,1,4,1,6324,6357,12
Task 6324,Job 1,11,7,2,9,1,13,20,7,2,4,0,6324,6357,13
Task 6325,Job 0,5,10,4,10,1,9,15,6,4,2,0,6325,6358,16
Task 6325,Job 1,10,10,3,7,0,13,17,4,3,1,2,6325,6358,13
Task 6326,Job 0,9,5,3,11,1,12,20,8,3,4,0,6326,6359,7
Task 6326,Job 1,14,9,4,7,0,18,21,3,4,4,1,6326,6359,19
Task 6327,Job 0,1,8,4,8,0,5,9,4,4,1,2,6327,6361,11
Task 6327,Job 1,6,8,4,6,0,10,12,2,4,1,0,6327,6361,17
Task 6328,Job 0,8,6,2,11,0,10,19,9,2,4,2,6328,6362,16
Task 6328,Job 1,13,9,1,6,1,14,19,5,1,4,2,6328,6362,6
Task 6329,Job 0,6,9,1,11,0,7,17,10,1,1,1,6329,6363,11
Task 6329,Job 1,11,5,4,12,0,15,23,8,4,1,0,6329,6363,7
Task 6330,Job 0,7,4,3,12,0,10,19,9,3,1,1,6330,6363,18
Task 6330,Job 1,12,10,1,10,0,13,22,9,1,1,2,6330,6363,6
Task 6331,Job 0,6,5,4,11,0,10,17,7,4,3,2,6331,6364,3
Task 6331,Job 1,11,8,1,9,1,12,20,8,1,1,1,6331,6364,13
Task 6332,Job 0,7,7,1,8,0,8,15,7,1,3,1,6332,6365,17
Task 6332,Job 1,12,8,4,6,0,16,18,2,4,2,0,6332,6365,16
Task 6333,Job 0,4,9,2,8,0,6,12,6,2,2,0,6333,6367,14
Task 6333,Job 1,9,5,4,12,0,13,21,8,4,2,1,6333,6367,6
Task 6334,Job 0,2,6,2,12,0,4,14,10,2,1,2,6334,6368,8
Task 6334,Job 1,7,4,2,9,1,9,16,7,2,1,0,6334,6368,16
Task 6335,Job 0,5,8,1,12,1,6,17,11,1,4,2,6335,6369,4
Task 6335,Job 1,10,8,4,12,0,14,22,8,4,1,2,6335,6369,4
Task 6336,Job 0,6,10,4,12,0,10,18,8,4,1,0,6336,6370,11
Task 6336,Job 1,11,6,4,12,1,15,23,8,4,2,2,6336,6370,18
Task 6337,Job 0,6,5,3,8,0,9,14,5,3,4,1,6337,6371,2
Task 6337,Job 1,11,7,2,8,1,13,19,6,2,2,2,6337,6371,10
Task 6338,Job 0,5,6,2,7,0,7,12,5,2,4,1,6338,6372,20
Task 6338,Job 1,10,7,4,10,0,14,20,6,4,1,2,6338,6372,4
Task 6339,Job 0,3,6,1,10,1,4,13,9,1,3,2,6339,6373,14
Task 6339,Job 1,8,10,1,6,0,9,14,5,1,3,0,6339,6373,20
Task 6340,Job 0,3,6,1,6,0,4,9,5,1,4,2,6340,6374,14
Task 6340,Job 1,8,4,4,11,0,12,19,7,4,1,2,6340,6374,10
Task 6341,Job 0,4,7,1,9,0,5,13,8,1,4,2,6341,6375,13
Task 6341,Job 1,9,4,4,8,1,13,17,4,4,2,1,6341,6375,13
Task 6342,Job 0,8,8,3,7,0,11,15,4,3,3,2,6342,6375,14
Task 6342,Job 1,13,6,1,7,0,14,20,6,1,2,1,6342,6375,16
Task 6343,Job 0,1,10,1,12,0,2,13,11,1,4,0,6343,6376,12
Task 6343,Job 1,6,8,3,10,0,9,16,7,3,2,2,6343,6376,14
Task 6344,Job 0,2,4,4,7,1,6,9,3,4,4,0,6344,6377,10
Task 6344,Job 1,7,8,1,6,0,8,13,5,1,4,2,6344,6377,14
Task 6345,Job 0,2,4,1,8,0,3,10,7,1,4,0,6345,6378,16
Task 6345,Job 1,7,5,3,6,0,10,13,3,3,3,0,6345,6378,8
Task 6346,Job 0,3,10,4,11,0,7,14,7,4,2,0,6346,6380,19
Task 6346,Job 1,8,10,3,8,1,11,16,5,3,4,0,6346,6380,11
Task 6347,Job 0,3,10,3,9,0,6,12,6,3,4,0,6347,6381,8
Task 6347,Job 1,8,6,1,10,0,9,18,9,1,3,0,6347,6381,17
Task 6348,Job 0,3,10,3,7,1,6,10,4,3,2,1,6348,6381,17
Task 6348,Job 1,8,9,2,11,1,10,19,9,2,3,1,6348,6381,3
Task 6349,Job 0,4,8,2,7,0,6,11,5,2,3,0,6349,6382,14
Task 6349,Job 1,9,8,4,7,1,13,16,3,4,1,2,6349,6382,2
Task 6350,Job 0,5,4,3,8,0,8,13,5,3,3,1,6350,6383,15
Task 6350,Job 1,10,5,1,9,0,11,19,8,1,2,1,6350,6383,19
Task 6351,Job 0,5,9,2,12,1,7,17,10,2,3,2,6351,6384,19
Task 6351,Job 1,10,10,2,12,0,12,22,10,2,3,0,6351,6384,5
Task 6352,Job 0,1,5,2,8,0,3,9,6,2,4,2,6352,6385,16
Task 6352,Job 1,6,8,1,11,0,7,17,10,1,3,2,6352,6385,14
Task 6353,Job 0,1,9,2,12,0,3,13,10,2,3,2,6353,6386,3
Task 6353,Job 1,6,6,2,12,0,8,18,10,2,3,0,6353,6386,17
Task 6354,Job 0,3,10,4,12,0,7,15,8,4,2,2,6354,6387,7
Task 6354,Job 1,8,7,3,9,0,11,17,6,3,3,2,6354,6387,13
Task 6355,Job 0,9,4,2,8,0,11,17,6,2,2,0,6355,6389,10
Task 6355,Job 1,14,5,1,6,0,15,20,5,1,2,0,6355,6389,19
Task 6356,Job 0,10,5,4,12,0,14,22,8,4,4,0,6356,6389,6
Task 6356,Job 1,15,5,3,12,0,18,27,9,3,1,2,6356,6389,6
Task 6357,Job 0,2,5,2,12,0,4,14,10,2,2,2,6357,6391,20
Task 6357,Job 1,7,7,3,6,0,10,13,3,3,1,1,6357,6391,17
Task 6358,Job 0,4,4,2,8,1,6,12,6,2,4,2,6358,6391,13
Task 6358,Job 1,9,10,4,6,0,13,15,2,4,3,2,6358,6391,8
Task 6359,Job 0,5,10,1,10,0,6,15,9,1,4,0,6359,6393,18
Task 6359,Job 1,10,6,3,6,0,13,16,3,3,4,1,6359,6393,20
Task 6360,Job 0,8,5,1,6,0,9,14,5,1,1,2,6360,6393,10
Task 6360,Job 1,13,8,1,10,0,14,23,9,1,4,0,6360,6393,9
Task 6361,Job 0,8,10,1,8,0,9,16,7,1,4,2,6361,6395,12
Task 6361,Job 1,13,9,1,7,0,14,20,6,1,1,2,6361,6395,3
Task 6362,Job 0,4,10,4,9,0,8,13,5,4,2,2,6362,6395,11
Task 6362,Job 1,9,7,2,10,0,11,19,8,2,4,2,6362,6395,13
Task 6363,Job 0,4,9,1,7,1,5,11,6,1,2,0,6363,6396,16
Task 6363,Job 1,9,4,2,8,0,11,17,6,2,2,0,6363,6396,20
Task 6364,Job 0,6,9,1,12,0,7,18,11,1,1,1,6364,6397,12
Task 6364,Job 1,11,4,3,10,0,14,21,7,3,4,1,6364,6397,15
Task 6365,Job 0,6,10,2,12,1,8,18,10,2,2,1,6365,6398,5
Task 6365,Job 1,11,10,1,6,0,12,17,5,1,1,1,6365,6398,19
Task 6366,Job 0,5,7,1,9,0,6,14,8,1,4,1,6366,6400,11
Task 6366,Job 1,10,9,1,12,1,11,22,11,1,3,2,6366,6400,12
Task 6367,Job 0,8,4,3,7,1,11,15,4,3,4,0,6367,6400,6
Task 6367,Job 1,13,5,4,8,0,17,21,4,4,3,1,6367,6400,7
Task 6368,Job 0,2,10,3,7,0,5,9,4,3,4,1,6368,6401,16
Task 6368,Job 1,7,9,3,11,0,10,18,8,3,4,2,6368,6401,3
Task 6369,Job 0,9,8,4,11,0,13,20,7,4,4,1,6369,6403,8
Task 6369,Job 1,14,5,2,10,0,16,24,8,2,1,0,6369,6403,16
Task 6370,Job 0,7,7,3,7,1,10,14,4,3,3,0,6370,6403,13
Task 6370,Job 1,12,5,3,8,0,15,20,5,3,1,1,6370,6403,19
Task 6371,Job 0,7,6,2,10,0,9,17,8,2,2,1,6371,6404,10
Task 6371,Job 1,12,8,3,6,0,15,18,3,3,4,2,6371,6404,4
Task 6372,Job 0,10,5,2,10,0,12,20,8,2,1,1,6372,6406,18
Task 6372,Job 1,15,9,1,10,0,16,25,9,1,4,1,6372,6406,16
Task 6373,Job 0,7,6,2,10,0,9,17,8,2,4,0,6373,6407,4
Task 6373,Job 1,12,4,4,7,0,16,19,3,4,1,1,6373,6407,13
Task 6374,Job 0,6,9,3,10,1,9,16,7,3,3,0,6374,6408,5
Task 6374,Job 1,11,10,1,10,0,12,21,9,1,2,0,6374,6408,12
Task 6375,Job 0,6,10,3,10,0,9,16,7,3,1,0,6375,6408,5
Task 6375,Job 1,11,5,1,6,0,12,17,5,1,3,0,6375,6408,6
Task 6376,Job 0,10,9,2,11,0,12,21,9,2,2,0,6376,6409,7
Task 6376,Job 1,15,8,1,12,0,16,27,11,1,3,2,6376,6409,2
Task 6377,Job 0,9,6,2,7,0,11,16,5,2,1,0,6377,6410,12
Task 6377,Job 1,14,5,2,12,0,16,26,10,2,2,2,6377,6410,6
Task 6378,Job 0,7,5,4,8,0,11,15,4,4,2,1,6378,6411,19
Task 6378,Job 1,12,6,1,7,0,13,19,6,1,1,2,6378,6411,2
Task 6379,Job 0,2,6,4,7,0,6,9,3,4,4,0,6379,6413,12
Task 6379,Job 1,7,5,1,10,0,8,17,9,1,2,0,6379,6413,8
Task 6380,Job 0,4,9,2,10,1,6,14,8,2,4,0,6380,6413,19
Task 6380,Job 1,9,4,1,12,1,10,21,11,1,4,2,6380,6413,18
Task 6381,Job 0,10,4,1,7,0,11,17,6,1,1,2,6381,6414,20
Task 6381,Job 1,15,7,4,9,0,19,24,5,4,4,1,6381,6414,2
Task 6382,Job 0,9,10,1,10,0,10,19,9,1,3,1,6382,6415,6
Task 6382,Job 1,14,8,3,9,0,17,23,6,3,2,2,6382,6415,5
Task 6383,Job 0,8,4,1,6,0,9,14,5,1,2,2,6383,6417,2
Task 6383,Job 1,13,7,2,9,0,15,22,7,2,1,2,6383,6417,10
Task 6384,Job 0,3,4,2,7,0,5,10,5,2,2,0,6384,6418,13
Task 6384,Job 1,8,4,2,6,1,10,14,4,2,4,1,6384,6418,4
Task 6385,Job 0,1,7,2,11,0,3,12,9,2,3,1,6385,6419,12
Task 6385,Job 1,6,5,3,7,0,9,13,4,3,3,1,6385,6419,10
Task 6386,Job 0,8,6,1,7,1,9,15,6,1,1,1,6386,6419,11
Task 6386,Job 1,13,9,2,11,1,15,24,9,2,1,0,6386,6419,15
Task 6387,Job 0,1,9,1,12,1,2,13,11,1,2,1,6387,6420,2
Task 6387,Job 1,6,4,2,12,0,8,18,10,2,2,1,6387,6420,5
Task 6388,Job 0,1,9,3,12,1,4,13,9,3,1,0,6388,6422,7
Task 6388,Job 1,6,7,1,7,0,7,13,6,1,1,0,6388,6422,13
Task 6389,Job 0,5,8,2,12,0,7,17,10,2,2,0,6389,6423,4
Task 6389,Job 1,10,10,3,8,0,13,18,5,3,3,1,6389,6423,13
Task 6390,Job 0,8,8,1,7,0,9,15,6,1,1,2,6390,6423,18
Task 6390,Job 1,13,10,2,6,0,15,19,4,2,3,0,6390,6423,5
Task 6391,Job 0,5,4,3,7,0,8,12,4,3,1,1,6391,6424,14
Task 6391,Job 1,10,10,3,11,1,13,21,8,3,1,2,6391,6424,10
Task 6392,Job 0,9,10,3,9,0,12,18,6,3,3,0,6392,6426,8
Task 6392,Job 1,14,5,1,10,0,15,24,9,1,2,0,6392,6426,15
Task 6393,Job 0,9,8,4,6,0,13,15,2,4,2,0,6393,6426,14
Task 6393,Job 1,14,7,1,9,0,15,23,8,1,1,0,6393,6426,17
Task 6394,Job 0,3,6,2,6,1,5,9,4,2,2,1,6394,6427,5
Task 6394,Job 1,8,4,4,6,0,12,14,2,4,1,2,6394,6427,4
Task 6395,Job 0,10,5,3,7,0,13,17,4,3,4,0,6395,6429,7
Task 6395,Job 1,15,7,4,11,0,19,26,7,4,4,0,6395,6429,13
Task 6396,Job 0,1,5,2,6,1,3,7,4,2,3,2,6396,6429,2
Task 6396,Job 1,6,10,2,12,0,8,18,10,2,3,0,6396,6429,19
Task 6397,Job 0,9,5,3,10,0,12,19,7,3,1,1,6397,6430,4
Task 6397,Job 1,14,4,3,8,1,17,22,5,3,4,0,6397,6430,3
Task 6398,Job 0,10,7,3,9,0,13,19,6,3,1,1,6398,6431,5
Task 6398,Job 1,15,5,2,9,0,17,24,7,2,1,1,6398,6431,2
Task 6399,Job 0,6,10,1,8,0,7,14,7,1,2,0,6399,6433,11
Task 6399,Job 1,11,4,3,9,1,14,20,6,3,2,1,6399,6433,3
Task 6400,Job 0,2,9,3,7,0,5,9,4,3,2,2,6400,6433,3
Task 6400,Job 1,7,9,2,7,0,9,14,5,2,1,1,6400,6433,4
Task 6401,Job 0,6,4,3,11,0,9,17,8,3,4,2,6401,6435,5
Task 6401,Job 1,11,10,2,11,1,13,22,9,2,4,0,6401,6435,20
Task 6402,Job 0,2,5,1,9,1,3,11,8,1,3,0,6402,6436,15
Task 6402,Job 1,7,8,3,12,0,10,19,9,3,2,1,6402,6436,14
Task 6403,Job 0,8,8,1,10,0,9,18,9,1,3,0,6403,6437,5
Task 6403,Job 1,13,7,2,12,0,15,25,10,2,2,0,6403,6437,5
Task 6404,Job 0,2,5,1,11,1,3,13,10,1,1,2,6404,6438,10
Task 6404,Job 1,7,9,1,7,0,8,14,6,1,1,2,6404,6438,9
Task 6405,Job 0,7,7,1,10,1,8,17,9,1,2,2,6405,6438,9
Task 6405,Job 1,12,7,3,7,0,15,19,4,3,4,2,6405,6438,9
Task 6406,Job 0,10,10,3,10,0,13,20,7,3,1,0,6406,6440,3
Task 6406,Job 1,15,5,4,10,0,19,25,6,4,2,0,6406,6440,14
Task 6407,Job 0,1,8,3,7,0,4,8,4,3,1,2,6407,6441,11
Task 6407,Job 1,6,7,3,12,1,9,18,9,3,1,2,6407,6441,9
Task 6408,Job 0,7,5,2,8,0,9,15,6,2,2,1,6408,6441,16
Task 6408,Job 1,12,4,3,12,1,15,24,9,3,1,1,6408,6441,15
Task 6409,Job 0,7,4,4,11,0,11,18,7,4,4,1,6409,6443,15
Task 6409,Job 1,12,7,1,9,0,13,21,8,1,3,1,6409,6443,16
Task 6410,Job 0,3,10,4,11,0,7,14,7,4,3,1,6410,6444,12
Task 6410,Job 1,8,5,4,6,0,12,14,2,4,4,1,6410,6444,19
Task 6411,Job 0,10,7,3,7,0,13,17,4,3,1,2,6411,6445,17
Task 6411,Job 1,15,9,1,11,1,16,26,10,1,4,2,6411,6445,14
Task 6412,Job 0,9,5,1,6,1,10,15,5,1,3,0,6412,6446,16
Task 6412,Job 1,14,5,4,7,1,18,21,3,4,1,0,6412,6446,3
Task 6413,Job 0,10,10,1,6,0,11,16,5,1,4,1,6413,6446,8
Task 6413,Job 1,15,6,2,8,1,17,23,6,2,2,2,6413,6446,13
Task 6414,Job 0,3,9,3,12,0,6,15,9,3,4,2,6414,6447,16
Task 6414,Job 1,8,8,1,12,0,9,20,11,1,2,2,6414,6447,12
Task 6415,Job 0,5,9,4,12,0,9,17,8,4,3,2,6415,6448,9
Task 6415,Job 1,10,6,1,12,0,11,22,11,1,4,2,6415,6448,15
Task 6416,Job 0,7,6,1,6,1,8,13,5,1,4,2,6416,6450,18
Task 6416,Job 1,12,7,3,12,0,15,24,9,3,3,2,6416,6450,3
Task 6417,Job 0,7,6,1,6,0,8,13,5,1,3,2,6417,6451,12
Task 6417,Job 1,12,5,4,11,1,16,23,7,4,1,2,6417,6451,8
Task 6418,Job 0,3,4,4,9,0,7,12,5,4,2,1,6418,6452,2
Task 6418,Job 1,8,10,1,11,0,9,19,10,1,1,2,6418,6452,20
Task 6419,Job 0,1,4,4,9,0,5,10,5,4,3,2,6419,6453,18
Task 6419,Job 1,6,5,1,6,1,7,12,5,1,1,1,6419,6453,12
Task 6420,Job 0,1,9,4,8,0,5,9,4,4,2,0,6420,6453,3
Task 6420,Job 1,6,7,1,7,1,7,13,6,1,4,1,6420,6453,20
Task 6421,Job 0,9,8,4,7,1,13,16,3,4,4,0,6421,6455,4
Task 6421,Job 1,14,4,4,7,1,18,21,3,4,2,1,6421,6455,3
Task 6422,Job 0,2,9,3,11,0,5,13,8,3,3,1,6422,6455,15
Task 6422,Job 1,7,5,4,9,1,11,16,5,4,2,2,6422,6455,2
Task 6423,Job 0,1,9,1,6,0,2,7,5,1,2,0,6423,6456,2
Task 6423,Job 1,6,9,1,12,1,7,18,11,1,1,2,6423,6456,17
Task 6424,Job 0,4,6,4,7,0,8,11,3,4,2,0,6424,6458,6
Task 6424,Job 1,9,6,1,6,0,10,15,5,1,4,2,6424,6458,18
Task 6425,Job 0,4,4,1,12,0,5,16,11,1,4,0,6425,6458,19
Task 6425,Job 1,9,5,1,10,0,10,19,9,1,4,0,6425,6458,9
Task 6426,Job 0,1,4,2,9,0,3,10,7,2,3,0,6426,6459,14
Task 6426,Job 1,6,4,2,11,0,8,17,9,2,1,0,6426,6459,5
Task 6427,Job 0,4,8,3,11,1,7,15,8,3,4,2,6427,6461,12
Task 6427,Job 1,9,5,4,7,0,13,16,3,4,2,0,6427,6461,8
Task 6428,Job 0,2,6,4,7,0,6,9,3,4,2,2,6428,6462,14
Task 6428,Job 1,7,9,3,12,1,10,19,9,3,3,1,6428,6462,13
Task 6429,Job 0,5,7,2,9,0,7,14,7,2,4,0,6429,6463,11
Task 6429,Job 1,10,10,3,6,0,13,16,3,3,2,1,6429,6463,3
Task 6430,Job 0,7,7,3,11,0,10,18,8,3,2,0,6430,6464,3
Task 6430,Job 1,12,8,2,12,1,14,24,10,2,1,2,6430,6464,10
Task 6431,Job 0,8,5,4,10,0,12,18,6,4,2,1,6431,6464,15
Task 6431,Job 1,13,8,1,9,1,14,22,8,1,1,0,6431,6464,5
Task 6432,Job 0,1,7,2,7,0,3,8,5,2,2,2,6432,6466,8
Task 6432,Job 1,6,7,4,9,0,10,15,5,4,1,0,6432,6466,17
Task 6433,Job 0,2,10,4,8,0,6,10,4,4,4,0,6433,6467,8
Task 6433,Job 1,7,7,4,11,0,11,18,7,4,1,0,6433,6467,8
Task 6434,Job 0,2,9,4,6,1,6,8,2,4,4,2,6434,6467,2
Task 6434,Job 1,7,7,1,8,0,8,15,7,1,3,2,6434,6467,13
Task 6435,Job 0,2,5,1,9,1,3,11,8,1,3,2,6435,6469,14
Task 6435,Job 1,7,7,1,6,0,8,13,5,1,1,0,6435,6469,4
Task 6436,Job 0,3,7,4,12,0,7,15,8,4,3,2,6436,6469,5
Task 6436,Job 1,8,9,1,10,0,9,18,9,1,3,1,6436,6469,20
Task 6437,Job 0,8,7,3,10,1,11,18,7,3,1,1,6437,6470,13
Task 6437,Job 1,13,4,1,12,0,14,25,11,1,1,2,6437,6470,6
Task 6438,Job 0,5,5,1,10,0,6,15,9,1,3,1,6438,6471,12
Task 6438,Job 1,10,9,2,8,0,12,18,6,2,2,2,6438,6471,3
Task 6439,Job 0,8,7,4,6,0,12,14,2,4,3,1,6439,6472,15
Task 6439,Job 1,13,8,2,10,0,15,23,8,2,2,0,6439,6472,12
Task 6440,Job 0,4,4,4,8,0,8,12,4,4,1,2,6440,6474,10
Task 6440,Job 1,9,8,2,10,1,11,19,8,2,3,2,6440,6474,20
Task 6441,Job 0,9,5,1,7,1,10,16,6,1,3,2,6441,6474,15
Task 6441,Job 1,14,10,1,6,0,15,20,5,1,3,2,6441,6474,20
Task 6442,Job 0,5,5,3,7,0,8,12,4,3,4,0,6442,6475,8
Task 6442,Job 1,10,5,3,6,0,13,16,3,3,3,0,6442,6475,5
Task 6443,Job 0,2,5,3,9,0,5,11,6,3,4,2,6443,6477,3
Task 6443,Job 1,7,9,2,11,0,9,18,9,2,4,0,6443,6477,16
Task 6444,Job 0,3,7,3,12,1,6,15,9,3,2,2,6444,6478,19
Task 6444,Job 1,8,4,1,10,1,9,18,9,1,3,2,6444,6478,18
Task 6445,Job 0,3,10,2,6,1,5,9,4,2,4,1,6445,6478,8
Task 6445,Job 1,8,4,3,6,0,11,14,3,3,1,2,6445,6478,12
Task 6446,Job 0,4,4,3,6,0,7,10,3,3,2,1,6446,6480,16
Task 6446,Job 1,9,6,4,8,0,13,17,4,4,3,0,6446,6480,2
Task 6447,Job 0,8,10,2,6,0,10,14,4,2,3,1,6447,6480,5
Task 6447,Job 1,13,6,2,8,0,15,21,6,2,2,1,6447,6480,5
Task 6448,Job 0,10,9,2,10,1,12,20,8,2,1,2,6448,6481,10
Task 6448,Job 1,15,6,2,9,0,17,24,7,2,3,0,6448,6481,14
Task 6449,Job 0,4,4,2,10,0,6,14,8,2,1,0,6449,6483,7
Task 6449,Job 1,9,6,3,7,0,12,16,4,3,2,2,6449,6483,10
Task 6450,Job 0,8,7,4,10,0,12,18,6,4,1,2,6450,6483,10
Task 6450,Job 1,13,8,3,12,0,16,25,9,3,3,2,6450,6483,17
Task 6451,Job 0,6,6,1,8,0,7,14,7,1,4,2,6451,6485,18
Task 6451,Job 1,11,9,2,11,0,13,22,9,2,2,2,6451,6485,14
Task 6452,Job 0,5,10,3,11,0,8,16,8,3,2,1,6452,6485,2
Task 6452,Job 1,10,6,4,12,1,14,22,8,4,2,2,6452,6485,3
Task 6453,Job 0,3,7,1,10,0,4,13,9,1,1,2,6453,6486,9
Task 6453,Job 1,8,7,4,10,0,12,18,6,4,3,1,6453,6486,6
Task 6454,Job 0,9,9,3,12,0,12,21,9,3,2,1,6454,6487,14
Task 6454,Job 1,14,8,2,10,1,16,24,8,2,4,2,6454,6487,2
Task 6455,Job 0,8,9,1,11,1,9,19,10,1,3,0,6455,6488,18
Task 6455,Job 1,13,7,4,6,0,17,19,2,4,3,0,6455,6488,11
Task 6456,Job 0,7,7,3,9,1,10,16,6,3,4,0,6456,6489,18
Task 6456,Job 1,12,8,1,11,0,13,23,10,1,3,0,6456,6489,9
Task 6457,Job 0,3,9,1,12,0,4,15,11,1,2,1,6457,6491,13
Task 6457,Job 1,8,7,1,7,0,9,15,6,1,2,1,6457,6491,10
Task 6458,Job 0,3,7,3,11,0,6,14,8,3,2,2,6458,6492,3
Task 6458,Job 1,8,4,1,11,0,9,19,10,1,1,1,6458,6492,14
Task 6459,Job 0,6,6,4,11,0,10,17,7,4,4,2,6459,6493,20
Task 6459,Job 1,11,8,4,9,0,15,20,5,4,1,0,6459,6493,5
Task 6460,Job 0,6,9,2,7,0,8,13,5,2,4,1,6460,6494,6
Task 6460,Job 1,11,10,2,8,1,13,19,6,2,3,2,6460,6494,4
Task 6461,Job 0,8,10,3,10,1,11,18,7,3,4,0,6461,6494,20
Task 6461,Job 1,13,6,2,12,0,15,25,10,2,2,1,6461,6494,20
Task 6462,Job 0,9,7,3,10,0,12,19,7,3,1,0,6462,6495,3
Task 6462,Job 1,14,9,2,12,0,16,26,10,2,1,2,6462,6495,3
Task 6463,Job 0,6,7,3,12,0,9,18,9,3,4,0,6463,6497,19
Task 6463,Job 1,11,7,4,6,0,15,17,2,4,3,1,6463,6497,12
Task 6464,Job 0,9,6,4,7,0,13,16,3,4,4,2,6464,6498,4
Task 6464,Job 1,14,10,2,8,0,16,22,6,2,1,1,6464,6498,17
Task 6465,Job 0,2,10,1,12,0,3,14,11,1,4,2,6465,6498,4
Task 6465,Job 1,7,6,2,9,1,9,16,7,2,3,1,6465,6498,6
Task 6466,Job 0,5,4,3,8,0,8,13,5,3,2,0,6466,6499,11
Task 6466,Job 1,10,7,3,8,0,13,18,5,3,4,1,6466,6499,16
Task 6467,Job 0,3,6,4,12,0,7,15,8,4,3,1,6467,6501,16
Task 6467,Job 1,8,6,3,7,0,11,15,4,3,3,1,6467,6501,3
Task 6468,Job 0,7,5,3,7,1,10,14,4,3,1,1,6468,6501,5
Task 6468,Job 1,12,8,3,9,0,15,21,6,3,4,2,6468,6501,13
Task 6469,Job 0,2,8,1,12,0,3,14,11,1,4,1,6469,6503,15
Task 6469,Job 1,7,7,4,8,0,11,15,4,4,1,1,6469,6503,18
Task 6470,Job 0,6,5,2,11,0,8,17,9,2,1,0,6470,6504,19
Task 6470,Job 1,11,9,2,7,0,13,18,5,2,3,1,6470,6504,7
Task 6471,Job 0,3,6,4,7,1,7,10,3,4,2,1,6471,6504,19
Task 6471,Job 1,8,7,3,9,0,11,17,6,3,1,0,6471,6504,19
Task 6472,Job 0,3,6,3,12,1,6,15,9,3,1,2,6472,6505,20
Task 6472,Job 1,8,8,1,9,0,9,17,8,1,4,0,6472,6505,12
Task 6473,Job 0,9,10,3,9,1,12,18,6,3,1,2,6473,6506,18
Task 6473,Job 1,14,5,4,8,1,18,22,4,4,2,2,6473,6506,16
Task 6474,Job 0,4,4,3,10,1,7,14,7,3,4,1,6474,6508,13
Task 6474,Job 1,9,9,4,6,0,13,15,2,4,1,2,6474,6508,2
Task 6475,Job 0,4,9,3,9,0,7,13,6,3,4,2,6475,6509,2
Task 6475,Job 1,9,6,2,9,0,11,18,7,2,1,1,6475,6509,20
Task 6476,Job 0,4,4,2,7,0,6,11,5,2,1,1,6476,6509,20
Task 6476,Job 1,9,8,2,7,0,11,16,5,2,1,0,6476,6509,2
Task 6477,Job 0,1,8,2,10,1,3,11,8,2,3,1,6477,6511,20
Task 6477,Job 1,6,9,1,8,0,7,14,7,1,3,0,6477,6511,19
Task 6478,Job 0,3,10,2,11,1,5,14,9,2,4,2,6478,6511,4
Task 6478,Job 1,8,6,3,7,0,11,15,4,3,4,1,6478,6511,10
Task 6479,Job 0,4,8,3,10,1,7,14,7,3,3,0,6479,6512,9
Task 6479,Job 1,9,8,1,12,0,10,21,11,1,4,2,6479,6512,12
Task 6480,Job 0,8,9,3,6,0,11,14,3,3,3,1,6480,6513,16
Task 6480,Job 1,13,7,4,12,0,17,25,8,4,3,1,6480,6513,18
Task 6481,Job 0,2,8,4,8,0,6,10,4,4,2,2,6481,6515,5
Task 6481,Job 1,7,10,1,10,0,8,17,9,1,2,1,6481,6515,8
Task 6482,Job 0,8,5,3,7,0,11,15,4,3,3,1,6482,6515,13
Task 6482,Job 1,13,10,2,10,0,15,23,8,2,4,2,6482,6515,15
Task 6483,Job 0,9,10,2,12,1,11,21,10,2,4,2,6483,6517,5
Task 6483,Job 1,14,5,1,8,0,15,22,7,1,4,0,6483,6517,3
Task 6484,Job 0,5,5,4,11,0,9,16,7,4,4,2,6484,6517,2
Task 6484,Job 1,10,6,1,7,1,11,17,6,1,4,2,6484,6517,9
Task 6485,Job 0,8,4,3,8,0,11,16,5,3,2,0,6485,6519,11
Task 6485,Job 1,13,6,1,8,1,14,21,7,1,4,1,6485,6519,8
Task 6486,Job 0,2,6,3,12,0,5,14,9,3,3,1,6486,6520,3
Task 6486,Job 1,7,6,4,6,1,11,13,2,4,3,2,6486,6520,8
Task 6487,Job 0,3,4,2,7,1,5,10,5,2,2,2,6487,6521,2
Task 6487,Job 1,8,4,3,8,0,11,16,5,3,1,2,6487,6521,2
Task 6488,Job 0,10,6,1,7,0,11,17,6,1,4,2,6488,6521,4
Task 6488,Job 1,15,6,1,8,0,16,23,7,1,4,2,6488,6521,4
Task 6489,Job 0,4,6,3,9,0,7,13,6,3,4,2,6489,6522,8
Task 6489,Job 1,9,10,2,8,0,11,17,6,2,4,1,6489,6522,13
Task 6490,Job 0,1,5,2,8,1,3,9,6,2,1,2,6490,6524,15
Task 6490,Job 1,6,9,1,12,1,7,18,11,1,4,1,6490,6524,16
Task 6491,Job 0,1,4,1,8,0,2,9,7,1,1,0,6491,6525,12
Task 6491,Job 1,6,8,2,6,0,8,12,4,2,2,0,6491,6525,3
Task 6492,Job 0,6,5,3,10,0,9,16,7,3,1,0,6492,6525,5
Task 6492,Job 1,11,7,1,8,0,12,19,7,1,3,0,6492,6525,9
Task 6493,Job 0,1,8,3,9,0,4,10,6,3,3,1,6493,6527,5
Task 6493,Job 1,6,5,4,11,0,10,17,7,4,1,2,6493,6527,16
Task 6494,Job 0,4,6,3,9,0,7,13,6,3,1,0,6494,6528,7
Task 6494,Job 1,9,5,4,7,1,13,16,3,4,2,1,6494,6528,13
Task 6495,Job 0,5,9,3,9,0,8,14,6,3,4,1,6495,6528,8
Task 6495,Job 1,10,8,1,9,0,11,19,8,1,1,1,6495,6528,9
Task 6496,Job 0,7,6,2,10,0,9,17,8,2,3,1,6496,6529,16
Task 6496,Job 1,12,10,4,11,0,16,23,7,4,4,2,6496,6529,20
Task 6497,Job 0,4,7,1,8,0,5,12,7,1,1,2,6497,6531,12
Task 6497,Job 1,9,9,4,12,0,13,21,8,4,4,2,6497,6531,12
Task 6498,Job 0,6,4,1,12,0,7,18,11,1,1,0,6498,6532,5
Task 6498,Job 1,11,10,4,12,1,15,23,8,4,3,0,6498,6532,5
Task 6499,Job 0,5,6,3,10,1,8,15,7,3,3,2,6499,6533,13
Task 6499,Job 1,10,5,3,8,1,13,18,5,3,3,1,6499,6533,15
Task 6500,Job 0,9,8,1,6,0,10,15,5,1,2,0,6500,6534,15
Task 6500,Job 1,14,9,2,9,0,16,23,7,2,3,1,6500,6534,2
Task 6501,Job 0,5,10,3,6,1,8,11,3,3,3,0,6501,6535,6
Task 6501,Job 1,10,10,3,12,0,13,22,9,3,4,1,6501,6535,19
Task 6502,Job 0,5,4,3,8,0,8,13,5,3,2,0,6502,6535,16
Task 6502,Job 1,10,10,1,12,1,11,22,11,1,2,1,6502,6535,18
Task 6503,Job 0,7,8,3,6,0,10,13,3,3,3,1,6503,6536,15
Task 6503,Job 1,12,9,1,6,0,13,18,5,1,4,0,6503,6536,11
Task 6504,Job 0,10,8,1,6,0,11,16,5,1,1,2,6504,6538,10
Task 6504,Job 1,15,4,1,9,0,16,24,8,1,4,1,6504,6538,14
Task 6505,Job 0,2,9,4,10,0,6,12,6,4,3,0,6505,6539,19
Task 6505,Job 1,7,5,4,12,1,11,19,8,4,3,0,6505,6539,15
Task 6506,Job 0,3,5,3,11,0,6,14,8,3,2,0,6506,6539,7
Task 6506,Job 1,8,8,3,9,1,11,17,6,3,2,1,6506,6539,15
Task 6507,Job 0,7,4,1,11,1,8,18,10,1,3,0,6507,6540,17
Task 6507,Job 1,12,8,4,9,0,16,21,5,4,2,2,6507,6540,11
Task 6508,Job 0,8,9,4,8,0,12,16,4,4,4,0,6508,6542,17
Task 6508,Job 1,13,10,1,8,0,14,21,7,1,4,0,6508,6542,12
Task 6509,Job 0,4,4,2,11,0,6,15,9,2,4,1,6509,6543,13
Task 6509,Job 1,9,6,3,7,0,12,16,4,3,1,1,6509,6543,11
Task 6510,Job 0,4,6,2,12,0,6,16,10,2,1,2,6510,6544,20
Task 6510,Job 1,9,10,2,10,0,11,19,8,2,2,1,6510,6544,18
Task 6511,Job 0,3,4,3,9,0,6,12,6,3,3,1,6511,6545,8
Task 6511,Job 1,8,6,2,6,1,10,14,4,2,3,0,6511,6545,14
Task 6512,Job 0,4,4,3,6,0,7,10,3,3,4,2,6512,6546,9
Task 6512,Job 1,9,10,2,8,1,11,17,6,2,2,2,6512,6546,6
Task 6513,Job 0,5,6,4,12,1,9,17,8,4,3,0,6513,6546,20
Task 6513,Job 1,10,9,1,12,0,11,22,11,1,4,0,6513,6546,16
Task 6514,Job 0,9,10,4,11,0,13,20,7,4,4,1,6514,6547,5
Task 6514,Job 1,14,7,1,8,0,15,22,7,1,2,1,6514,6547,9
Task 6515,Job 0,4,5,2,9,0,6,13,7,2,3,1,6515,6549,16
Task 6515,Job 1,9,8,4,9,0,13,18,5,4,1,0,6515,6549,10
Task 6516,Job 0,2,7,1,8,1,3,10,7,1,4,1,6516,6549,19
Task 6516,Job 1,7,9,2,12,0,9,19,10,2,1,0,6516,6549,11
Task 6517,Job 0,6,5,2,9,0,8,15,7,2,1,0,6517,6550,8
Task 6517,Job 1,11,6,2,9,0,13,20,7,2,2,2,6517,6550,11
Task 6518,Job 0,10,9,3,7,0,13,17,4,3,3,0,6518,6552,6
Task 6518,Job 1,15,9,2,10,1,17,25,8,2,2,1,6518,6552,17
Task 6519,Job 0,1,7,2,11,1,3,12,9,2,3,2,6519,6553,12
Task 6519,Job 1,6,6,1,9,0,7,15,8,1,4,0,6519,6553,20
Task 6520,Job 0,6,10,3,12,0,9,18,9,3,3,2,6520,6554,5
Task 6520,Job 1,11,9,2,10,0,13,21,8,2,3,1,6520,6554,17
Task 6521,Job 0,6,9,1,11,0,7,17,10,1,1,2,6521,6554,16
Task 6521,Job 1,11,6,1,12,1,12,23,11,1,4,1,6521,6554,4
Task 6522,Job 0,6,9,1,12,1,7,18,11,1,2,1,6522,6555,15
Task 6522,Job 1,11,10,3,11,0,14,22,8,3,2,2,6522,6555,16
Task 6523,Job 0,3,5,3,11,1,6,14,8,3,4,0,6523,6556,15
Task 6523,Job 1,8,7,2,10,0,10,18,8,2,3,0,6523,6556,14
Task 6524,Job 0,8,4,4,10,0,12,18,6,4,3,0,6524,6557,8
Task 6524,Job 1,13,8,3,12,0,16,25,9,3,1,2,6524,6557,19
Task 6525,Job 0,8,5,2,6,1,10,14,4,2,2,2,6525,6558,14
Task 6525,Job 1,13,6,2,12,0,15,25,10,2,4,1,6525,6558,13
Task 6526,Job 0,4,4,4,11,1,8,15,7,4,1,2,6526,6559,6
Task 6526,Job 1,9,10,2,7,0,11,16,5,2,2,0,6526,6559,9
Task 6527,Job 0,4,4,3,6,0,7,10,3,3,1,0,6527,6560,4
Task 6527,Job 1,9,8,1,11,1,10,20,10,1,3,2,6527,6560,11
Task 6528,Job 0,1,4,1,6,0,2,7,5,1,3,1,6528,6562,18
Task 6528,Job 1,6,5,4,9,0,10,15,5,4,4,2,6528,6562,3
Task 6529,Job 0,3,5,3,11,0,6,14,8,3,3,1,6529,6563,19
Task 6529,Job 1,8,6,2,12,1,10,20,10,2,4,2,6529,6563,3
Task 6530,Job 0,4,7,1,11,0,5,15,10,1,1,0,6530,6564,13
Task 6530,Job 1,9,8,4,8,0,13,17,4,4,4,2,6530,6564,2
Task 6531,Job 0,8,5,1,8,0,9,16,7,1,1,2,6531,6564,6
Task 6531,Job 1,13,4,1,6,0,14,19,5,1,1,2,6531,6564,12
Task 6532,Job 0,6,8,3,8,0,9,14,5,3,1,1,6532,6566,10
Task 6532,Job 1,11,10,1,9,1,12,20,8,1,4,1,6532,6566,19
Task 6533,Job 0,6,5,3,11,0,9,17,8,3,4,2,6533,6566,20
Task 6533,Job 1,11,10,3,10,0,14,21,7,3,3,2,6533,6566,6
Task 6534,Job 0,7,4,1,11,0,8,18,10,1,1,0,6534,6568,8
Task 6534,Job 1,12,9,4,11,0,16,23,7,4,2,2,6534,6568,6
Task 6535,Job 0,10,4,1,11,0,11,21,10,1,2,0,6535,6569,18
Task 6535,Job 1,15,5,2,10,0,17,25,8,2,2,2,6535,6569,7
Task 6536,Job 0,9,9,2,7,1,11,16,5,2,1,0,6536,6569,2
Task 6536,Job 1,14,8,4,10,0,18,24,6,4,2,1,6536,6569,7
Task 6537,Job 0,8,9,4,11,1,12,19,7,4,1,1,6537,6570,18
Task 6537,Job 1,13,8,4,9,0,17,22,5,4,4,0,6537,6570,15
Task 6538,Job 0,5,8,2,9,1,7,14,7,2,3,1,6538,6572,15
Task 6538,Job 1,10,4,3,10,0,13,20,7,3,3,1,6538,6572,19
Task 6539,Job 0,8,8,1,6,1,9,14,5,1,1,2,6539,6572,12
Task 6539,Job 1,13,5,2,8,0,15,21,6,2,3,0,6539,6572,20
Task 6540,Job 0,10,6,2,6,0,12,16,4,2,1,0,6540,6574,2
Task 6540,Job 1,15,7,4,8,1,19,23,4,4,2,1,6540,6574,17
Task 6541,Job 0,3,8,1,7,0,4,10,6,1,1,1,6541,6574,18
Task 6541,Job 1,8,7,3,9,0,11,17,6,3,4,0,6541,6574,18
Task 6542,Job 0,6,5,1,7,0,7,13,6,1,4,2,6542,6576,13
Task 6542,Job 1,11,4,1,8,0,12,19,7,1,1,1,6542,6576,13
Task 6543,Job 0,9,8,2,7,0,11,16,5,2,1,2,6543,6577,18
Task 6543,Job 1,14,7,1,7,0,15,21,6,1,4,2,6543,6577,18
Task 6544,Job 0,4,9,1,10,0,5,14,9,1,2,1,6544,6577,7
Task 6544,Job 1,9,9,4,6,0,13,15,2,4,2,2,6544,6577,2
Task 6545,Job 0,4,8,3,11,0,7,15,8,3,2,0,6545,6578,4
Task 6545,Job 1,9,4,1,10,0,10,19,9,1,3,2,6545,6578,3
Task 6546,Job 0,6,10,1,12,1,7,18,11,1,1,1,6546,6579,20
Task 6546,Job 1,11,6,4,11,1,15,22,7,4,4,2,6546,6579,17
Task 6547,Job 0,6,5,1,9,1,7,15,8,1,3,2,6547,6581,11
Task 6547,Job 1,11,9,2,10,1,13,21,8,2,4,1,6547,6581,16
Task 6548,Job 0,8,5,2,12,0,10,20,10,2,4,0,6548,6582,18
Task 6548,Job 1,13,10,3,12,0,16,25,9,3,2,2,6548,6582,5
Task 6549,Job 0,2,7,3,9,0,5,11,6,3,2,2,6549,6582,6
Task 6549,Job 1,7,10,4,10,0,11,17,6,4,3,0,6549,6582,7
Task 6550,Job 0,10,5,3,12,0,13,22,9,3,2,2,6550,6583,8
Task 6550,Job 1,15,7,1,12,1,16,27,11,1,1,0,6550,6583,14
Task 6551,Job 0,3,4,4,8,0,7,11,4,4,4,1,6551,6584,14
Task 6551,Job 1,8,5,2,11,0,10,19,9,2,1,0,6551,6584,2
Task 6552,Job 0,3,9,4,6,1,7,9,2,4,3,0,6552,6585,12
Task 6552,Job 1,8,4,1,8,1,9,16,7,1,3,2,6552,6585,13
Task 6553,Job 0,7,4,3,6,1,10,13,3,3,3,0,6553,6587,11
Task 6553,Job 1,12,7,2,8,1,14,20,6,2,2,1,6553,6587,7
Task 6554,Job 0,1,10,2,8,0,3,9,6,2,2,0,6554,6587,2
Task 6554,Job 1,6,6,4,11,1,10,17,7,4,2,1,6554,6587,20
Task 6555,Job 0,2,9,2,8,0,4,10,6,2,3,2,6555,6588,2
Task 6555,Job 1,7,10,1,12,0,8,19,11,1,2,2,6555,6588,18
Task 6556,Job 0,4,9,4,10,1,8,14,6,4,2,1,6556,6590,2
Task 6556,Job 1,9,10,3,7,0,12,16,4,3,2,1,6556,6590,14
Task 6557,Job 0,4,9,4,7,0,8,11,3,4,2,0,6557,6591,17
Task 6557,Job 1,9,6,2,6,0,11,15,4,2,2,2,6557,6591,16
Task 6558,Job 0,9,8,4,10,1,13,19,6,4,4,2,6558,6592,8
Task 6558,Job 1,14,10,2,9,0,16,23,7,2,1,0,6558,6592,8
Task 6559,Job 0,4,7,3,9,0,7,13,6,3,4,2,6559,6592,11
Task 6559,Job 1,9,7,4,12,0,13,21,8,4,2,1,6559,6592,14
Task 6560,Job 0,7,5,3,7,1,10,14,4,3,2,2,6560,6594,4
Task 6560,Job 1,12,9,1,11,0,13,23,10,1,2,0,6560,6594,5
Task 6561,Job 0,7,9,2,10,1,9,17,8,2,2,1,6561,6594,19
Task 6561,Job 1,12,5,4,10,0,16,22,6,4,2,2,6561,6594,17
Task 6562,Job 0,6,9,1,12,1,7,18,11,1,3,0,6562,6596,9
Task 6562,Job 1,11,4,4,6,0,15,17,2,4,4,2,6562,6596,18
Task 6563,Job 0,4,6,3,6,0,7,10,3,3,3,0,6563,6596,18
Task 6563,Job 1,9,5,2,11,0,11,20,9,2,2,1,6563,6596,2
Task 6564,Job 0,9,10,2,6,0,11,15,4,2,1,0,6564,6597,17
Task 6564,Job 1,14,5,3,9,0,17,23,6,3,1,2,6564,6597,20
Task 6565,Job 0,4,5,3,9,0,7,13,6,3,3,1,6565,6598,20
Task 6565,Job 1,9,5,2,6,0,11,15,4,2,1,1,6565,6598,14
Task 6566,Job 0,1,4,4,12,1,5,13,8,4,3,0,6566,6600,12
Task 6566,Job 1,6,9,2,6,1,8,12,4,2,3,1,6566,6600,19
Task 6567,Job 0,4,6,4,10,0,8,14,6,4,1,0,6567,6600,20
Task 6567,Job 1,9,7,2,11,0,11,20,9,2,1,2,6567,6600,10
Task 6568,Job 0,2,5,2,12,0,4,14,10,2,1,0,6568,6601,8
Task 6568,Job 1,7,7,3,10,1,10,17,7,3,1,2,6568,6601,3
Task 6569,Job 0,7,7,1,8,0,8,15,7,1,1,2,6569,6602,4
Task 6569,Job 1,12,9,4,11,0,16,23,7,4,4,2,6569,6602,16
Task 6570,Job 0,10,5,4,7,0,14,17,3,4,1,0,6570,6603,13
Task 6570,Job 1,15,7,3,9,0,18,24,6,3,1,0,6570,6603,19
Task 6571,Job 0,4,7,1,9,0,5,13,8,1,3,0,6571,6604,8
Task 6571,Job 1,9,10,1,9,0,10,18,8,1,3,0,6571,6604,3
Task 6572,Job 0,4,9,1,6,0,5,10,5,1,2,0,6572,6606,3
Task 6572,Job 1,9,6,3,9,0,12,18,6,3,4,0,6572,6606,15
Task 6573,Job 0,10,7,4,6,0,14,16,2,4,2,0,6573,6607,13
Task 6573,Job 1,15,7,3,11,0,18,26,8,3,3,1,6573,6607,20
Task 6574,Job 0,5,6,2,8,0,7,13,6,2,1,2,6574,6608,15
Task 6574,Job 1,10,8,4,9,0,14,19,5,4,4,0,6574,6608,14
Task 6575,Job 0,6,8,4,12,0,10,18,8,4,1,0,6575,6609,18
Task 6575,Job 1,11,6,3,8,1,14,19,5,3,4,1,6575,6609,19
Task 6576,Job 0,3,7,1,10,0,4,13,9,1,4,2,6576,6610,8
Task 6576,Job 1,8,9,4,11,0,12,19,7,4,4,0,6576,6610,17
Task 6577,Job 0,6,9,1,6,0,7,12,5,1,4,2,6577,6610,19
Task 6577,Job 1,11,7,2,12,1,13,23,10,2,1,0,6577,6610,16
Task 6578,Job 0,4,7,3,6,0,7,10,3,3,1,2,6578,6612,18
Task 6578,Job 1,9,7,1,6,0,10,15,5,1,1,1,6578,6612,15
Task 6579,Job 0,10,7,2,7,1,12,17,5,2,4,1,6579,6613,4
Task 6579,Job 1,15,6,2,7,0,17,22,5,2,1,1,6579,6613,20
Task 6580,Job 0,4,9,3,7,0,7,11,4,3,4,2,6580,6613,19
Task 6580,Job 1,9,10,2,8,0,11,17,6,2,3,1,6580,6613,3
Task 6581,Job 0,10,4,3,7,1,13,17,4,3,1,0,6581,6614,16
Task 6581,Job 1,15,7,1,6,0,16,21,5,1,3,2,6581,6614,19
Task 6582,Job 0,9,5,4,11,0,13,20,7,4,4,1,6582,6616,11
Task 6582,Job 1,14,5,4,8,1,18,22,4,4,4,2,6582,6616,7
Task 6583,Job 0,5,7,2,12,1,7,17,10,2,2,1,6583,6616,2
Task 6583,Job 1,10,8,4,9,1,14,19,5,4,1,0,6583,6616,19
Task 6584,Job 0,1,5,3,9,0,4,10,6,3,3,1,6584,6618,4
Task 6584,Job 1,6,6,1,7,1,7,13,6,1,2,2,6584,6618,8
Task 6585,Job 0,3,8,1,10,0,4,13,9,1,1,0,6585,6619,6
Task 6585,Job 1,8,9,4,8,0,12,16,4,4,1,1,6585,6619,4
Task 6586,Job 0,3,5,2,11,0,5,14,9,2,1,1,6586,6620,2
Task 6586,Job 1,8,10,4,10,0,12,18,6,4,4,0,6586,6620,16
Task 6587,Job 0,7,6,3,10,0,10,17,7,3,4,0,6587,6621,9
Task 6587,Job 1,12,6,3,6,0,15,18,3,3,4,1,6587,6621,15
Task 6588,Job 0,3,6,3,12,0,6,15,9,3,1,2,6588,6622,8
Task 6588,Job 1,8,6,4,12,0,12,20,8,4,4,2,6588,6622,7
Task 6589,Job 0,8,6,1,10,0,9,18,9,1,1,1,6589,6622,15
Task 6589,Job 1,13,5,2,10,1,15,23,8,2,3,0,6589,6622,10
Task 6590,Job 0,7,9,1,9,0,8,16,8,1,4,1,6590,6624,4
Task 6590,Job 1,12,4,1,8,0,13,20,7,1,1,0,6590,6624,2
Task 6591,Job 0,4,10,2,11,0,6,15,9,2,3,2,6591,6624,18
Task 6591,Job 1,9,10,3,12,0,12,21,9,3,2,2,6591,6624,19
Task 6592,Job 0,8,9,1,12,0,9,20,11,1,1,1,6592,6626,10
Task 6592,Job 1,13,7,3,6,0,16,19,3,3,3,2,6592,6626,14
Task 6593,Job 0,4,4,2,10,0,6,14,8,2,3,2,6593,6626,15
Task 6593,Job 1,9,5,3,11,0,12,20,8,3,1,2,6593,6626,19
Task 6594,Job 0,2,8,1,10,0,3,12,9,1,4,2,6594,6628,2
Task 6594,Job 1,7,7,1,11,0,8,18,10,1,4,1,6594,6628,15
Task 6595,Job 0,7,6,3,7,1,10,14,4,3,2,0,6595,6628,15
Task 6595,Job 1,12,10,2,9,0,14,21,7,2,4,0,6595,6628,5
Task 6596,Job 0,3,9,4,6,1,7,9,2,4,3,2,6596,6629,14
Task 6596,Job 1,8,4,1,10,0,9,18,9,1,1,2,6596,6629,17
Task 6597,Job 0,5,10,3,10,0,8,15,7,3,4,2,6597,6630,20
Task 6597,Job 1,10,5,4,8,1,14,18,4,4,3,1,6597,6630,10
Task 6598,Job 0,10,10,1,10,0,11,20,9,1,1,2,6598,6632,12
Task 6598,Job 1,15,9,3,6,0,18,21,3,3,2,2,6598,6632,4
Task 6599,Job 0,3,4,4,7,0,7,10,3,4,3,1,6599,6632,2
Task 6599,Job 1,8,10,4,8,0,12,16,4,4,2,0,6599,6632,16
Task 6600,Job 0,2,9,3,6,1,5,8,3,3,4,0,6600,6633,14
Task 6600,Job 1,7,8,2,11,1,9,18,9,2,1,1,6600,6633,10
Task 6601,Job 0,8,9,3,11,0,11,19,8,3,2,0,6601,6634,2
Task 6601,Job 1,13,5,1,12,0,14,25,11,1,3,0,6601,6634,11
Task 6602,Job 0,1,9,4,10,0,5,11,6,4,1,2,6602,6635,13
Task 6602,Job 1,6,4,1,11,1,7,17,10,1,3,2,6602,6635,8
Task 6603,Job 0,10,9,3,9,1,13,19,6,3,1,1,6603,6636,9
Task 6603,Job 1,15,9,2,9,0,17,24,7,2,1,2,6603,6636,5
Task 6604,Job 0,2,4,4,8,0,6,10,4,4,2,2,6604,6637,13
Task 6604,Job 1,7,10,2,10,0,9,17,8,2,2,2,6604,6637,11
Task 6605,Job 0,2,10,3,6,0,5,8,3,3,4,1,6605,6639,17
Task 6605,Job 1,7,5,3,11,0,10,18,8,3,2,1,6605,6639,14
Task 6606,Job 0,3,6,3,10,0,6,13,7,3,2,0,6606,6639,3
Task 6606,Job 1,8,9,4,12,1,12,20,8,4,3,2,6606,6639,13
Task 6607,Job 0,1,9,2,9,1,3,10,7,2,3,0,6607,6641,15
Task 6607,Job 1,6,4,2,7,0,8,13,5,2,3,1,6607,6641,4
Task 6608,Job 0,9,10,3,10,0,12,19,7,3,2,1,6608,6642,7
Task 6608,Job 1,14,8,4,8,0,18,22,4,4,3,0,6608,6642,8
Task 6609,Job 0,9,5,3,11,0,12,20,8,3,2,1,6609,6642,3
Task 6609,Job 1,14,4,1,6,0,15,20,5,1,4,2,6609,6642,4
Task 6610,Job 0,4,9,3,10,0,7,14,7,3,2,2,6610,6644,8
Task 6610,Job 1,9,7,3,6,0,12,15,3,3,3,1,6610,6644,16
Task 6611,Job 0,10,9,4,9,0,14,19,5,4,4,0,6611,6644,12
Task 6611,Job 1,15,9,1,10,0,16,25,9,1,1,2,6611,6644,12
Task 6612,Job 0,4,10,4,7,0,8,11,3,4,2,2,6612,6645,16
Task 6612,Job 1,9,5,2,7,1,11,16,5,2,2,1,6612,6645,10
Task 6613,Job 0,3,9,1,7,0,4,10,6,1,4,0,6613,6646,3
Task 6613,Job 1,8,4,3,10,0,11,18,7,3,1,0,6613,6646,15
Task 6614,Job 0,8,10,1,11,0,9,19,10,1,1,1,6614,6647,19
Task 6614,Job 1,13,5,2,10,1,15,23,8,2,2,0,6614,6647,13
Task 6615,Job 0,5,6,4,10,0,9,15,6,4,2,0,6615,6649,3
Task 6615,Job 1,10,8,2,7,1,12,17,5,2,3,1,6615,6649,4
Task 6616,Job 0,3,6,1,12,1,4,15,11,1,1,2,6616,6650,7
Task 6616,Job 1,8,10,4,8,1,12,16,4,4,4,0,6616,6650,6
Task 6617,Job 0,4,6,1,10,1,5,14,9,1,1,1,6617,6650,5
Task 6617,Job 1,9,8,4,10,0,13,19,6,4,1,0,6617,6650,5
Task 6618,Job 0,2,6,1,9,0,3,11,8,1,3,2,6618,6651,4
Task 6618,Job 1,7,8,4,6,0,11,13,2,4,1,1,6618,6651,8
Task 6619,Job 0,1,5,1,9,1,2,10,8,1,2,0,6619,6653,8
Task 6619,Job 1,6,4,3,6,1,9,12,3,3,4,0,6619,6653,4
Task 6620,Job 0,7,4,1,12,0,8,19,11,1,2,2,6620,6653,6
Task 6620,Job 1,12,10,3,7,1,15,19,4,3,4,2,6620,6653,9
Task 6621,Job 0,1,10,2,12,0,3,13,10,2,3,2,6621,6655,2
Task 6621,Job 1,6,7,2,10,0,8,16,8,2,1,2,6621,6655,12
Task 6622,Job 0,5,7,4,12,1,9,17,8,4,1,2,6622,6656,13
Task 6622,Job 1,10,4,3,10,0,13,20,7,3,2,0,6622,6656,9
Task 6623,Job 0,8,9,1,7,0,9,15,6,1,1,1,6623,6656,17
Task 6623,Job 1,13,6,3,8,0,16,21,5,3,1,0,6623,6656,7
Task 6624,Job 0,3,10,3,12,0,6,15,9,3,3,0,6624,6657,13
Task 6624,Job 1,8,6,1,7,0,9,15,6,1,4,2,6624,6657,3
Task 6625,Job 0,3,5,4,8,0,7,11,4,4,1,0,6625,6659,20
Task 6625,Job 1,8,4,1,6,0,9,14,5,1,4,0,6625,6659,8
Task 6626,Job 0,7,5,4,8,0,11,15,4,4,2,0,6626,6659,9
Task 6626,Job 1,12,6,3,6,0,15,18,3,3,1,1,6626,6659,14
Task 6627,Job 0,2,9,1,8,0,3,10,7,1,2,2,6627,6661,17
Task 6627,Job 1,7,6,1,10,0,8,17,9,1,4,2,6627,6661,20
Task 6628,Job 0,4,10,2,7,0,6,11,5,2,4,1,6628,6662,10
Task 6628,Job 1,9,8,1,6,1,10,15,5,1,1,1,6628,6662,4
Task 6629,Job 0,9,8,1,10,0,10,19,9,1,3,2,6629,6663,17
Task 6629,Job 1,14,10,3,11,0,17,25,8,3,3,1,6629,6663,17
Task 6630,Job 0,10,10,3,7,0,13,17,4,3,2,2,6630,6663,13
Task 6630,Job 1,15,4,3,10,0,18,25,7,3,2,0,6630,6663,18
Task 6631,Job 0,6,5,4,9,0,10,15,5,4,4,1,6631,6665,6
Task 6631,Job 1,11,10,3,10,0,14,21,7,3,1,1,6631,6665,16
Task 6632,Job 0,4,6,3,6,0,7,10,3,3,3,1,6632,6665,15
Task 6632,Job 1,9,7,4,7,1,13,16,3,4,3,0,6632,6665,13
Task 6633,Job 0,6,4,1,9,0,7,15,8,1,4,2,6633,6667,8
Task 6633,Job 1,11,6,3,12,1,14,23,9,3,4,2,6633,6667,10
Task 6634,Job 0,1,9,3,9,0,4,10,6,3,2,2,6634,6667,4
Task 6634,Job 1,6,8,2,7,1,8,13,5,2,2,2,6634,6667,13
Task 6635,Job 0,7,7,4,9,0,11,16,5,4,2,2,6635,6669,11
Task 6635,Job 1,12,6,4,11,0,16,23,7,4,2,0,6635,6669,10
Task 6636,Job 0,5,4,3,9,0,8,14,6,3,1,1,6636,6669,10
Task 6636,Job 1,10,5,3,7,0,13,17,4,3,4,1,6636,6669,9
Task 6637,Job 0,8,5,3,7,1,11,15,4,3,2,0,6637,6671,16
Task 6637,Job 1,13,4,3,12,1,16,25,9,3,1,2,6637,6671,4
Task 6638,Job 0,3,8,3,8,0,6,11,5,3,1,0,6638,6671,5
Task 6638,Job 1,8,10,4,12,0,12,20,8,4,3,1,6638,6671,14
Task 6639,Job 0,7,7,4,10,0,11,17,6,4,3,0,6639,6672,8
Task 6639,Job 1,12,5,1,7,0,13,19,6,1,2,0,6639,6672,17
Task 6640,Job 0,9,6,2,6,0,11,15,4,2,2,2,6640,6674,11
Task 6640,Job 1,14,8,1,9,0,15,23,8,1,1,2,6640,6674,19
Task 6641,Job 0,2,5,4,10,0,6,12,6,4,1,2,6641,6674,20
Task 6641,Job 1,7,9,4,6,0,11,13,2,4,3,1,6641,6674,15
Task 6642,Job 0,5,9,4,8,0,9,13,4,4,3,1,6642,6675,5
Task 6642,Job 1,10,10,4,6,0,14,16,2,4,1,2,6642,6675,6
Task 6643,Job 0,1,7,3,7,0,4,8,4,3,4,1,6643,6677,20
Task 6643,Job 1,6,9,4,8,0,10,14,4,4,1,0,6643,6677,20
Task 6644,Job 0,5,8,3,11,0,8,16,8,3,3,0,6644,6677,19
Task 6644,Job 1,10,4,2,6,0,12,16,4,2,3,1,6644,6677,11
Task 6645,Job 0,7,9,3,9,0,10,16,6,3,4,2,6645,6678,2
Task 6645,Job 1,12,5,1,6,0,13,18,5,1,2,1,6645,6678,16
Task 6646,Job 0,10,6,2,8,0,12,18,6,2,4,0,6646,6679,9
Task 6646,Job 1,15,7,2,11,0,17,26,9,2,1,2,6646,6679,19
Task 6647,Job 0,8,7,1,7,0,9,15,6,1,2,1,6647,6680,8
Task 6647,Job 1,13,6,1,7,0,14,20,6,1,3,0,6647,6680,5
Task 6648,Job 0,10,8,3,12,0,13,22,9,3,1,0,6648,6682,10
Task 6648,Job 1,15,7,4,7,0,19,22,3,4,3,0,6648,6682,2
Task 6649,Job 0,5,10,1,11,0,6,16,10,1,1,2,6649,6683,5
Task 6649,Job 1,10,8,1,7,0,11,17,6,1,2,1,6649,6683,4
Task 6650,Job 0,10,7,1,9,0,11,19,8,1,3,2,6650,6683,12
Task 6650,Job 1,15,9,1,7,1,16,22,6,1,3,1,6650,6683,4
Task 6651,Job 0,9,7,1,12,0,10,21,11,1,3,1,6651,6684,10
Task 6651,Job 1,14,5,2,11,0,16,25,9,2,4,1,6651,6684,13
Task 6652,Job 0,10,8,1,10,0,11,20,9,1,1,0,6652,6685,5
Task 6652,Job 1,15,8,1,8,1,16,23,7,1,3,1,6652,6685,17
Task 6653,Job 0,8,4,1,12,0,9,20,11,1,3,0,6653,6686,14
Task 6653,Job 1,13,6,4,11,0,17,24,7,4,3,1,6653,6686,17
Task 6654,Job 0,5,4,1,11,0,6,16,10,1,1,0,6654,6688,18
Task 6654,Job 1,10,6,3,7,0,13,17,4,3,4,2,6654,6688,3
Task 6655,Job 0,8,7,1,6,0,9,14,5,1,2,0,6655,6689,9
Task 6655,Job 1,13,7,1,10,0,14,23,9,1,2,0,6655,6689,17
Task 6656,Job 0,5,7,2,6,0,7,11,4,2,2,2,6656,6690,19
Task 6656,Job 1,10,4,2,6,0,12,16,4,2,3,1,6656,6690,16
Task 6657,Job 0,5,6,1,7,0,6,12,6,1,2,0,6657,6690,16
Task 6657,Job 1,10,4,1,8,0,11,18,7,1,3,2,6657,6690,8
Task 6658,Job 0,8,10,2,12,1,10,20,10,2,3,1,6658,6692,6
Task 6658,Job 1,13,10,1,6,0,14,19,5,1,1,2,6658,6692,20
Task 6659,Job 0,3,6,2,10,1,5,13,8,2,3,2,6659,6692,6
Task 6659,Job 1,8,8,2,7,0,10,15,5,2,2,2,6659,6692,15
Task 6660,Job 0,2,10,1,12,1,3,14,11,1,1,1,6660,6693,5
Task 6660,Job 1,7,9,4,12,1,11,19,8,4,2,2,6660,6693,17
Task 6661,Job 0,8,5,3,8,0,11,16,5,3,2,2,6661,6694,15
Task 6661,Job 1,13,6,4,8,0,17,21,4,4,4,0,6661,6694,6
Task 6662,Job 0,6,5,1,8,0,7,14,7,1,2,2,6662,6696,5
Task 6662,Job 1,11,10,1,11,0,12,22,10,1,2,1,6662,6696,20
Task 6663,Job 0,5,5,1,9,0,6,14,8,1,2,0,6663,6696,17
Task 6663,Job 1,10,7,4,9,1,14,19,5,4,1,0,6663,6696,16
Task 6664,Job 0,3,6,4,10,0,7,13,6,4,2,2,6664,6697,12
Task 6664,Job 1,8,10,2,10,1,10,18,8,2,3,1,6664,6697,9
Task 6665,Job 0,5,10,4,11,0,9,16,7,4,1,0,6665,6699,10
Task 6665,Job 1,10,4,2,10,1,12,20,8,2,3,0,6665,6699,9
Task 6666,Job 0,4,6,1,9,0,5,13,8,1,1,1,6666,6700,7
Task 6666,Job 1,9,10,3,11,0,12,20,8,3,2,0,6666,6700,20
Task 6667,Job 0,9,4,2,11,0,11,20,9,2,3,0,6667,6701,11
Task 6667,Job 1,14,4,1,12,0,15,26,11,1,1,2,6667,6701,11
Task 6668,Job 0,2,6,1,8,1,3,10,7,1,1,2,6668,6701,17
Task 6668,Job 1,7,6,3,8,0,10,15,5,3,1,0,6668,6701,17
Task 6669,Job 0,4,5,4,7,0,8,11,3,4,2,2,6669,6703,13
Task 6669,Job 1,9,7,3,8,1,12,17,5,3,3,1,6669,6703,13
Task 6670,Job 0,4,10,3,10,0,7,14,7,3,2,2,6670,6704,19
Task 6670,Job 1,9,5,4,6,0,13,15,2,4,4,0,6670,6704,16
Task 6671,Job 0,7,4,4,9,0,11,16,5,4,1,0,6671,6705,17
Task 6671,Job 1,12,5,1,12,0,13,24,11,1,1,0,6671,6705,10
Task 6672,Job 0,7,9,1,6,1,8,13,5,1,3,2,6672,6705,12
Task 6672,Job 1,12,6,1,12,0,13,24,11,1,1,0,6672,6705,7
Task 6673,Job 0,1,6,1,10,0,2,11,9,1,2,2,6673,6706,17
Task 6673,Job 1,6,9,2,7,0,8,13,5,2,1,0,6673,6706,4
Task 6674,Job 0,7,7,2,6,0,9,13,4,2,4,2,6674,6708,16
Task 6674,Job 1,12,5,3,7,0,15,19,4,3,2,2,6674,6708,15
Task 6675,Job 0,7,8,4,11,0,11,18,7,4,2,1,6675,6708,8
Task 6675,Job 1,12,6,4,9,1,16,21,5,4,4,2,6675,6708,9
Task 6676,Job 0,7,4,3,6,1,10,13,3,3,1,2,6676,6710,14
Task 6676,Job 1,12,9,1,11,0,13,23,10,1,1,2,6676,6710,11
Task 6677,Job 0,1,9,3,11,0,4,12,8,3,2,2,6677,6711,16
Task 6677,Job 1,6,6,2,8,0,8,14,6,2,2,0,6677,6711,6
Task 6678,Job 0,6,9,1,11,0,7,17,10,1,4,2,6678,6712,18
Task 6678,Job 1,11,6,3,7,1,14,18,4,3,1,2,6678,6712,15
Task 6679,Job 0,10,10,3,6,0,13,16,3,3,2,2,6679,6713,3
Task 6679,Job 1,15,6,1,7,1,16,22,6,1,4,1,6679,6713,10
Task 6680,Job 0,4,4,1,6,1,5,10,5,1,4,2,6680,6713,4
Task 6680,Job 1,9,6,1,9,1,10,18,8,1,4,2,6680,6713,8
Task 6681,Job 0,10,10,4,7,0,14,17,3,4,4,0,6681,6715,3
Task 6681,Job 1,15,9,2,10,0,17,25,8,2,3,1,6681,6715,12
Task 6682,Job 0,1,4,4,7,0,5,8,3,4,3,1,6682,6716,20
Task 6682,Job 1,6,8,1,12,0,7,18,11,1,3,1,6682,6716,8
Task 6683,Job 0,8,10,4,12,0,12,20,8,4,2,1,6683,6717,6
Task 6683,Job 1,13,10,4,6,1,17,19,2,4,1,2,6683,6717,9
Task 6684,Job 0,5,6,4,10,0,9,15,6,4,3,2,6684,6717,15
Task 6684,Job 1,10,6,2,10,0,12,20,8,2,1,0,6684,6717,8
Task 6685,Job 0,9,8,1,10,0,10,19,9,1,4,2,6685,6719,3
Task 6685,Job 1,14,9,2,11,1,16,25,9,2,2,0,6685,6719,5
Task 6686,Job 0,2,8,4,11,0,6,13,7,4,3,2,6686,6720,19
Task 6686,Job 1,7,8,2,11,0,9,18,9,2,4,2,6686,6720,8
Task 6687,Job 0,10,6,3,12,0,13,22,9,3,2,0,6687,6721,15
Task 6687,Job 1,15,10,3,6,1,18,21,3,3,1,2,6687,6721,12
Task 6688,Job 0,10,7,2,7,1,12,17,5,2,1,0,6688,6722,14
Task 6688,Job 1,15,4,4,11,0,19,26,7,4,4,2,6688,6722,16
Task 6689,Job 0,8,8,3,9,0,11,17,6,3,2,0,6689,6722,17
Task 6689,Job 1,13,8,4,9,0,17,22,5,4,4,2,6689,6722,3
Task 6690,Job 0,1,6,3,10,0,4,11,7,3,3,2,6690,6724,2
Task 6690,Job 1,6,7,4,7,1,10,13,3,4,4,1,6690,6724,11
Task 6691,Job 0,3,6,4,12,0,7,15,8,4,2,2,6691,6725,13
Task 6691,Job 1,8,5,3,6,0,11,14,3,3,1,0,6691,6725,2
Task 6692,Job 0,4,7,2,9,0,6,13,7,2,3,0,6692,6726,20
Task 6692,Job 1,9,7,3,11,0,12,20,8,3,2,0,6692,6726,6
Task 6693,Job 0,7,7,2,7,0,9,14,5,2,3,2,6693,6727,17
Task 6693,Job 1,12,10,4,11,0,16,23,7,4,3,0,6693,6727,3
Task 6694,Job 0,8,5,2,11,0,10,19,9,2,2,1,6694,6728,11
Task 6694,Job 1,13,10,1,10,0,14,23,9,1,1,2,6694,6728,2
Task 6695,Job 0,2,4,3,11,0,5,13,8,3,4,1,6695,6728,16
Task 6695,Job 1,7,8,1,9,0,8,16,8,1,1,1,6695,6728,15
Task 6696,Job 0,1,10,1,12,0,2,13,11,1,2,1,6696,6730,7
Task 6696,Job 1,6,5,3,8,0,9,14,5,3,2,2,6696,6730,2
Task 6697,Job 0,7,4,1,10,1,8,17,9,1,4,1,6697,6730,18
Task 6697,Job 1,12,10,4,7,1,16,19,3,4,1,1,6697,6730,2
Task 6698,Job 0,2,9,2,10,0,4,12,8,2,4,0,6698,6731,11
Task 6698,Job 1,7,6,1,9,1,8,16,8,1,3,2,6698,6731,5
Task 6699,Job 0,7,9,3,8,0,10,15,5,3,4,2,6699,6733,13
Task 6699,Job 1,12,6,1,12,1,13,24,11,1,2,0,6699,6733,14
Task 6700,Job 0,3,4,4,9,1,7,12,5,4,1,1,6700,6734,7
Task 6700,Job 1,8,7,2,12,0,10,20,10,2,1,0,6700,6734,19
Task 6701,Job 0,6,6,2,12,1,8,18,10,2,2,2,6701,6735,15
Task 6701,Job 1,11,8,2,12,0,13,23,10,2,3,1,6701,6735,3
Task 6702,Job 0,5,9,1,9,1,6,14,8,1,2,0,6702,6736,4
Task 6702,Job 1,10,9,1,10,0,11,20,9,1,4,2,6702,6736,13
Task 6703,Job 0,8,5,3,6,1,11,14,3,3,2,0,6703,6736,9
Task 6703,Job 1,13,9,1,6,1,14,19,5,1,2,0,6703,6736,11
Task 6704,Job 0,4,8,2,11,0,6,15,9,2,1,2,6704,6737,2
Task 6704,Job 1,9,9,2,10,0,11,19,8,2,1,1,6704,6737,11
Task 6705,Job 0,9,4,4,6,0,13,15,2,4,3,2,6705,6739,5
Task 6705,Job 1,14,10,4,11,1,18,25,7,4,1,1,6705,6739,2
Task 6706,Job 0,3,4,3,7,0,6,10,4,3,4,0,6706,6739,17
Task 6706,Job 1,8,10,4,9,0,12,17,5,4,2,1,6706,6739,8
Task 6707,Job 0,1,8,4,12,1,5,13,8,4,1,1,6707,6741,5
Task 6707,Job 1,6,8,3,6,1,9,12,3,3,1,1,6707,6741,14
Task 6708,Job 0,7,4,1,11,0,8,18,10,1,2,2,6708,6742,2
Task 6708,Job 1,12,6,3,6,0,15,18,3,3,4,0,6708,6742,7
Task 6709,Job 0,3,6,4,8,0,7,11,4,4,4,1,6709,6742,4
Task 6709,Job 1,8,9,4,10,0,12,18,6,4,1,0,6709,6742,14
Task 6710,Job 0,8,5,2,12,0,10,20,10,2,3,1,6710,6744,9
Task 6710,Job 1,13,4,3,7,0,16,20,4,3,3,1,6710,6744,14
Task 6711,Job 0,9,7,3,8,1,12,17,5,3,1,0,6711,6744,20
Task 6711,Job 1,14,6,3,12,1,17,26,9,3,3,1,6711,6744,14
Task 6712,Job 0,7,8,1,12,0,8,19,11,1,4,0,6712,6746,19
Task 6712,Job 1,12,4,2,6,0,14,18,4,2,2,1,6712,6746,9
Task 6713,Job 0,9,9,3,11,0,12,20,8,3,3,1,6713,6747,20
Task 6713,Job 1,14,4,2,10,0,16,24,8,2,4,2,6713,6747,9
Task 6714,Job 0,8,7,4,9,0,12,17,5,4,2,0,6714,6747,16
Task 6714,Job 1,13,9,1,9,0,14,22,8,1,2,1,6714,6747,11
Task 6715,Job 0,1,10,2,7,0,3,8,5,2,1,0,6715,6749,15
Task 6715,Job 1,6,6,1,10,0,7,16,9,1,4,2,6715,6749,10
Task 6716,Job 0,5,4,2,7,0,7,12,5,2,1,0,6716,6750,19
Task 6716,Job 1,10,4,4,6,0,14,16,2,4,1,2,6716,6750,9
Task 6717,Job 0,5,4,3,6,0,8,11,3,3,3,2,6717,6751,3
Task 6717,Job 1,10,8,4,12,1,14,22,8,4,1,1,6717,6751,7
Task 6718,Job 0,2,6,4,12,1,6,14,8,4,1,1,6718,6752,8
Task 6718,Job 1,7,7,1,12,0,8,19,11,1,3,1,6718,6752,10
Task 6719,Job 0,4,5,3,9,1,7,13,6,3,4,0,6719,6753,20
Task 6719,Job 1,9,10,2,12,0,11,21,10,2,4,2,6719,6753,4
Task 6720,Job 0,3,7,2,9,0,5,12,7,2,3,2,6720,6754,11
Task 6720,Job 1,8,7,3,6,0,11,14,3,3,4,2,6720,6754,19
Task 6721,Job 0,6,4,1,9,0,7,15,8,1,3,2,6721,6755,6
Task 6721,Job 1,11,10,3,8,0,14,19,5,3,2,0,6721,6755,14
Task 6722,Job 0,7,9,1,11,0,8,18,10,1,2,0,6722,6756,13
Task 6722,Job 1,12,9,4,11,0,16,23,7,4,4,1,6722,6756,8
Task 6723,Job 0,9,8,1,12,1,10,21,11,1,2,1,6723,6756,5
Task 6723,Job 1,14,7,1,6,0,15,20,5,1,1,0,6723,6756,7
Task 6724,Job 0,7,8,3,6,0,10,13,3,3,2,0,6724,6757,15
Task 6724,Job 1,12,8,3,11,0,15,23,8,3,4,0,6724,6757,6
Task 6725,Job 0,1,9,2,9,0,3,10,7,2,1,0,6725,6758,9
Task 6725,Job 1,6,7,2,11,1,8,17,9,2,4,2,6725,6758,2
Task 6726,Job 0,5,9,4,11,0,9,16,7,4,1,1,6726,6760,10
Task 6726,Job 1,10,10,2,7,0,12,17,5,2,4,1,6726,6760,13
Task 6727,Job 0,8,9,1,9,0,9,17,8,1,3,2,6727,6760,2
Task 6727,Job 1,13,6,4,9,1,17,22,5,4,1,0,6727,6760,13
Task 6728,Job 0,8,8,3,6,0,11,14,3,3,3,0,6728,6762,5
Task 6728,Job 1,13,6,1,6,0,14,19,5,1,2,1,6728,6762,20
Task 6729,Job 0,3,4,3,9,0,6,12,6,3,3,0,6729,6762,15
Task 6729,Job 1,8,10,4,10,1,12,18,6,4,1,2,6729,6762,17
Task 6730,Job 0,7,4,3,10,1,10,17,7,3,3,0,6730,6763,19
Task 6730,Job 1,12,5,3,12,0,15,24,9,3,1,1,6730,6763,5
Task 6731,Job 0,9,8,4,8,1,13,17,4,4,2,0,6731,6764,16
Task 6731,Job 1,14,10,1,8,0,15,22,7,1,4,2,6731,6764,18
Task 6732,Job 0,7,8,2,7,0,9,14,5,2,4,2,6732,6765,4
Task 6732,Job 1,12,8,3,8,1,15,20,5,3,3,1,6732,6765,9
Task 6733,Job 0,3,10,4,9,0,7,12,5,4,3,0,6733,6767,15
Task 6733,Job 1,8,5,2,12,0,10,20,10,2,2,1,6733,6767,17
Task 6734,Job 0,6,10,2,11,1,8,17,9,2,4,0,6734,6767,15
Task 6734,Job 1,11,10,4,12,0,15,23,8,4,4,1,6734,6767,4
Task 6735,Job 0,4,10,2,8,1,6,12,6,2,2,2,6735,6769,4
Task 6735,Job 1,9,8,4,11,0,13,20,7,4,2,1,6735,6769,16
Task 6736,Job 0,1,4,2,8,0,3,9,6,2,3,1,6736,6769,8
Task 6736,Job 1,6,7,2,7,0,8,13,5,2,1,0,6736,6769,10
Task 6737,Job 0,8,6,4,9,0,12,17,5,4,4,0,6737,6770,5
Task 6737,Job 1,13,6,4,6,1,17,19,2,4,2,1,6737,6770,16
Task 6738,Job 0,7,7,4,12,1,11,19,8,4,3,0,6738,6772,17
Task 6738,Job 1,12,5,1,9,0,13,21,8,1,1,0,6738,6772,16
Task 6739,Job 0,5,6,1,10,1,6,15,9,1,1,1,6739,6772,3
Task 6739,Job 1,10,4,1,6,0,11,16,5,1,4,2,6739,6772,18
Task 6740,Job 0,6,5,3,12,1,9,18,9,3,3,1,6740,6773,2
Task 6740,Job 1,11,5,2,6,0,13,17,4,2,3,0,6740,6773,19
Task 6741,Job 0,9,6,1,12,0,10,21,11,1,2,1,6741,6775,17
Task 6741,Job 1,14,5,2,12,0,16,26,10,2,1,0,6741,6775,3
Task 6742,Job 0,10,10,3,6,0,13,16,3,3,3,2,6742,6776,5
Task 6742,Job 1,15,10,4,6,0,19,21,2,4,1,1,6742,6776,3
Task 6743,Job 0,7,7,2,8,1,9,15,6,2,1,0,6743,6777,17
Task 6743,Job 1,12,9,3,7,1,15,19,4,3,1,2,6743,6777,3
Task 6744,Job 0,4,7,2,9,0,6,13,7,2,2,1,6744,6777,15
Task 6744,Job 1,9,8,4,9,0,13,18,5,4,3,0,6744,6777,3
Task 6745,Job 0,4,9,3,11,0,7,15,8,3,1,1,6745,6779,19
Task 6745,Job 1,9,10,3,11,0,12,20,8,3,1,2,6745,6779,11
Task 6746,Job 0,2,10,2,6,0,4,8,4,2,4,1,6746,6780,15
Task 6746,Job 1,7,10,4,9,1,11,16,5,4,2,0,6746,6780,13
Task 6747,Job 0,7,8,4,7,0,11,14,3,4,4,0,6747,6780,11
Task 6747,Job 1,12,5,3,9,1,15,21,6,3,2,2,6747,6780,19
Task 6748,Job 0,7,4,4,12,0,11,19,8,4,1,1,6748,6781,14
Task 6748,Job 1,12,5,2,7,0,14,19,5,2,1,0,6748,6781,5
Task 6749,Job 0,9,9,3,12,0,12,21,9,3,3,2,6749,6783,7
Task 6749,Job 1,14,4,2,11,0,16,25,9,2,3,2,6749,6783,9
Task 6750,Job 0,3,10,1,12,0,4,15,11,1,3,2,6750,6783,2
Task 6750,Job 1,8,7,4,9,0,12,17,5,4,1,1,6750,6783,11
Task 6751,Job 0,9,10,4,11,0,13,20,7,4,4,2,6751,6785,20
Task 6751,Job 1,14,7,1,7,0,15,21,6,1,1,1,6751,6785,9
Task 6752,Job 0,10,10,2,11,0,12,21,9,2,1,0,6752,6786,2
Task 6752,Job 1,15,9,4,8,1,19,23,4,4,4,2,6752,6786,15
Task 6753,Job 0,9,5,2,7,0,11,16,5,2,2,0,6753,6786,14
Task 6753,Job 1,14,7,2,9,0,16,23,7,2,4,0,6753,6786,4
Task 6754,Job 0,10,8,2,7,0,12,17,5,2,2,0,6754,6788,6
Task 6754,Job 1,15,7,1,10,0,16,25,9,1,4,2,6754,6788,12
Task 6755,Job 0,9,10,4,9,0,13,18,5,4,1,0,6755,6789,10
Task 6755,Job 1,14,8,3,12,0,17,26,9,3,3,1,6755,6789,14
Task 6756,Job 0,7,7,4,7,0,11,14,3,4,2,2,6756,6789,12
Task 6756,Job 1,12,10,4,8,0,16,20,4,4,3,1,6756,6789,12
Task 6757,Job 0,3,10,3,10,0,6,13,7,3,4,2,6757,6790,11
Task 6757,Job 1,8,5,4,12,0,12,20,8,4,1,2,6757,6790,14
Task 6758,Job 0,10,8,1,9,0,11,19,8,1,2,1,6758,6791,12
Task 6758,Job 1,15,9,3,11,1,18,26,8,3,4,0,6758,6791,16
Task 6759,Job 0,8,10,1,12,0,9,20,11,1,1,1,6759,6793,12
Task 6759,Job 1,13,10,4,9,0,17,22,5,4,3,2,6759,6793,18
Task 6760,Job 0,8,6,3,10,0,11,18,7,3,3,1,6760,6793,4
Task 6760,Job 1,13,6,2,8,1,15,21,6,2,4,0,6760,6793,4
Task 6761,Job 0,5,4,3,8,0,8,13,5,3,3,1,6761,6794,7
Task 6761,Job 1,10,6,4,12,0,14,22,8,4,2,0,6761,6794,16
Task 6762,Job 0,4,10,2,9,0,6,13,7,2,4,0,6762,6796,15
Task 6762,Job 1,9,6,2,7,0,11,16,5,2,3,1,6762,6796,13
Task 6763,Job 0,6,7,1,11,1,7,17,10,1,2,0,6763,6796,10
Task 6763,Job 1,11,6,2,11,1,13,22,9,2,3,0,6763,6796,14
Task 6764,Job 0,6,10,1,8,0,7,14,7,1,3,0,6764,6798,6
Task 6764,Job 1,11,6,4,7,1,15,18,3,4,1,2,6764,6798,16
Task 6765,Job 0,2,4,2,6,1,4,8,4,2,1,1,6765,6798,16
Task 6765,Job 1,7,9,2,9,0,9,16,7,2,3,2,6765,6798,11
Task 6766,Job 0,3,9,3,7,0,6,10,4,3,3,1,6766,6799,20
Task 6766,Job 1,8,10,1,6,0,9,14,5,1,4,0,6766,6799,11
Task 6767,Job 0,9,6,1,6,1,10,15,5,1,2,0,6767,6801,19
Task 6767,Job 1,14,10,3,11,1,17,25,8,3,4,0,6767,6801,15
Task 6768,Job 0,5,7,3,7,1,8,12,4,3,4,1,6768,6801,19
Task 6768,Job 1,10,6,3,6,0,13,16,3,3,4,2,6768,6801,2
Task 6769,Job 0,5,4,4,6,0,9,11,2,4,4,1,6769,6803,6
Task 6769,Job 1,10,4,4,9,0,14,19,5,4,3,0,6769,6803,3
Task 6770,Job 0,9,5,4,6,0,13,15,2,4,1,0,6770,6804,13
Task 6770,Job 1,14,9,2,7,0,16,21,5,2,3,2,6770,6804,7
Task 6771,Job 0,3,4,3,9,0,6,12,6,3,3,1,6771,6805,6
Task 6771,Job 1,8,6,4,7,0,12,15,3,4,2,0,6771,6805,12
Task 6772,Job 0,2,4,4,8,0,6,10,4,4,2,0,6772,6805,18
Task 6772,Job 1,7,7,2,10,0,9,17,8,2,2,2,6772,6805,2
Task 6773,Job 0,5,5,2,12,0,7,17,10,2,1,0,6773,6807,19
Task 6773,Job 1,10,8,3,12,0,13,22,9,3,3,2,6773,6807,6
Task 6774,Job 0,4,5,1,11,1,5,15,10,1,1,0,6774,6807,13
Task 6774,Job 1,9,7,2,6,0,11,15,4,2,3,1,6774,6807,11
Task 6775,Job 0,6,4,3,6,1,9,12,3,3,2,0,6775,6808,7
Task 6775,Job 1,11,8,1,7,0,12,18,6,1,2,1,6775,6808,16
Task 6776,Job 0,1,6,4,7,0,5,8,3,4,1,2,6776,6809,6
Task 6776,Job 1,6,4,4,6,0,10,12,2,4,4,1,6776,6809,16
Task 6777,Job 0,5,9,3,12,1,8,17,9,3,4,2,6777,6810,16
Task 6777,Job 1,10,9,3,8,0,13,18,5,3,2,1,6777,6810,4
Task 6778,Job 0,7,9,4,8,0,11,15,4,4,2,0,6778,6811,8
Task 6778,Job 1,12,7,2,10,0,14,22,8,2,2,2,6778,6811,19
Task 6779,Job 0,2,6,4,9,0,6,11,5,4,4,2,6779,6813,8
Task 6779,Job 1,7,9,2,12,0,9,19,10,2,1,0,6779,6813,15
Task 6780,Job 0,5,4,3,7,0,8,12,4,3,1,1,6780,6813,16
Task 6780,Job 1,10,9,1,12,0,11,22,11,1,1,1,6780,6813,4
Task 6781,Job 0,9,8,2,9,0,11,18,7,2,1,0,6781,6815,11
Task 6781,Job 1,14,6,4,11,1,18,25,7,4,3,1,6781,6815,12
Task 6782,Job 0,5,4,1,7,1,6,12,6,1,2,2,6782,6815,8
Task 6782,Job 1,10,9,2,7,0,12,17,5,2,4,1,6782,6815,16
Task 6783,Job 0,5,7,2,8,0,7,13,6,2,4,0,6783,6816,13
Task 6783,Job 1,10,6,2,10,0,12,20,8,2,3,2,6783,6816,18
Task 6784,Job 0,7,7,4,12,0,11,19,8,4,3,2,6784,6818,13
Task 6784,Job 1,12,4,1,6,0,13,18,5,1,4,2,6784,6818,18
Task 6785,Job 0,8,9,4,9,0,12,17,5,4,2,0,6785,6818,16
Task 6785,Job 1,13,10,2,9,0,15,22,7,2,3,1,6785,6818,19
Task 6786,Job 0,10,7,4,12,1,14,22,8,4,4,0,6786,6820,18
Task 6786,Job 1,15,6,3,10,0,18,25,7,3,3,0,6786,6820,11
Task 6787,Job 0,1,4,2,8,1,3,9,6,2,3,0,6787,6821,20
Task 6787,Job 1,6,10,3,12,0,9,18,9,3,4,2,6787,6821,10
Task 6788,Job 0,1,6,3,8,0,4,9,5,3,4,1,6788,6821,11
Task 6788,Job 1,6,10,2,9,1,8,15,7,2,1,2,6788,6821,11
Task 6789,Job 0,7,6,2,12,0,9,19,10,2,3,2,6789,6822,14
Task 6789,Job 1,12,7,4,7,0,16,19,3,4,3,1,6789,6822,5
Task 6790,Job 0,8,8,1,7,0,9,15,6,1,1,2,6790,6823,17
Task 6790,Job 1,13,8,1,11,1,14,24,10,1,3,0,6790,6823,10
Task 6791,Job 0,3,8,3,10,1,6,13,7,3,3,2,6791,6824,3
Task 6791,Job 1,8,4,4,8,1,12,16,4,4,2,0,6791,6824,10
Task 6792,Job 0,9,10,3,10,0,12,19,7,3,4,2,6792,6825,2
Task 6792,Job 1,14,10,2,10,1,16,24,8,2,4,1,6792,6825,9
Task 6793,Job 0,8,8,4,6,0,12,14,2,4,2,2,6793,6826,14
Task 6793,Job 1,13,8,4,11,0,17,24,7,4,4,0,6793,6826,5
Task 6794,Job 0,7,8,1,7,0,8,14,6,1,4,1,6794,6828,6
Task 6794,Job 1,12,5,3,8,0,15,20,5,3,2,0,6794,6828,4
Task 6795,Job 0,3,7,4,9,1,7,12,5,4,4,1,6795,6828,10
Task 6795,Job 1,8,6,4,12,0,12,20,8,4,4,2,6795,6828,17
Task 6796,Job 0,4,6,4,10,1,8,14,6,4,1,1,6796,6829,5
Task 6796,Job 1,9,7,2,11,1,11,20,9,2,2,2,6796,6829,10
Task 6797,Job 0,2,10,1,8,0,3,10,7,1,2,0,6797,6831,7
Task 6797,Job 1,7,10,3,10,0,10,17,7,3,2,1,6797,6831,6
Task 6798,Job 0,9,8,1,11,0,10,20,10,1,2,1,6798,6831,7
Task 6798,Job 1,14,8,3,10,0,17,24,7,3,2,1,6798,6831,16
Task 6799,Job 0,9,9,2,8,1,11,17,6,2,1,0,6799,6832,17
Task 6799,Job 1,14,4,2,8,1,16,22,6,2,2,0,6799,6832,3
Task 6800,Job 0,6,8,1,6,0,7,12,5,1,1,2,6800,6833,18
Task 6800,Job 1,11,4,1,12,0,12,23,11,1,3,1,6800,6833,12
Task 6801,Job 0,6,8,1,7,0,7,13,6,1,3,1,6801,6834,15
Task 6801,Job 1,11,9,3,7,0,14,18,4,3,1,1,6801,6834,6
Task 6802,Job 0,8,8,1,6,1,9,14,5,1,1,2,6802,6836,12
Task 6802,Job 1,13,9,2,9,0,15,22,7,2,1,2,6802,6836,5
Task 6803,Job 0,1,7,2,8,0,3,9,6,2,3,0,6803,6836,8
Task 6803,Job 1,6,8,4,8,0,10,14,4,4,2,0,6803,6836,17
Task 6804,Job 0,3,7,3,11,0,6,14,8,3,2,1,6804,6837,17
Task 6804,Job 1,8,4,1,8,1,9,16,7,1,1,0,6804,6837,14
Task 6805,Job 0,6,5,2,9,0,8,15,7,2,1,1,6805,6838,6
Task 6805,Job 1,11,9,3,7,0,14,18,4,3,1,1,6805,6838,7
Task 6806,Job 0,7,4,3,8,0,10,15,5,3,2,0,6806,6839,11
Task 6806,Job 1,12,10,4,6,0,16,18,2,4,4,1,6806,6839,18
Task 6807,Job 0,8,4,3,7,0,11,15,4,3,1,2,6807,6841,5
Task 6807,Job 1,13,10,3,8,0,16,21,5,3,4,0,6807,6841,7
Task 6808,Job 0,2,10,4,6,0,6,8,2,4,2,1,6808,6841,14
Task 6808,Job 1,7,4,4,9,0,11,16,5,4,3,0,6808,6841,15
Task 6809,Job 0,5,5,1,7,0,6,12,6,1,1,2,6809,6842,5
Task 6809,Job 1,10,9,4,10,0,14,20,6,4,4,0,6809,6842,15
Task 6810,Job 0,2,4,3,6,0,5,8,3,3,1,2,6810,6844,10
Task 6810,Job 1,7,9,3,10,1,10,17,7,3,2,1,6810,6844,9
Task 6811,Job 0,10,7,1,7,0,11,17,6,1,1,2,6811,6844,2
Task 6811,Job 1,15,6,4,11,0,19,26,7,4,4,0,6811,6844,15
Task 6812,Job 0,1,8,1,11,0,2,12,10,1,4,0,6812,6846,10
Task 6812,Job 1,6,8,3,11,0,9,17,8,3,4,2,6812,6846,19
Task 6813,Job 0,6,9,4,12,0,10,18,8,4,4,0,6813,6847,3
Task 6813,Job 1,11,5,2,12,0,13,23,10,2,3,2,6813,6847,16
Task 6814,Job 0,7,6,2,8,0,9,15,6,2,2,0,6814,6847,7
Task 6814,Job 1,12,7,3,9,0,15,21,6,3,3,0,6814,6847,3
Task 6815,Job 0,7,4,3,8,0,10,15,5,3,4,1,6815,6849,18
Task 6815,Job 1,12,6,2,11,0,14,23,9,2,4,0,6815,6849,4
Task 6816,Job 0,8,6,4,10,0,12,18,6,4,2,1,6816,6849,6
Task 6816,Job 1,13,7,2,9,0,15,22,7,2,2,0,6816,6849,13
Task 6817,Job 0,4,10,2,9,0,6,13,7,2,4,0,6817,6851,2
Task 6817,Job 1,9,9,2,6,0,11,15,4,2,4,2,6817,6851,16
Task 6818,Job 0,7,8,2,12,0,9,19,10,2,4,0,6818,6851,9
Task 6818,Job 1,12,9,4,11,0,16,23,7,4,4,2,6818,6851,10
Task 6819,Job 0,4,7,3,7,0,7,11,4,3,4,1,6819,6852,6
Task 6819,Job 1,9,10,1,12,0,10,21,11,1,4,2,6819,6852,17
Task 6820,Job 0,4,5,4,8,0,8,12,4,4,1,2,6820,6853,12
Task 6820,Job 1,9,6,2,9,1,11,18,7,2,2,2,6820,6853,9
Task 6821,Job 0,4,8,3,12,1,7,16,9,3,3,0,6821,6854,4
Task 6821,Job 1,9,7,2,10,1,11,19,8,2,4,0,6821,6854,11
Task 6822,Job 0,8,10,4,12,0,12,20,8,4,4,2,6822,6855,18
Task 6822,Job 1,13,6,3,7,0,16,20,4,3,1,1,6822,6855,9
Task 6823,Job 0,4,9,1,9,0,5,13,8,1,3,2,6823,6856,20
Task 6823,Job 1,9,8,3,6,0,12,15,3,3,4,1,6823,6856,20
Task 6824,Job 0,6,4,3,12,0,9,18,9,3,3,0,6824,6857,17
Task 6824,Job 1,11,9,3,8,0,14,19,5,3,4,0,6824,6857,19
Task 6825,Job 0,8,5,4,7,0,12,15,3,4,3,0,6825,6858,12
Task 6825,Job 1,13,6,1,10,0,14,23,9,1,1,1,6825,6858,2
Task 6826,Job 0,7,10,2,10,0,9,17,8,2,2,0,6826,6860,12
Task 6826,Job 1,12,10,3,8,0,15,20,5,3,2,1,6826,6860,7
Task 6827,Job 0,10,7,4,8,1,14,18,4,4,1,0,6827,6860,14
Task 6827,Job 1,15,9,1,9,0,16,24,8,1,1,1,6827,6860,13
Task 6828,Job 0,7,10,1,11,0,8,18,10,1,4,1,6828,6862,10
Task 6828,Job 1,12,5,2,12,0,14,24,10,2,2,1,6828,6862,14
Task 6829,Job 0,9,6,2,9,0,11,18,7,2,1,0,6829,6863,14
Task 6829,Job 1,14,4,4,6,0,18,20,2,4,1,0,6829,6863,3
Task 6830,Job 0,10,9,3,9,0,13,19,6,3,1,0,6830,6864,4
Task 6830,Job 1,15,5,4,12,0,19,27,8,4,3,2,6830,6864,10
Task 6831,Job 0,4,10,4,10,1,8,14,6,4,3,0,6831,6865,8
Task 6831,Job 1,9,4,4,7,0,13,16,3,4,4,2,6831,6865,20
Task 6832,Job 0,8,10,4,8,0,12,16,4,4,4,2,6832,6865,11
Task 6832,Job 1,13,10,1,9,1,14,22,8,1,1,1,6832,6865,18
Task 6833,Job 0,3,9,2,7,0,5,10,5,2,2,2,6833,6866,11
Task 6833,Job 1,8,6,3,8,0,11,16,5,3,2,0,6833,6866,16
Task 6834,Job 0,2,10,1,12,0,3,14,11,1,2,2,6834,6868,3
Task 6834,Job 1,7,10,2,11,1,9,18,9,2,2,1,6834,6868,20
Task 6835,Job 0,10,7,4,6,1,14,16,2,4,4,0,6835,6869,9
Task 6835,Job 1,15,6,2,10,0,17,25,8,2,3,2,6835,6869,20
Task 6836,Job 0,4,6,3,9,0,7,13,6,3,2,2,6836,6870,18
Task 6836,Job 1,9,7,2,8,0,11,17,6,2,3,1,6836,6870,9
Task 6837,Job 0,3,7,2,6,0,5,9,4,2,2,0,6837,6871,2
Task 6837,Job 1,8,7,4,7,0,12,15,3,4,2,2,6837,6871,17
Task 6838,Job 0,2,8,4,8,0,6,10,4,4,3,2,6838,6872,20
Task 6838,Job 1,7,10,4,7,1,11,14,3,4,3,0,6838,6872,12
Task 6839,Job 0,9,9,2,9,0,11,18,7,2,1,0,6839,6872,15
Task 6839,Job 1,14,6,4,9,1,18,23,5,4,2,0,6839,6872,19
Task 6840,Job 0,4,10,4,12,1,8,16,8,4,4,1,6840,6873,13
Task 6840,Job 1,9,8,4,11,1,13,20,7,4,1,1,6840,6873,15
Task 6841,Job 0,7,8,3,9,0,10,16,6,3,4,1,6841,6875,12
Task 6841,Job 1,12,5,2,10,1,14,22,8,2,2,2,6841,6875,18
Task 6842,Job 0,3,10,2,11,0,5,14,9,2,2,1,6842,6876,17
Task 6842,Job 1,8,10,4,11,0,12,19,7,4,4,0,6842,6876,3
Task 6843,Job 0,2,9,3,6,0,5,8,3,3,3,0,6843,6877,3
Task 6843,Job 1,7,6,1,12,0,8,19,11,1,1,2,6843,6877,9
Task 6844,Job 0,5,5,3,6,0,8,11,3,3,1,2,6844,6878,6
Task 6844,Job 1,10,8,3,7,1,13,17,4,3,2,0,6844,6878,12
Task 6845,Job 0,8,5,3,10,0,11,18,7,3,2,2,6845,6878,7
Task 6845,Job 1,13,4,2,11,1,15,24,9,2,3,2,6845,6878,16
Task 6846,Job 0,1,8,2,7,1,3,8,5,2,3,0,6846,6879,14
Task 6846,Job 1,6,9,3,8,0,9,14,5,3,3,1,6846,6879,7
Task 6847,Job 0,6,9,1,7,1,7,13,6,1,4,0,6847,6881,12
Task 6847,Job 1,11,6,2,7,0,13,18,5,2,2,1,6847,6881,3
Task 6848,Job 0,3,7,3,12,0,6,15,9,3,2,2,6848,6882,12
Task 6848,Job 1,8,9,2,12,1,10,20,10,2,1,0,6848,6882,5
Task 6849,Job 0,7,6,2,9,0,9,16,7,2,1,2,6849,6883,2
Task 6849,Job 1,12,6,4,10,0,16,22,6,4,3,0,6849,6883,11
Task 6850,Job 0,9,8,3,10,0,12,19,7,3,3,0,6850,6884,6
Task 6850,Job 1,14,5,4,6,1,18,20,2,4,4,1,6850,6884,4
Task 6851,Job 0,7,8,1,12,0,8,19,11,1,3,1,6851,6885,11
Task 6851,Job 1,12,4,3,6,1,15,18,3,3,3,0,6851,6885,6
Task 6852,Job 0,10,7,4,12,1,14,22,8,4,2,0,6852,6885,19
Task 6852,Job 1,15,4,1,10,0,16,25,9,1,1,2,6852,6885,7
Task 6853,Job 0,3,10,2,11,1,5,14,9,2,3,0,6853,6887,18
Task 6853,Job 1,8,10,1,7,1,9,15,6,1,1,0,6853,6887,11
Task 6854,Job 0,1,4,3,6,1,4,7,3,3,2,1,6854,6887,6
Task 6854,Job 1,6,6,4,10,0,10,16,6,4,3,1,6854,6887,16
Task 6855,Job 0,1,7,4,7,0,5,8,3,4,3,0,6855,6889,19
Task 6855,Job 1,6,7,3,11,0,9,17,8,3,4,2,6855,6889,20
Task 6856,Job 0,3,10,1,10,0,4,13,9,1,2,2,6856,6890,6
Task 6856,Job 1,8,5,4,6,0,12,14,2,4,3,1,6856,6890,13
Task 6857,Job 0,2,4,1,12,0,3,14,11,1,4,2,6857,6891,13
Task 6857,Job 1,7,9,3,11,1,10,18,8,3,2,1,6857,6891,7
Task 6858,Job 0,2,9,1,8,0,3,10,7,1,1,0,6858,6892,4
Task 6858,Job 1,7,4,1,8,0,8,15,7,1,4,0,6858,6892,13
Task 6859,Job 0,4,7,4,6,0,8,10,2,4,2,2,6859,6893,7
Task 6859,Job 1,9,4,1,6,0,10,15,5,1,2,1,6859,6893,8
Task 6860,Job 0,4,5,2,7,0,6,11,5,2,3,2,6860,6893,5
Task 6860,Job 1,9,10,1,12,0,10,21,11,1,3,0,6860,6893,18
Task 6861,Job 0,2,8,4,12,1,6,14,8,4,3,2,6861,6894,8
Task 6861,Job 1,7,5,3,7,0,10,14,4,3,4,1,6861,6894,14
Task 6862,Job 0,4,10,4,12,0,8,16,8,4,1,2,6862,6896,7
Task 6862,Job 1,9,6,4,11,0,13,20,7,4,2,0,6862,6896,17
Task 6863,Job 0,3,9,2,8,0,5,11,6,2,4,1,6863,6897,12
Task 6863,Job 1,8,8,3,6,0,11,14,3,3,1,1,6863,6897,16
Task 6864,Job 0,5,6,4,9,1,9,14,5,4,1,0,6864,6897,2
Task 6864,Job 1,10,8,4,7,0,14,17,3,4,2,0,6864,6897,5
Task 6865,Job 0,6,6,3,11,0,9,17,8,3,3,1,6865,6899,17
Task 6865,Job 1,11,5,2,8,0,13,19,6,2,2,1,6865,6899,2
Task 6866,Job 0,10,9,2,12,0,12,22,10,2,2,1,6866,6900,4
Task 6866,Job 1,15,4,1,8,1,16,23,7,1,4,1,6866,6900,17
Task 6867,Job 0,4,8,3,12,0,7,16,9,3,4,0,6867,6900,11
Task 6867,Job 1,9,5,2,11,0,11,20,9,2,4,0,6867,6900,12
Task 6868,Job 0,6,8,3,12,1,9,18,9,3,4,1,6868,6902,5
Task 6868,Job 1,11,6,1,7,0,12,18,6,1,3,0,6868,6902,13
Task 6869,Job 0,2,6,4,7,0,6,9,3,4,2,2,6869,6903,3
Task 6869,Job 1,7,9,2,8,0,9,15,6,2,2,2,6869,6903,18
Task 6870,Job 0,10,9,4,8,0,14,18,4,4,1,1,6870,6903,8
Task 6870,Job 1,15,6,3,11,0,18,26,8,3,3,1,6870,6903,6
Task 6871,Job 0,4,6,3,9,0,7,13,6,3,3,0,6871,6904,3
Task 6871,Job 1,9,5,2,7,1,11,16,5,2,4,0,6871,6904,16
Task 6872,Job 0,7,5,4,6,0,11,13,2,4,4,1,6872,6905,10
Task 6872,Job 1,12,8,1,8,0,13,20,7,1,1,2,6872,6905,14
Task 6873,Job 0,6,9,2,11,1,8,17,9,2,2,1,6873,6906,9
Task 6873,Job 1,11,7,4,9,0,15,20,5,4,2,0,6873,6906,2
Task 6874,Job 0,5,10,4,11,0,9,16,7,4,4,0,6874,6908,9
Task 6874,Job 1,10,9,1,9,0,11,19,8,1,3,2,6874,6908,11
Task 6875,Job 0,4,10,4,12,0,8,16,8,4,2,2,6875,6908,15
Task 6875,Job 1,9,6,1,12,0,10,21,11,1,3,0,6875,6908,4
Task 6876,Job 0,3,8,4,6,0,7,9,2,4,2,0,6876,6910,14
Task 6876,Job 1,8,5,1,9,1,9,17,8,1,3,1,6876,6910,6
Task 6877,Job 0,10,8,4,8,0,14,18,4,4,3,2,6877,6911,2
Task 6877,Job 1,15,9,2,9,0,17,24,7,2,1,2,6877,6911,12
Task 6878,Job 0,5,8,2,8,0,7,13,6,2,3,1,6878,6912,8
Task 6878,Job 1,10,7,3,11,0,13,21,8,3,1,0,6878,6912,19
Task 6879,Job 0,5,4,4,8,0,9,13,4,4,4,0,6879,6912,10
Task 6879,Job 1,10,9,3,11,1,13,21,8,3,4,2,6879,6912,2
Task 6880,Job 0,7,8,3,12,0,10,19,9,3,3,1,6880,6913,6
Task 6880,Job 1,12,7,2,10,0,14,22,8,2,3,0,6880,6913,16
Task 6881,Job 0,6,9,1,11,1,7,17,10,1,1,2,6881,6915,5
Task 6881,Job 1,11,6,4,7,0,15,18,3,4,4,1,6881,6915,19
Task 6882,Job 0,4,4,3,10,0,7,14,7,3,4,1,6882,6915,5
Task 6882,Job 1,9,9,3,10,0,12,19,7,3,4,2,6882,6915,10
Task 6883,Job 0,4,7,2,7,0,6,11,5,2,3,2,6883,6917,7
Task 6883,Job 1,9,10,1,6,0,10,15,5,1,2,2,6883,6917,15
Task 6884,Job 0,7,7,1,11,0,8,18,10,1,2,0,6884,6918,7
Task 6884,Job 1,12,7,3,6,0,15,18,3,3,2,0,6884,6918,17
Task 6885,Job 0,9,7,2,8,0,11,17,6,2,1,0,6885,6918,9
Task 6885,Job 1,14,8,1,6,0,15,20,5,1,1,2,6885,6918,4
Task 6886,Job 0,6,5,1,9,0,7,15,8,1,4,0,6886,6919,2
Task 6886,Job 1,11,10,3,9,1,14,20,6,3,2,2,6886,6919,20
Task 6887,Job 0,1,4,3,12,0,4,13,9,3,4,1,6887,6920,8
Task 6887,Job 1,6,5,3,6,1,9,12,3,3,4,1,6887,6920,3
Task 6888,Job 0,6,7,4,8,0,10,14,4,4,4,1,6888,6921,6
Task 6888,Job 1,11,9,1,12,1,12,23,11,1,4,1,6888,6921,3
Task 6889,Job 0,1,8,4,11,0,5,12,7,4,2,2,6889,6922,15
Task 6889,Job 1,6,5,3,12,0,9,18,9,3,2,0,6889,6922,2
Task 6890,Job 0,5,10,4,12,0,9,17,8,4,1,0,6890,6924,8
Task 6890,Job 1,10,5,3,10,0,13,20,7,3,2,0,6890,6924,11
Task 6891,Job 0,10,4,1,7,1,11,17,6,1,4,0,6891,6924,18
Task 6891,Job 1,15,7,2,8,1,17,23,6,2,2,2,6891,6924,10
Task 6892,Job 0,1,4,3,7,0,4,8,4,3,3,0,6892,6926,13
Task 6892,Job 1,6,4,1,7,1,7,13,6,1,2,2,6892,6926,12
Task 6893,Job 0,7,7,4,11,0,11,18,7,4,4,0,6893,6926,2
Task 6893,Job 1,12,7,1,12,0,13,24,11,1,4,1,6893,6926,11
Task 6894,Job 0,9,6,3,7,1,12,16,4,3,1,1,6894,6928,3
Task 6894,Job 1,14,6,4,6,0,18,20,2,4,4,2,6894,6928,9
Task 6895,Job 0,1,9,3,10,0,4,11,7,3,4,1,6895,6928,19
Task 6895,Job 1,6,10,2,6,0,8,12,4,2,4,0,6895,6928,7
Task 6896,Job 0,1,4,1,9,1,2,10,8,1,4,1,6896,6930,14
Task 6896,Job 1,6,7,1,8,0,7,14,7,1,3,2,6896,6930,18
Task 6897,Job 0,2,7,3,10,0,5,12,7,3,4,0,6897,6930,13
Task 6897,Job 1,7,8,2,7,0,9,14,5,2,2,0,6897,6930,14
Task 6898,Job 0,7,4,4,6,0,11,13,2,4,4,1,6898,6931,11
Task 6898,Job 1,12,6,1,9,0,13,21,8,1,4,2,6898,6931,15
Task 6899,Job 0,2,10,3,7,0,5,9,4,3,1,1,6899,6933,15
Task 6899,Job 1,7,10,3,12,0,10,19,9,3,1,0,6899,6933,16
Task 6900,Job 0,5,5,4,7,1,9,12,3,4,3,1,6900,6933,16
Task 6900,Job 1,10,5,2,9,0,12,19,7,2,3,2,6900,6933,12
Task 6901,Job 0,1,6,2,12,0,3,13,10,2,1,2,6901,6934,12
Task 6901,Job 1,6,7,3,12,0,9,18,9,3,2,0,6901,6934,13
Task 6902,Job 0,7,6,2,10,0,9,17,8,2,2,0,6902,6936,6
Task 6902,Job 1,12,7,1,11,0,13,23,10,1,4,2,6902,6936,18
Task 6903,Job 0,6,6,3,9,1,9,15,6,3,2,2,6903,6936,13
Task 6903,Job 1,11,9,2,11,0,13,22,9,2,1,1,6903,6936,10
Task 6904,Job 0,7,7,4,10,0,11,17,6,4,3,1,6904,6938,5
Task 6904,Job 1,12,7,3,8,1,15,20,5,3,4,2,6904,6938,12
Task 6905,Job 0,4,10,1,11,0,5,15,10,1,4,2,6905,6938,6
Task 6905,Job 1,9,9,2,8,0,11,17,6,2,1,2,6905,6938,2
Task 6906,Job 0,6,7,1,7,1,7,13,6,1,3,0,6906,6940,12
Task 6906,Job 1,11,8,4,11,0,15,22,7,4,1,2,6906,6940,12
Task 6907,Job 0,9,5,4,9,0,13,18,5,4,1,2,6907,6940,16
Task 6907,Job 1,14,9,3,10,0,17,24,7,3,3,2,6907,6940,9
Task 6908,Job 0,6,5,3,9,0,9,15,6,3,3,2,6908,6941,4
Task 6908,Job 1,11,4,3,12,0,14,23,9,3,1,2,6908,6941,3
Task 6909,Job 0,10,8,3,8,0,13,18,5,3,1,0,6909,6942,11
Task 6909,Job 1,15,8,4,9,0,19,24,5,4,4,0,6909,6942,5
Task 6910,Job 0,1,5,1,10,0,2,11,9,1,1,2,6910,6944,20
Task 6910,Job 1,6,6,4,12,0,10,18,8,4,1,0,6910,6944,12
Task 6911,Job 0,9,7,1,8,0,10,17,7,1,3,1,6911,6945,11
Task 6911,Job 1,14,4,4,6,0,18,20,2,4,3,1,6911,6945,3
Task 6912,Job 0,5,5,3,8,0,8,13,5,3,3,2,6912,6945,20
Task 6912,Job 1,10,4,1,6,0,11,16,5,1,1,2,6912,6945,4
Task 6913,Job 0,9,9,3,10,1,12,19,7,3,3,1,6913,6947,14
Task 6913,Job 1,14,8,1,9,0,15,23,8,1,2,0,6913,6947,7
Task 6914,Job 0,9,8,1,6,0,10,15,5,1,3,0,6914,6948,4
Task 6914,Job 1,14,7,1,7,0,15,21,6,1,1,1,6914,6948,17
Task 6915,Job 0,9,5,4,12,0,13,21,8,4,1,2,6915,6949,9
Task 6915,Job 1,14,10,3,6,0,17,20,3,3,3,1,6915,6949,5
Task 6916,Job 0,4,9,1,9,0,5,13,8,1,2,0,6916,6950,6
Task 6916,Job 1,9,7,1,10,1,10,19,9,1,2,0,6916,6950,17
Task 6917,Job 0,2,7,2,12,1,4,14,10,2,2,2,6917,6950,6
Task 6917,Job 1,7,10,4,12,0,11,19,8,4,4,0,6917,6950,19
Task 6918,Job 0,4,9,3,9,0,7,13,6,3,3,1,6918,6951,11
Task 6918,Job 1,9,10,3,8,0,12,17,5,3,1,1,6918,6951,2
Task 6919,Job 0,1,8,3,8,0,4,9,5,3,3,2,6919,6953,8
Task 6919,Job 1,6,6,4,8,0,10,14,4,4,3,1,6919,6953,15
Task 6920,Job 0,1,4,4,10,0,5,11,6,4,3,2,6920,6953,2
Task 6920,Job 1,6,10,2,8,1,8,14,6,2,4,0,6920,6953,20
Task 6921,Job 0,3,9,4,9,1,7,12,5,4,3,0,6921,6954,4
Task 6921,Job 1,8,5,1,7,0,9,15,6,1,2,1,6921,6954,19
Task 6922,Job 0,7,5,1,6,0,8,13,5,1,1,0,6922,6956,15
Task 6922,Job 1,12,5,1,12,0,13,24,11,1,3,0,6922,6956,3
Task 6923,Job 0,8,5,4,6,0,12,14,2,4,2,2,6923,6957,11
Task 6923,Job 1,13,4,3,9,0,16,22,6,3,2,1,6923,6957,19
Task 6924,Job 0,1,5,1,6,0,2,7,5,1,2,0,6924,6957,14
Task 6924,Job 1,6,6,1,12,1,7,18,11,1,3,2,6924,6957,12
Task 6925,Job 0,2,7,4,9,0,6,11,5,4,1,0,6925,6958,2
Task 6925,Job 1,7,9,1,6,0,8,13,5,1,2,2,6925,6958,5
Task 6926,Job 0,2,8,1,7,0,3,9,6,1,4,2,6926,6959,7
Task 6926,Job 1,7,7,3,12,0,10,19,9,3,2,0,6926,6959,16
Task 6927,Job 0,3,9,4,10,0,7,13,6,4,3,0,6927,6961,14
Task 6927,Job 1,8,8,3,10,0,11,18,7,3,3,1,6927,6961,5
Task 6928,Job 0,4,8,2,7,1,6,11,5,2,4,1,6928,6962,5
Task 6928,Job 1,9,8,4,12,0,13,21,8,4,1,0,6928,6962,16
Task 6929,Job 0,8,6,1,11,0,9,19,10,1,3,0,6929,6963,10
Task 6929,Job 1,13,4,1,12,1,14,25,11,1,2,2,6929,6963,11
Task 6930,Job 0,1,7,3,6,0,4,7,3,3,1,0,6930,6964,2
Task 6930,Job 1,6,6,3,7,0,9,13,4,3,2,0,6930,6964,10
Task 6931,Job 0,9,7,4,8,0,13,17,4,4,1,2,6931,6965,5
Task 6931,Job 1,14,9,2,11,0,16,25,9,2,4,1,6931,6965,16
Task 6932,Job 0,10,5,2,7,1,12,17,5,2,4,2,6932,6965,15
Task 6932,Job 1,15,9,3,9,0,18,24,6,3,1,2,6932,6965,2
Task 6933,Job 0,2,5,1,9,1,3,11,8,1,2,0,6933,6967,12
Task 6933,Job 1,7,4,3,8,0,10,15,5,3,2,2,6933,6967,13
Task 6934,Job 0,10,5,4,7,0,14,17,3,4,1,0,6934,6967,11
Task 6934,Job 1,15,8,4,12,0,19,27,8,4,2,0,6934,6967,16
Task 6935,Job 0,1,9,1,11,1,2,12,10,1,2,1,6935,6968,9
Task 6935,Job 1,6,4,4,8,0,10,14,4,4,4,0,6935,6968,2
Task 6936,Job 0,9,6,3,6,0,12,15,3,3,2,2,6936,6969,14
Task 6936,Job 1,14,5,3,7,0,17,21,4,3,4,0,6936,6969,6
Task 6937,Job 0,3,5,3,12,0,6,15,9,3,3,1,6937,6970,14
Task 6937,Job 1,8,5,2,7,0,10,15,5,2,4,1,6937,6970,19
Task 6938,Job 0,10,7,1,12,1,11,22,11,1,1,0,6938,6971,15
Task 6938,Job 1,15,9,3,8,0,18,23,5,3,4,0,6938,6971,14
Task 6939,Job 0,7,7,1,7,1,8,14,6,1,2,2,6939,6973,3
Task 6939,Job 1,12,8,4,8,1,16,20,4,4,3,0,6939,6973,8
Task 6940,Job 0,8,9,3,6,0,11,14,3,3,3,2,6940,6974,14
Task 6940,Job 1,13,7,2,6,1,15,19,4,2,2,1,6940,6974,15
Task 6941,Job 0,1,9,4,7,0,5,8,3,4,1,1,6941,6975,10
Task 6941,Job 1,6,4,4,9,0,10,15,5,4,3,0,6941,6975,7
Task 6942,Job 0,1,7,4,9,0,5,10,5,4,3,0,6942,6975,2
Task 6942,Job 1,6,5,3,6,0,9,12,3,3,1,2,6942,6975,2
Task 6943,Job 0,1,10,2,8,0,3,9,6,2,1,0,6943,6976,19
Task 6943,Job 1,6,9,1,8,0,7,14,7,1,3,0,6943,6976,2
Task 6944,Job 0,9,10,3,10,0,12,19,7,3,2,0,6944,6978,13
Task 6944,Job 1,14,6,3,11,0,17,25,8,3,3,2,6944,6978,8
Task 6945,Job 0,6,4,4,12,0,10,18,8,4,1,1,6945,6978,3
Task 6945,Job 1,11,6,4,10,0,15,21,6,4,1,1,6945,6978,15
Task 6946,Job 0,6,4,3,9,0,9,15,6,3,2,0,6946,6980,7
Task 6946,Job 1,11,10,4,9,0,15,20,5,4,2,1,6946,6980,14
Task 6947,Job 0,5,6,2,7,0,7,12,5,2,1,2,6947,6980,6
Task 6947,Job 1,10,5,1,8,0,11,18,7,1,4,0,6947,6980,18
Task 6948,Job 0,4,8,1,6,0,5,10,5,1,3,1,6948,6982,14
Task 6948,Job 1,9,8,4,8,0,13,17,4,4,1,0,6948,6982,20
Task 6949,Job 0,10,10,2,9,0,12,19,7,2,4,2,6949,6983,12
Task 6949,Job 1,15,10,2,11,0,17,26,9,2,4,0,6949,6983,10
Task 6950,Job 0,8,8,4,7,1,12,15,3,4,1,2,6950,6983,9
Task 6950,Job 1,13,6,2,10,0,15,23,8,2,2,1,6950,6983,8
Task 6951,Job 0,9,10,1,11,0,10,20,10,1,1,0,6951,6984,18
Task 6951,Job 1,14,6,3,8,0,17,22,5,3,3,2,6951,6984,15
Task 6952,Job 0,7,7,3,12,0,10,19,9,3,4,2,6952,6985,19
Task 6952,Job 1,12,9,2,8,0,14,20,6,2,4,0,6952,6985,3
Task 6953,Job 0,10,5,3,12,0,13,22,9,3,3,1,6953,6987,2
Task 6953,Job 1,15,4,4,9,0,19,24,5,4,4,2,6953,6987,5
Task 6954,Job 0,1,6,1,12,1,2,13,11,1,3,0,6954,6988,6
Task 6954,Job 1,6,7,2,10,0,8,16,8,2,2,2,6954,6988,20
Task 6955,Job 0,7,10,2,7,0,9,14,5,2,1,0,6955,6988,7
Task 6955,Job 1,12,6,3,6,0,15,18,3,3,1,1,6955,6988,6
Task 6956,Job 0,4,7,3,12,0,7,16,9,3,4,2,6956,6989,14
Task 6956,Job 1,9,9,2,10,0,11,19,8,2,4,1,6956,6989,11
Task 6957,Job 0,10,9,1,6,1,11,16,5,1,4,0,6957,6991,5
Task 6957,Job 1,15,4,2,11,0,17,26,9,2,3,1,6957,6991,17
Task 6958,Job 0,7,6,3,11,0,10,18,8,3,2,0,6958,6992,17
Task 6958,Job 1,12,10,1,12,0,13,24,11,1,1,0,6958,6992,14
Task 6959,Job 0,3,8,2,9,0,5,12,7,2,1,1,6959,6993,18
Task 6959,Job 1,8,6,1,8,0,9,16,7,1,4,1,6959,6993,20
Task 6960,Job 0,9,9,1,9,0,10,18,8,1,1,1,6960,6994,11
Task 6960,Job 1,14,6,2,9,1,16,23,7,2,4,0,6960,6994,20
Task 6961,Job 0,10,9,4,6,0,14,16,2,4,1,0,6961,6995,15
Task 6961,Job 1,15,9,2,6,0,17,21,4,2,2,0,6961,6995,17
Task 6962,Job 0,6,10,4,12,1,10,18,8,4,1,0,6962,6995,3
Task 6962,Job 1,11,6,4,9,0,15,20,5,4,2,0,6962,6995,16
Task 6963,Job 0,9,8,4,10,1,13,19,6,4,3,0,6963,6996,19
Task 6963,Job 1,14,5,4,6,0,18,20,2,4,3,2,6963,6996,5
Task 6964,Job 0,9,9,1,8,0,10,17,7,1,4,2,6964,6998,11
Task 6964,Job 1,14,9,2,9,1,16,23,7,2,2,2,6964,6998,18
Task 6965,Job 0,8,6,3,11,0,11,19,8,3,1,0,6965,6999,15
Task 6965,Job 1,13,5,3,10,0,16,23,7,3,3,2,6965,6999,13
Task 6966,Job 0,4,10,4,8,1,8,12,4,4,2,1,6966,6999,18
Task 6966,Job 1,9,7,2,11,0,11,20,9,2,4,0,6966,6999,12
Task 6967,Job 0,3,5,1,11,0,4,14,10,1,3,2,6967,7000,14
Task 6967,Job 1,8,7,1,10,0,9,18,9,1,4,0,6967,7000,7
Task 6968,Job 0,3,8,3,12,0,6,15,9,3,3,0,6968,7002,14
Task 6968,Job 1,8,4,1,12,0,9,20,11,1,3,0,6968,7002,4
Task 6969,Job 0,6,5,4,10,0,10,16,6,4,4,2,6969,7003,2
Task 6969,Job 1,11,9,2,8,0,13,19,6,2,2,0,6969,7003,7
Task 6970,Job 0,10,5,4,11,1,14,21,7,4,2,1,6970,7003,4
Task 6970,Job 1,15,5,4,11,1,19,26,7,4,4,1,6970,7003,17
Task 6971,Job 0,8,10,1,11,0,9,19,10,1,2,0,6971,7005,12
Task 6971,Job 1,13,8,2,12,0,15,25,10,2,1,2,6971,7005,19
Task 6972,Job 0,1,5,4,9,1,5,10,5,4,4,2,6972,7006,11
Task 6972,Job 1,6,10,1,12,0,7,18,11,1,4,1,6972,7006,7
Task 6973,Job 0,4,8,2,6,0,6,10,4,2,2,2,6973,7006,13
Task 6973,Job 1,9,7,1,12,0,10,21,11,1,3,0,6973,7006,7
Task 6974,Job 0,8,7,4,9,0,12,17,5,4,3,2,6974,7007,11
Task 6974,Job 1,13,5,3,6,1,16,19,3,3,1,2,6974,7007,7
Task 6975,Job 0,9,7,1,8,1,10,17,7,1,3,0,6975,7008,16
Task 6975,Job 1,14,7,2,11,0,16,25,9,2,2,1,6975,7008,12
Task 6976,Job 0,9,8,4,9,1,13,18,5,4,3,1,6976,7010,18
Task 6976,Job 1,14,5,1,6,0,15,20,5,1,3,1,6976,7010,7
Task 6977,Job 0,5,7,1,11,1,6,16,10,1,1,2,6977,7011,16
Task 6977,Job 1,10,10,4,7,0,14,17,3,4,1,1,6977,7011,17
Task 6978,Job 0,3,8,1,6,0,4,9,5,1,1,0,6978,7012,16
Task 6978,Job 1,8,9,1,12,0,9,20,11,1,1,2,6978,7012,16
Task 6979,Job 0,2,7,2,9,1,4,11,7,2,1,1,6979,7013,14
Task 6979,Job 1,7,6,3,10,1,10,17,7,3,3,1,6979,7013,10
Task 6980,Job 0,6,10,4,7,0,10,13,3,4,4,2,6980,7013,12
Task 6980,Job 1,11,6,4,10,1,15,21,6,4,1,1,6980,7013,13
Task 6981,Job 0,9,7,1,7,0,10,16,6,1,2,1,6981,7014,20
Task 6981,Job 1,14,8,3,6,0,17,20,3,3,1,2,6981,7014,3
Task 6982,Job 0,2,4,3,11,0,5,13,8,3,1,2,6982,7016,2
Task 6982,Job 1,7,4,1,7,1,8,14,6,1,4,0,6982,7016,14
Task 6983,Job 0,8,10,4,8,0,12,16,4,4,1,0,6983,7017,5
Task 6983,Job 1,13,4,2,7,1,15,20,5,2,4,0,6983,7017,2
Task 6984,Job 0,6,8,4,9,1,10,15,5,4,2,0,6984,7017,13
Task 6984,Job 1,11,8,3,7,0,14,18,4,3,2,2,6984,7017,2
Task 6985,Job 0,5,6,1,11,0,6,16,10,1,2,0,6985,7019,4
Task 6985,Job 1,10,4,3,8,0,13,18,5,3,1,1,6985,7019,19
Task 6986,Job 0,3,9,2,10,0,5,13,8,2,1,2,6986,7019,9
Task 6986,Job 1,8,8,2,10,0,10,18,8,2,2,2,6986,7019,5
Task 6987,Job 0,8,8,4,8,0,12,16,4,4,3,0,6987,7020,20
Task 6987,Job 1,13,5,1,8,0,14,21,7,1,2,2,6987,7020,19
Task 6988,Job 0,9,6,3,9,0,12,18,6,3,4,2,6988,7022,15
Task 6988,Job 1,14,9,3,8,1,17,22,5,3,1,2,6988,7022,14
Task 6989,Job 0,4,9,1,11,1,5,15,10,1,4,1,6989,7022,6
Task 6989,Job 1,9,10,2,10,1,11,19,8,2,2,0,6989,7022,17
Task 6990,Job 0,8,10,1,7,0,9,15,6,1,4,1,6990,7024,10
Task 6990,Job 1,13,9,1,7,0,14,20,6,1,1,0,6990,7024,10
Task 6991,Job 0,5,6,3,9,0,8,14,6,3,4,0,6991,7025,2
Task 6991,Job 1,10,4,2,9,0,12,19,7,2,1,0,6991,7025,13
Task 6992,Job 0,3,4,4,12,0,7,15,8,4,2,2,6992,7025,5
Task 6992,Job 1,8,10,1,12,0,9,20,11,1,1,0,6992,7025,16
Task 6993,Job 0,8,7,2,8,0,10,16,6,2,3,1,6993,7026,10
Task 6993,Job 1,13,5,1,8,0,14,21,7,1,3,2,6993,7026,6
Task 6994,Job 0,8,10,2,6,1,10,14,4,2,3,1,6994,7028,10
Task 6994,Job 1,13,7,1,7,1,14,20,6,1,1,0,6994,7028,17
Task 6995,Job 0,10,5,4,6,0,14,16,2,4,4,1,6995,7028,8
Task 6995,Job 1,15,6,3,6,0,18,21,3,3,3,1,6995,7028,2
Task 6996,Job 0,1,7,4,7,1,5,8,3,4,3,1,6996,7029,8
Task 6996,Job 1,6,9,3,7,1,9,13,4,3,2,0,6996,7029,9
Task 6997,Job 0,3,9,3,9,0,6,12,6,3,2,2,6997,7030,4
Task 6997,Job 1,8,5,1,8,0,9,16,7,1,4,2,6997,7030,4
Task 6998,Job 0,3,4,4,10,0,7,13,6,4,3,2,6998,7031,18
Task 6998,Job 1,8,4,3,12,0,11,20,9,3,4,0,6998,7031,17
Task 6999,Job 0,8,7,4,6,0,12,14,2,4,2,2,6999,7033,18
Task 6999,Job 1,13,6,1,6,1,14,19,5,1,4,1,6999,7033,9
Task 7000,Job 0,8,7,4,11,0,12,19,7,4,2,0,7000,7033,16
Task 7000,Job 1,13,10,1,9,1,14,22,8,1,1,1,7000,7033,8
Task 7001,Job 0,5,4,4,9,0,9,14,5,4,1,0,7001,7035,6
Task 7001,Job 1,10,10,4,8,0,14,18,4,4,3,0,7001,7035,6
Task 7002,Job 0,9,4,2,7,0,11,16,5,2,1,0,7002,7035,18
Task 7002,Job 1,14,5,4,12,0,18,26,8,4,3,1,7002,7035,7
Task 7003,Job 0,4,5,1,7,1,5,11,6,1,1,1,7003,7036,20
Task 7003,Job 1,9,7,4,9,0,13,18,5,4,1,2,7003,7036,15
Task 7004,Job 0,2,4,1,6,0,3,8,5,1,2,1,7004,7038,17
Task 7004,Job 1,7,9,4,12,0,11,19,8,4,4,2,7004,7038,8
Task 7005,Job 0,9,4,1,9,0,10,18,8,1,2,2,7005,7039,13
Task 7005,Job 1,14,8,3,12,1,17,26,9,3,3,1,7005,7039,12
Task 7006,Job 0,8,4,1,10,0,9,18,9,1,2,2,7006,7040,12
Task 7006,Job 1,13,6,3,8,1,16,21,5,3,3,1,7006,7040,16
Task 7007,Job 0,8,4,2,7,0,10,15,5,2,4,2,7007,7041,19
Task 7007,Job 1,13,8,1,7,0,14,20,6,1,2,2,7007,7041,14
Task 7008,Job 0,8,5,1,12,1,9,20,11,1,1,2,7008,7041,5
Task 7008,Job 1,13,8,1,8,1,14,21,7,1,2,2,7008,7041,12
Task 7009,Job 0,10,5,4,9,0,14,19,5,4,2,1,7009,7042,20
Task 7009,Job 1,15,9,1,11,0,16,26,10,1,4,2,7009,7042,10
Task 7010,Job 0,3,10,1,11,1,4,14,10,1,4,2,7010,7043,8
Task 7010,Job 1,8,7,1,6,0,9,14,5,1,4,1,7010,7043,8
Task 7011,Job 0,9,6,1,10,0,10,19,9,1,3,1,7011,7045,15
Task 7011,Job 1,14,6,4,7,0,18,21,3,4,4,2,7011,7045,2
Task 7012,Job 0,4,5,1,6,0,5,10,5,1,4,0,7012,7046,16
Task 7012,Job 1,9,5,3,10,0,12,19,7,3,2,0,7012,7046,12
Task 7013,Job 0,9,6,1,11,0,10,20,10,1,1,0,7013,7047,4
Task 7013,Job 1,14,6,2,8,0,16,22,6,2,4,0,7013,7047,18
Task 7014,Job 0,1,8,1,11,0,2,12,10,1,1,2,7014,7047,20
Task 7014,Job 1,6,6,3,10,1,9,16,7,3,1,1,7014,7047,19
Task 7015,Job 0,8,4,3,6,1,11,14,3,3,4,2,7015,7048,12
Task 7015,Job 1,13,6,4,12,1,17,25,8,4,2,2,7015,7048,11
Task 7016,Job 0,9,6,4,6,0,13,15,2,4,1,1,7016,7049,11
Task 7016,Job 1,14,4,1,6,1,15,20,5,1,1,0,7016,7049,12
Task 7017,Job 0,2,5,1,9,0,3,11,8,1,4,1,7017,7050,6
Task 7017,Job 1,7,5,2,8,0,9,15,6,2,2,0,7017,7050,7
Task 7018,Job 0,7,10,2,9,0,9,16,7,2,1,0,7018,7051,13
Task 7018,Job 1,12,7,3,6,0,15,18,3,3,3,1,7018,7051,16
Task 7019,Job 0,8,5,3,9,1,11,17,6,3,3,2,7019,7052,10
Task 7019,Job 1,13,7,4,12,0,17,25,8,4,3,2,7019,7052,19
Task 7020,Job 0,10,10,4,12,0,14,22,8,4,2,2,7020,7053,18
Task 7020,Job 1,15,7,2,8,0,17,23,6,2,1,2,7020,7053,13
Task 7021,Job 0,7,8,3,9,0,10,16,6,3,4,0,7021,7055,12
Task 7021,Job 1,12,4,2,11,1,14,23,9,2,3,0,7021,7055,2
Task 7022,Job 0,10,10,3,12,0,13,22,9,3,2,2,7022,7056,19
Task 7022,Job 1,15,6,2,8,0,17,23,6,2,3,2,7022,7056,11
Task 7023,Job 0,1,4,2,12,0,3,13,10,2,1,2,7023,7057,20
Task 7023,Job 1,6,4,3,6,0,9,12,3,3,2,2,7023,7057,11
Task 7024,Job 0,10,5,3,10,1,13,20,7,3,2,0,7024,7057,19
Task 7024,Job 1,15,10,2,10,1,17,25,8,2,2,1,7024,7057,17
Task 7025,Job 0,7,9,1,7,0,8,14,6,1,2,1,7025,7058,2
Task 7025,Job 1,12,4,1,8,1,13,20,7,1,2,1,7025,7058,18
Task 7026,Job 0,9,5,3,8,0,12,17,5,3,3,2,7026,7060,6
Task 7026,Job 1,14,9,3,12,1,17,26,9,3,3,0,7026,7060,4
Task 7027,Job 0,8,9,2,12,0,10,20,10,2,1,0,7027,7060,16
Task 7027,Job 1,13,10,1,7,0,14,20,6,1,3,2,7027,7060,13
Task 7028,Job 0,1,7,1,7,0,2,8,6,1,1,0,7028,7062,20
Task 7028,Job 1,6,8,1,6,1,7,12,5,1,1,1,7028,7062,15
Task 7029,Job 0,4,5,1,7,0,5,11,6,1,3,0,7029,7062,7
Task 7029,Job 1,9,10,3,11,1,12,20,8,3,1,1,7029,7062,14
Task 7030,Job 0,2,6,3,6,1,5,8,3,3,2,0,7030,7063,5
Task 7030,Job 1,7,9,2,8,0,9,15,6,2,1,0,7030,7063,17
Task 7031,Job 0,3,9,3,11,0,6,14,8,3,3,1,7031,7064,8
Task 7031,Job 1,8,4,2,11,0,10,19,9,2,4,1,7031,7064,6
Task 7032,Job 0,10,10,3,6,0,13,16,3,3,3,0,7032,7066,10
Task 7032,Job 1,15,4,4,12,0,19,27,8,4,1,0,7032,7066,6
Task 7033,Job 0,8,4,4,8,0,12,16,4,4,1,1,7033,7067,4
Task 7033,Job 1,13,7,4,12,0,17,25,8,4,4,2,7033,7067,20
Task 7034,Job 0,5,5,2,9,0,7,14,7,2,2,1,7034,7068,13
Task 7034,Job 1,10,7,3,11,0,13,21,8,3,3,1,7034,7068,19
Task 7035,Job 0,8,7,3,8,0,11,16,5,3,1,2,7035,7069,18
Task 7035,Job 1,13,6,2,12,0,15,25,10,2,4,1,7035,7069,15
Task 7036,Job 0,5,7,1,11,0,6,16,10,1,2,0,7036,7069,20
Task 7036,Job 1,10,6,4,7,0,14,17,3,4,4,1,7036,7069,2
Task 7037,Job 0,7,7,3,8,1,10,15,5,3,2,0,7037,7070,19
Task 7037,Job 1,12,7,1,6,1,13,18,5,1,3,0,7037,7070,19
Task 7038,Job 0,2,9,1,6,1,3,8,5,1,1,0,7038,7072,14
Task 7038,Job 1,7,8,4,9,0,11,16,5,4,2,1,7038,7072,20
Task 7039,Job 0,5,5,3,11,0,8,16,8,3,1,2,7039,7073,10
Task 7039,Job 1,10,8,3,6,0,13,16,3,3,1,0,7039,7073,9
Task 7040,Job 0,10,5,3,11,1,13,21,8,3,3,1,7040,7073,4
Task 7040,Job 1,15,10,2,12,1,17,27,10,2,3,2,7040,7073,2
Task 7041,Job 0,2,8,1,8,0,3,10,7,1,4,1,7041,7074,8
Task 7041,Job 1,7,10,3,11,0,10,18,8,3,3,0,7041,7074,2
Task 7042,Job 0,4,5,1,11,1,5,15,10,1,4,1,7042,7075,9
Task 7042,Job 1,9,10,2,8,1,11,17,6,2,3,1,7042,7075,8
Task 7043,Job 0,2,4,4,6,0,6,8,2,4,1,0,7043,7076,19
Task 7043,Job 1,7,7,1,8,0,8,15,7,1,3,1,7043,7076,3
Task 7044,Job 0,3,7,4,8,0,7,11,4,4,2,2,7044,7078,15
Task 7044,Job 1,8,7,3,7,0,11,15,4,3,3,2,7044,7078,13
Task 7045,Job 0,5,10,3,12,1,8,17,9,3,3,2,7045,7078,9
Task 7045,Job 1,10,9,3,11,0,13,21,8,3,3,0,7045,7078,6
Task 7046,Job 0,3,5,1,8,0,4,11,7,1,4,1,7046,7080,19
Task 7046,Job 1,8,6,2,7,0,10,15,5,2,4,1,7046,7080,7
Task 7047,Job 0,7,6,4,7,1,11,14,3,4,3,1,7047,7080,7
Task 7047,Job 1,12,9,2,12,0,14,24,10,2,4,0,7047,7080,9
Task 7048,Job 0,7,8,1,10,0,8,17,9,1,1,2,7048,7082,9
Task 7048,Job 1,12,10,4,11,0,16,23,7,4,1,0,7048,7082,15
Task 7049,Job 0,2,10,3,10,1,5,12,7,3,2,0,7049,7083,15
Task 7049,Job 1,7,4,1,10,0,8,17,9,1,2,1,7049,7083,10
Task 7050,Job 0,2,4,4,10,0,6,12,6,4,1,0,7050,7083,12
Task 7050,Job 1,7,4,2,6,0,9,13,4,2,3,2,7050,7083,2
Task 7051,Job 0,2,7,2,10,1,4,12,8,2,1,2,7051,7085,16
Task 7051,Job 1,7,5,3,10,0,10,17,7,3,4,1,7051,7085,2
Task 7052,Job 0,9,8,4,7,0,13,16,3,4,2,0,7052,7086,9
Task 7052,Job 1,14,7,1,7,1,15,21,6,1,1,1,7052,7086,8
Task 7053,Job 0,7,6,4,7,0,11,14,3,4,2,1,7053,7087,9
Task 7053,Job 1,12,7,4,11,0,16,23,7,4,3,2,7053,7087,8
Task 7054,Job 0,6,5,1,12,0,7,18,11,1,1,1,7054,7087,6
Task 7054,Job 1,11,5,3,10,0,14,21,7,3,4,1,7054,7087,16
Task 7055,Job 0,10,9,1,9,0,11,19,8,1,4,2,7055,7089,16
Task 7055,Job 1,15,8,2,12,0,17,27,10,2,3,1,7055,7089,18
Task 7056,Job 0,3,10,1,9,0,4,12,8,1,1,0,7056,7089,13
Task 7056,Job 1,8,5,1,11,0,9,19,10,1,2,2,7056,7089,13
Task 7057,Job 0,4,10,3,7,1,7,11,4,3,2,2,7057,7090,9
Task 7057,Job 1,9,8,4,7,0,13,16,3,4,2,0,7057,7090,16
Task 7058,Job 0,1,7,1,11,1,2,12,10,1,2,1,7058,7092,16
Task 7058,Job 1,6,10,3,10,0,9,16,7,3,3,1,7058,7092,4
Task 7059,Job 0,10,6,2,6,1,12,16,4,2,4,2,7059,7092,11
Task 7059,Job 1,15,5,3,9,0,18,24,6,3,2,1,7059,7092,15
Task 7060,Job 0,5,9,4,10,1,9,15,6,4,4,0,7060,7094,3
Task 7060,Job 1,10,6,4,11,0,14,21,7,4,4,1,7060,7094,10
Task 7061,Job 0,3,8,1,10,0,4,13,9,1,1,2,7061,7095,8
Task 7061,Job 1,8,7,3,8,0,11,16,5,3,3,0,7061,7095,16
Task 7062,Job 0,2,7,4,6,0,6,8,2,4,3,0,7062,7096,11
Task 7062,Job 1,7,6,4,11,1,11,18,7,4,3,2,7062,7096,18
Task 7063,Job 0,5,5,2,12,1,7,17,10,2,4,2,7063,7097,3
Task 7063,Job 1,10,4,1,11,0,11,21,10,1,4,0,7063,7097,5
Task 7064,Job 0,7,8,3,12,0,10,19,9,3,1,1,7064,7097,19
Task 7064,Job 1,12,10,2,9,0,14,21,7,2,4,1,7064,7097,7
Task 7065,Job 0,1,7,3,12,0,4,13,9,3,4,2,7065,7098,4
Task 7065,Job 1,6,7,4,10,0,10,16,6,4,4,2,7065,7098,10
Task 7066,Job 0,1,4,4,6,0,5,7,2,4,3,2,7066,7100,2
Task 7066,Job 1,6,6,3,10,1,9,16,7,3,1,1,7066,7100,18
Task 7067,Job 0,1,5,4,11,0,5,12,7,4,1,0,7067,7100,17
Task 7067,Job 1,6,7,4,8,1,10,14,4,4,1,2,7067,7100,2
Task 7068,Job 0,9,5,2,6,0,11,15,4,2,1,1,7068,7102,6
Task 7068,Job 1,14,7,3,8,0,17,22,5,3,1,2,7068,7102,7
Task 7069,Job 0,8,6,1,11,0,9,19,10,1,4,1,7069,7103,11
Task 7069,Job 1,13,5,3,6,0,16,19,3,3,3,0,7069,7103,9
Task 7070,Job 0,9,9,2,12,0,11,21,10,2,3,1,7070,7103,17
Task 7070,Job 1,14,7,3,6,0,17,20,3,3,4,0,7070,7103,10
Task 7071,Job 0,5,8,2,11,1,7,16,9,2,2,2,7071,7105,17
Task 7071,Job 1,10,7,3,8,1,13,18,5,3,3,1,7071,7105,13
Task 7072,Job 0,10,7,3,11,0,13,21,8,3,1,2,7072,7106,2
Task 7072,Job 1,15,5,1,10,0,16,25,9,1,4,2,7072,7106,5
Task 7073,Job 0,7,10,2,8,0,9,15,6,2,2,1,7073,7107,15
Task 7073,Job 1,12,7,1,11,1,13,23,10,1,2,0,7073,7107,11
Task 7074,Job 0,1,5,3,10,0,4,11,7,3,4,0,7074,7107,10
Task 7074,Job 1,6,10,2,10,0,8,16,8,2,3,0,7074,7107,15
Task 7075,Job 0,9,9,1,6,0,10,15,5,1,3,0,7075,7108,4
Task 7075,Job 1,14,8,2,12,0,16,26,10,2,2,0,7075,7108,11
Task 7076,Job 0,10,9,1,9,0,11,19,8,1,3,1,7076,7109,4
Task 7076,Job 1,15,10,2,6,0,17,21,4,2,2,2,7076,7109,12
Task 7077,Job 0,4,9,2,12,0,6,16,10,2,2,0,7077,7111,11
Task 7077,Job 1,9,6,3,11,1,12,20,8,3,2,2,7077,7111,16
Task 7078,Job 0,9,4,4,9,0,13,18,5,4,3,1,7078,7111,20
Task 7078,Job 1,14,4,1,12,0,15,26,11,1,4,0,7078,7111,14
Task 7079,Job 0,7,8,2,6,0,9,13,4,2,1,1,7079,7112,11
Task 7079,Job 1,12,6,2,8,0,14,20,6,2,1,2,7079,7112,18
Task 7080,Job 0,1,8,3,12,0,4,13,9,3,3,1,7080,7113,9
Task 7080,Job 1,6,5,4,11,0,10,17,7,4,3,2,7080,7113,2
Task 7081,Job 0,6,9,4,12,0,10,18,8,4,3,1,7081,7114,5
Task 7081,Job 1,11,4,3,9,0,14,20,6,3,3,0,7081,7114,18
Task 7082,Job 0,9,10,3,7,0,12,16,4,3,2,1,7082,7116,3
Task 7082,Job 1,14,6,4,11,0,18,25,7,4,1,2,7082,7116,19
Task 7083,Job 0,8,7,3,7,0,11,15,4,3,2,2,7083,7116,10
Task 7083,Job 1,13,8,3,8,0,16,21,5,3,4,1,7083,7116,3
Task 7084,Job 0,9,9,3,10,0,12,19,7,3,1,1,7084,7118,14
Task 7084,Job 1,14,7,1,9,0,15,23,8,1,1,1,7084,7118,7
Task 7085,Job 0,10,5,4,12,0,14,22,8,4,4,1,7085,7119,16
Task 7085,Job 1,15,6,2,7,0,17,22,5,2,2,2,7085,7119,15
Task 7086,Job 0,9,4,4,10,0,13,19,6,4,1,0,7086,7119,15
Task 7086,Job 1,14,10,1,9,1,15,23,8,1,3,1,7086,7119,16
Task 7087,Job 0,2,10,1,11,0,3,13,10,1,4,1,7087,7121,16
Task 7087,Job 1,7,6,1,11,0,8,18,10,1,1,2,7087,7121,17
Task 7088,Job 0,8,10,3,8,0,11,16,5,3,2,0,7088,7122,13
Task 7088,Job 1,13,8,4,10,0,17,23,6,4,2,1,7088,7122,8
Task 7089,Job 0,8,9,1,10,0,9,18,9,1,1,2,7089,7122,17
Task 7089,Job 1,13,6,1,9,0,14,22,8,1,4,1,7089,7122,15
Task 7090,Job 0,4,8,4,8,0,8,12,4,4,4,0,7090,7124,3
Task 7090,Job 1,9,8,1,11,0,10,20,10,1,2,2,7090,7124,17
Task 7091,Job 0,4,4,2,12,1,6,16,10,2,1,0,7091,7125,18
Task 7091,Job 1,9,9,1,6,0,10,15,5,1,2,0,7091,7125,16
Task 7092,Job 0,10,8,4,8,0,14,18,4,4,1,0,7092,7125,17
Task 7092,Job 1,15,9,4,9,1,19,24,5,4,2,0,7092,7125,7
Task 7093,Job 0,1,6,2,11,0,3,12,9,2,1,2,7093,7126,11
Task 7093,Job 1,6,8,1,8,0,7,14,7,1,3,2,7093,7126,7
Task 7094,Job 0,8,7,2,8,0,10,16,6,2,3,1,7094,7128,5
Task 7094,Job 1,13,8,2,8,1,15,21,6,2,3,1,7094,7128,16
Task 7095,Job 0,2,6,2,9,0,4,11,7,2,1,1,7095,7129,6
Task 7095,Job 1,7,7,2,11,1,9,18,9,2,4,2,7095,7129,15
Task 7096,Job 0,5,8,2,6,0,7,11,4,2,1,0,7096,7129,18
Task 7096,Job 1,10,5,4,9,0,14,19,5,4,1,1,7096,7129,17
Task 7097,Job 0,1,5,2,10,1,3,11,8,2,3,1,7097,7130,12
Task 7097,Job 1,6,5,4,10,1,10,16,6,4,4,1,7097,7130,5
Task 7098,Job 0,9,6,4,7,1,13,16,3,4,4,0,7098,7131,18
Task 7098,Job 1,14,4,2,7,1,16,21,5,2,3,1,7098,7131,4
Task 7099,Job 0,5,6,1,11,0,6,16,10,1,2,0,7099,7132,6
Task 7099,Job 1,10,6,1,6,0,11,16,5,1,2,0,7099,7132,4
Task 7100,Job 0,10,8,2,6,0,12,16,4,2,4,1,7100,7133,16
Task 7100,Job 1,15,7,3,7,0,18,22,4,3,2,2,7100,7133,18
Task 7101,Job 0,9,7,4,12,0,13,21,8,4,4,0,7101,7134,19
Task 7101,Job 1,14,7,1,7,0,15,21,6,1,2,0,7101,7134,16
Task 7102,Job 0,10,5,4,12,0,14,22,8,4,3,1,7102,7136,16
Task 7102,Job 1,15,7,3,6,1,18,21,3,3,2,1,7102,7136,11
Task 7103,Job 0,5,7,4,11,0,9,16,7,4,4,2,7103,7137,18
Task 7103,Job 1,10,4,4,12,0,14,22,8,4,4,2,7103,7137,13
Task 7104,Job 0,6,5,4,10,0,10,16,6,4,2,0,7104,7138,16
Task 7104,Job 1,11,10,4,7,0,15,18,3,4,2,2,7104,7138,20
Task 7105,Job 0,3,6,1,12,0,4,15,11,1,3,1,7105,7138,9
Task 7105,Job 1,8,6,1,6,0,9,14,5,1,1,0,7105,7138,10
Task 7106,Job 0,3,10,2,6,0,5,9,4,2,2,0,7106,7139,3
Task 7106,Job 1,8,7,1,7,0,9,15,6,1,2,0,7106,7139,16
Task 7107,Job 0,3,9,2,6,0,5,9,4,2,4,2,7107,7141,10
Task 7107,Job 1,8,4,1,8,0,9,16,7,1,4,1,7107,7141,17
Task 7108,Job 0,1,7,4,6,0,5,7,2,4,2,2,7108,7141,2
Task 7108,Job 1,6,8,1,11,0,7,17,10,1,4,1,7108,7141,16
Task 7109,Job 0,4,4,2,6,1,6,10,4,2,2,2,7109,7142,14
Task 7109,Job 1,9,7,4,7,0,13,16,3,4,3,1,7109,7142,11
Task 7110,Job 0,10,4,2,7,0,12,17,5,2,3,0,7110,7144,16
Task 7110,Job 1,15,4,3,6,0,18,21,3,3,1,0,7110,7144,12
Task 7111,Job 0,8,6,1,9,0,9,17,8,1,4,2,7111,7145,9
Task 7111,Job 1,13,8,1,6,0,14,19,5,1,3,2,7111,7145,6
Task 7112,Job 0,10,4,2,9,0,12,19,7,2,1,0,7112,7146,9
Task 7112,Job 1,15,4,3,7,0,18,22,4,3,4,0,7112,7146,2
Task 7113,Job 0,4,5,2,8,0,6,12,6,2,2,1,7113,7147,11
Task 7113,Job 1,9,6,3,9,0,12,18,6,3,2,2,7113,7147,14
Task 7114,Job 0,8,8,4,8,0,12,16,4,4,1,2,7114,7148,14
Task 7114,Job 1,13,9,4,6,0,17,19,2,4,3,2,7114,7148,6
Task 7115,Job 0,9,5,1,7,1,10,16,6,1,3,2,7115,7148,19
Task 7115,Job 1,14,9,2,8,0,16,22,6,2,4,2,7115,7148,11
Task 7116,Job 0,9,4,3,6,1,12,15,3,3,3,1,7116,7149,6
Task 7116,Job 1,14,10,4,8,0,18,22,4,4,2,0,7116,7149,13
Task 7117,Job 0,6,10,3,9,0,9,15,6,3,1,1,7117,7151,14
Task 7117,Job 1,11,8,4,6,0,15,17,2,4,2,2,7117,7151,7
Task 7118,Job 0,3,7,4,11,0,7,14,7,4,3,1,7118,7151,5
Task 7118,Job 1,8,8,1,6,0,9,14,5,1,3,2,7118,7151,4
Task 7119,Job 0,8,9,2,6,0,10,14,4,2,1,0,7119,7153,9
Task 7119,Job 1,13,4,2,11,1,15,24,9,2,1,1,7119,7153,20
Task 7120,Job 0,1,8,2,10,1,3,11,8,2,1,2,7120,7153,20
Task 7120,Job 1,6,6,3,6,0,9,12,3,3,3,0,7120,7153,12
Task 7121,Job 0,9,6,1,7,1,10,16,6,1,4,2,7121,7154,6
Task 7121,Job 1,14,4,1,12,0,15,26,11,1,4,2,7121,7154,5
Task 7122,Job 0,2,9,3,9,1,5,11,6,3,4,0,7122,7155,13
Task 7122,Job 1,7,9,2,11,0,9,18,9,2,2,0,7122,7155,13
Task 7123,Job 0,4,7,3,8,1,7,12,5,3,2,2,7123,7157,3
Task 7123,Job 1,9,4,2,8,0,11,17,6,2,1,2,7123,7157,14
Task 7124,Job 0,8,7,1,10,0,9,18,9,1,3,0,7124,7157,5
Task 7124,Job 1,13,8,2,12,0,15,25,10,2,3,2,7124,7157,14
Task 7125,Job 0,9,8,4,7,1,13,16,3,4,4,2,7125,7159,15
Task 7125,Job 1,14,4,2,11,0,16,25,9,2,3,1,7125,7159,2
Task 7126,Job 0,5,8,2,11,1,7,16,9,2,2,0,7126,7160,17
Task 7126,Job 1,10,10,1,8,0,11,18,7,1,3,0,7126,7160,8
Task 7127,Job 0,10,5,2,11,0,12,21,9,2,3,0,7127,7161,18
Task 7127,Job 1,15,5,1,8,1,16,23,7,1,4,0,7127,7161,8
Task 7128,Job 0,1,8,2,6,0,3,7,4,2,2,2,7128,7161,10
Task 7128,Job 1,6,5,3,6,0,9,12,3,3,4,1,7128,7161,13
Task 7129,Job 0,9,6,2,7,0,11,16,5,2,1,1,7129,7162,4
Task 7129,Job 1,14,10,3,8,0,17,22,5,3,4,0,7129,7162,6
Task 7130,Job 0,5,4,3,10,1,8,15,7,3,2,2,7130,7164,10
Task 7130,Job 1,10,7,4,6,0,14,16,2,4,1,2,7130,7164,3
Task 7131,Job 0,2,9,1,12,0,3,14,11,1,3,2,7131,7165,11
Task 7131,Job 1,7,7,1,6,0,8,13,5,1,3,1,7131,7165,16
Task 7132,Job 0,3,9,2,8,0,5,11,6,2,2,2,7132,7165,11
Task 7132,Job 1,8,5,2,7,0,10,15,5,2,2,1,7132,7165,5
Task 7133,Job 0,6,6,4,12,0,10,18,8,4,3,2,7133,7167,6
Task 7133,Job 1,11,9,2,10,0,13,21,8,2,2,1,7133,7167,5
Task 7134,Job 0,9,10,1,12,0,10,21,11,1,1,1,7134,7168,12
Task 7134,Job 1,14,6,3,12,0,17,26,9,3,1,2,7134,7168,7
Task 7135,Job 0,3,4,2,7,1,5,10,5,2,3,0,7135,7168,8
Task 7135,Job 1,8,6,1,9,0,9,17,8,1,3,2,7135,7168,6
Task 7136,Job 0,3,7,2,10,1,5,13,8,2,4,0,7136,7169,11
Task 7136,Job 1,8,9,2,7,1,10,15,5,2,4,2,7136,7169,7
Task 7137,Job 0,1,10,4,7,0,5,8,3,4,1,0,7137,7170,13
Task 7137,Job 1,6,4,3,10,1,9,16,7,3,4,1,7137,7170,6
Task 7138,Job 0,10,4,4,7,0,14,17,3,4,2,0,7138,7172,7
Task 7138,Job 1,15,7,1,10,0,16,25,9,1,4,0,7138,7172,3
Task 7139,Job 0,7,6,1,8,0,8,15,7,1,2,0,7139,7172,10
Task 7139,Job 1,12,9,3,10,1,15,22,7,3,4,2,7139,7172,11
Task 7140,Job 0,10,6,4,10,0,14,20,6,4,4,1,7140,7173,6
Task 7140,Job 1,15,5,3,6,0,18,21,3,3,1,0,7140,7173,12
Task 7141,Job 0,6,7,1,8,0,7,14,7,1,2,0,7141,7174,17
Task 7141,Job 1,11,5,4,12,0,15,23,8,4,3,0,7141,7174,17
Task 7142,Job 0,6,6,4,6,0,10,12,2,4,4,2,7142,7176,7
Task 7142,Job 1,11,7,4,8,1,15,19,4,4,4,2,7142,7176,17
Task 7143,Job 0,4,7,4,10,1,8,14,6,4,1,0,7143,7177,13
Task 7143,Job 1,9,6,2,7,0,11,16,5,2,3,0,7143,7177,10
Task 7144,Job 0,1,8,3,9,1,4,10,6,3,4,0,7144,7177,2
Task 7144,Job 1,6,4,4,10,0,10,16,6,4,3,1,7144,7177,5
Task 7145,Job 0,6,9,4,10,0,10,16,6,4,2,1,7145,7178,13
Task 7145,Job 1,11,9,2,6,0,13,17,4,2,2,2,7145,7178,11
Task 7146,Job 0,9,10,1,11,0,10,20,10,1,2,2,7146,7179,8
Task 7146,Job 1,14,4,1,12,0,15,26,11,1,4,0,7146,7179,16
Task 7147,Job 0,8,5,1,8,0,9,16,7,1,3,0,7147,7181,12
Task 7147,Job 1,13,9,3,10,0,16,23,7,3,1,1,7147,7181,15
Task 7148,Job 0,5,7,4,7,0,9,12,3,4,1,0,7148,7182,2
Task 7148,Job 1,10,4,4,7,1,14,17,3,4,1,0,7148,7182,18
Task 7149,Job 0,9,9,4,11,1,13,20,7,4,4,1,7149,7183,11
Task 7149,Job 1,14,10,1,12,0,15,26,11,1,1,2,7149,7183,4
Task 7150,Job 0,3,10,1,11,0,4,14,10,1,2,0,7150,7183,8
Task 7150,Job 1,8,10,1,11,0,9,19,10,1,1,1,7150,7183,17
Task 7151,Job 0,7,9,1,8,0,8,15,7,1,2,0,7151,7185,19
Task 7151,Job 1,12,10,2,12,0,14,24,10,2,3,2,7151,7185,17
Task 7152,Job 0,9,6,1,8,1,10,17,7,1,2,2,7152,7185,5
Task 7152,Job 1,14,9,2,11,0,16,25,9,2,1,0,7152,7185,7
Task 7153,Job 0,9,4,1,10,0,10,19,9,1,3,1,7153,7186,10
Task 7153,Job 1,14,4,2,10,0,16,24,8,2,1,0,7153,7186,10
Task 7154,Job 0,7,7,3,10,0,10,17,7,3,1,2,7154,7188,17
Task 7154,Job 1,12,8,4,11,0,16,23,7,4,2,2,7154,7188,5
Task 7155,Job 0,10,9,4,11,0,14,21,7,4,2,1,7155,7189,8
Task 7155,Job 1,15,9,1,8,0,16,23,7,1,3,2,7155,7189,20
Task 7156,Job 0,2,6,1,12,0,3,14,11,1,4,0,7156,7189,15
Task 7156,Job 1,7,10,4,10,1,11,17,6,4,2,1,7156,7189,9
Task 7157,Job 0,5,7,2,6,1,7,11,4,2,2,0,7157,7191,6
Task 7157,Job 1,10,5,3,11,0,13,21,8,3,1,0,7157,7191,8
Task 7158,Job 0,7,10,2,10,0,9,17,8,2,2,2,7158,7192,4
Task 7158,Job 1,12,7,4,8,0,16,20,4,4,2,1,7158,7192,2
Task 7159,Job 0,2,7,3,12,1,5,14,9,3,1,0,7159,7193,18
Task 7159,Job 1,7,6,1,8,1,8,15,7,1,4,2,7159,7193,7
Task 7160,Job 0,2,9,4,6,1,6,8,2,4,4,0,7160,7193,9
Task 7160,Job 1,7,4,2,7,1,9,14,5,2,3,0,7160,7193,19
Task 7161,Job 0,1,5,4,10,0,5,11,6,4,1,2,7161,7194,12
Task 7161,Job 1,6,8,2,7,0,8,13,5,2,2,2,7161,7194,16
Task 7162,Job 0,9,6,1,7,0,10,16,6,1,2,0,7162,7196,15
Task 7162,Job 1,14,9,2,9,1,16,23,7,2,1,0,7162,7196,5
Task 7163,Job 0,4,6,2,11,0,6,15,9,2,4,0,7163,7196,11
Task 7163,Job 1,9,6,4,6,0,13,15,2,4,1,0,7163,7196,4
Task 7164,Job 0,4,9,2,8,1,6,12,6,2,3,1,7164,7197,20
Task 7164,Job 1,9,9,3,12,0,12,21,9,3,4,1,7164,7197,8
Task 7165,Job 0,8,10,2,7,0,10,15,5,2,2,1,7165,7198,5
Task 7165,Job 1,13,4,3,12,0,16,25,9,3,2,0,7165,7198,14
Task 7166,Job 0,4,7,3,11,1,7,15,8,3,2,2,7166,7200,19
Task 7166,Job 1,9,7,2,11,0,11,20,9,2,2,0,7166,7200,17
Task 7167,Job 0,5,8,4,8,0,9,13,4,4,2,1,7167,7200,12
Task 7167,Job 1,10,6,2,7,0,12,17,5,2,3,0,7167,7200,14
Task 7168,Job 0,4,8,1,8,0,5,12,7,1,4,0,7168,7202,15
Task 7168,Job 1,9,5,1,8,0,10,17,7,1,2,1,7168,7202,16
Task 7169,Job 0,3,7,4,6,0,7,9,2,4,4,0,7169,7203,5
Task 7169,Job 1,8,9,3,12,0,11,20,9,3,1,1,7169,7203,16
Task 7170,Job 0,7,5,1,8,1,8,15,7,1,4,2,7170,7203,19
Task 7170,Job 1,12,6,4,11,0,16,23,7,4,3,0,7170,7203,9
Task 7171,Job 0,5,9,4,11,0,9,16,7,4,1,0,7171,7204,5
Task 7171,Job 1,10,9,4,10,0,14,20,6,4,4,2,7171,7204,11
Task 7172,Job 0,10,8,2,11,0,12,21,9,2,3,1,7172,7205,14
Task 7172,Job 1,15,7,3,6,1,18,21,3,3,2,1,7172,7205,16
Task 7173,Job 0,10,7,1,9,0,11,19,8,1,3,0,7173,7206,19
Task 7173,Job 1,15,8,2,10,0,17,25,8,2,4,2,7173,7206,2
Task 7174,Job 0,1,6,1,11,0,2,12,10,1,1,2,7174,7208,4
Task 7174,Job 1,6,5,1,12,1,7,18,11,1,1,0,7174,7208,12
Task 7175,Job 0,9,6,2,12,1,11,21,10,2,4,0,7175,7209,2
Task 7175,Job 1,14,10,4,11,0,18,25,7,4,2,2,7175,7209,11
Task 7176,Job 0,8,9,2,11,0,10,19,9,2,4,2,7176,7210,19
Task 7176,Job 1,13,9,4,6,0,17,19,2,4,4,1,7176,7210,13
Task 7177,Job 0,5,9,4,9,0,9,14,5,4,2,1,7177,7211,8
Task 7177,Job 1,10,9,1,9,1,11,19,8,1,2,0,7177,7211,10
Task 7178,Job 0,7,9,3,9,0,10,16,6,3,2,1,7178,7211,14
Task 7178,Job 1,12,6,4,12,1,16,24,8,4,4,1,7178,7211,19
Task 7179,Job 0,1,6,1,12,0,2,13,11,1,2,1,7179,7213,9
Task 7179,Job 1,6,8,4,8,0,10,14,4,4,4,0,7179,7213,18
Task 7180,Job 0,2,6,1,12,0,3,14,11,1,3,0,7180,7214,2
Task 7180,Job 1,7,4,2,9,0,9,16,7,2,2,1,7180,7214,7
Task 7181,Job 0,6,6,1,9,0,7,15,8,1,2,1,7181,7215,12
Task 7181,Job 1,11,5,1,12,0,12,23,11,1,1,2,7181,7215,8
Task 7182,Job 0,6,7,2,9,0,8,15,7,2,4,0,7182,7216,19
Task 7182,Job 1,11,10,1,7,0,12,18,6,1,4,1,7182,7216,5
Task 7183,Job 0,3,6,4,6,0,7,9,2,4,4,1,7183,7216,16
Task 7183,Job 1,8,4,1,8,0,9,16,7,1,1,1,7183,7216,9
Task 7184,Job 0,6,10,2,9,0,8,15,7,2,3,0,7184,7217,13
Task 7184,Job 1,11,7,3,8,0,14,19,5,3,3,0,7184,7217,6
Task 7185,Job 0,7,5,3,7,0,10,14,4,3,4,1,7185,7219,16
Task 7185,Job 1,12,8,3,12,0,15,24,9,3,2,1,7185,7219,19
Task 7186,Job 0,1,7,3,10,0,4,11,7,3,4,1,7186,7220,19
Task 7186,Job 1,6,4,3,6,1,9,12,3,3,3,1,7186,7220,3
Task 7187,Job 0,1,4,3,11,1,4,12,8,3,4,2,7187,7220,6
Task 7187,Job 1,6,10,4,11,0,10,17,7,4,4,2,7187,7220,4
Task 7188,Job 0,8,9,4,12,0,12,20,8,4,3,2,7188,7221,13
Task 7188,Job 1,13,8,1,11,0,14,24,10,1,2,0,7188,7221,12
Task 7189,Job 0,2,5,2,11,0,4,13,9,2,2,1,7189,7223,4
Task 7189,Job 1,7,8,1,10,0,8,17,9,1,2,0,7189,7223,8
Task 7190,Job 0,8,7,2,7,0,10,15,5,2,2,0,7190,7224,11
Task 7190,Job 1,13,9,1,9,0,14,22,8,1,3,1,7190,7224,14
Task 7191,Job 0,5,6,2,10,0,7,15,8,2,2,1,7191,7224,20
Task 7191,Job 1,10,10,4,10,0,14,20,6,4,4,1,7191,7224,5
Task 7192,Job 0,5,6,1,11,0,6,16,10,1,1,1,7192,7225,7
Task 7192,Job 1,10,10,3,11,0,13,21,8,3,4,1,7192,7225,7
Task 7193,Job 0,10,7,4,8,0,14,18,4,4,4,0,7193,7226,18
Task 7193,Job 1,15,8,3,7,0,18,22,4,3,4,0,7193,7226,16
Task 7194,Job 0,10,7,2,9,1,12,19,7,2,4,2,7194,7227,20
Task 7194,Job 1,15,7,4,10,0,19,25,6,4,3,1,7194,7227,16
Task 7195,Job 0,2,6,4,6,0,6,8,2,4,3,1,7195,7229,14
Task 7195,Job 1,7,10,2,9,1,9,16,7,2,1,1,7195,7229,4
Task 7196,Job 0,2,4,3,10,0,5,12,7,3,1,0,7196,7230,17
Task 7196,Job 1,7,9,3,10,0,10,17,7,3,3,1,7196,7230,10
Task 7197,Job 0,4,10,2,6,1,6,10,4,2,1,2,7197,7230,9
Task 7197,Job 1,9,7,2,6,0,11,15,4,2,3,1,7197,7230,14
Task 7198,Job 0,6,7,1,6,1,7,12,5,1,2,1,7198,7231,6
Task 7198,Job 1,11,9,3,6,0,14,17,3,3,2,0,7198,7231,18
Task 7199,Job 0,8,7,1,8,0,9,16,7,1,1,2,7199,7232,12
Task 7199,Job 1,13,10,3,12,0,16,25,9,3,4,1,7199,7232,12
Task 7200,Job 0,9,4,4,6,1,13,15,2,4,2,0,7200,7233,4
Task 7200,Job 1,14,4,1,12,1,15,26,11,1,4,0,7200,7233,18
Task 7201,Job 0,9,9,2,11,0,11,20,9,2,1,2,7201,7235,10
Task 7201,Job 1,14,10,4,12,0,18,26,8,4,4,2,7201,7235,15
Task 7202,Job 0,9,6,2,9,1,11,18,7,2,4,1,7202,7236,20
Task 7202,Job 1,14,8,3,10,0,17,24,7,3,1,2,7202,7236,9
Task 7203,Job 0,10,7,1,6,0,11,16,5,1,4,1,7203,7236,2
Task 7203,Job 1,15,4,1,7,0,16,22,6,1,2,0,7203,7236,10
Task 7204,Job 0,3,10,4,11,1,7,14,7,4,3,1,7204,7238,19
Task 7204,Job 1,8,9,2,6,0,10,14,4,2,2,1,7204,7238,18
Task 7205,Job 0,8,5,4,12,0,12,20,8,4,2,1,7205,7238,12
Task 7205,Job 1,13,8,2,6,0,15,19,4,2,3,2,7205,7238,5
Task 7206,Job 0,2,10,2,7,0,4,9,5,2,1,1,7206,7239,17
Task 7206,Job 1,7,4,4,9,0,11,16,5,4,2,1,7206,7239,13
Task 7207,Job 0,1,8,3,7,1,4,8,4,3,4,0,7207,7240,15
Task 7207,Job 1,6,6,4,9,0,10,15,5,4,1,0,7207,7240,14
Task 7208,Job 0,2,7,2,6,1,4,8,4,2,1,0,7208,7241,20
Task 7208,Job 1,7,7,3,6,1,10,13,3,3,4,1,7208,7241,16
Task 7209,Job 0,10,4,4,10,0,14,20,6,4,1,2,7209,7242,2
Task 7209,Job 1,15,5,2,11,0,17,26,9,2,4,1,7209,7242,15
Task 7210,Job 0,1,5,1,6,0,2,7,5,1,2,2,7210,7243,16
Task 7210,Job 1,6,8,2,10,0,8,16,8,2,1,1,7210,7243,13
Task 7211,Job 0,8,10,2,10,1,10,18,8,2,4,0,7211,7245,10
Task 7211,Job 1,13,10,1,9,1,14,22,8,1,3,1,7211,7245,19
Task 7212,Job 0,1,8,2,6,0,3,7,4,2,3,2,7212,7246,18
Task 7212,Job 1,6,10,4,6,1,10,12,2,4,4,2,7212,7246,3
Task 7213,Job 0,6,5,3,10,0,9,16,7,3,2,2,7213,7247,18
Task 7213,Job 1,11,8,1,8,0,12,19,7,1,2,1,7213,7247,10
Task 7214,Job 0,6,10,1,11,0,7,17,10,1,2,2,7214,7247,6
Task 7214,Job 1,11,8,4,6,0,15,17,2,4,1,2,7214,7247,9
Task 7215,Job 0,1,5,3,8,0,4,9,5,3,4,0,7215,7248,16
Task 7215,Job 1,6,5,3,12,0,9,18,9,3,3,1,7215,7248,14
Task 7216,Job 0,10,5,1,9,1,11,19,8,1,2,1,7216,7249,20
Task 7216,Job 1,15,7,3,11,0,18,26,8,3,2,1,7216,7249,11
Task 7217,Job 0,5,10,1,7,0,6,12,6,1,4,2,7217,7250,4
Task 7217,Job 1,10,10,4,12,1,14,22,8,4,2,2,7217,7250,10
Task 7218,Job 0,1,10,2,6,1,3,7,4,2,3,2,7218,7252,15
Task 7218,Job 1,6,7,2,12,1,8,18,10,2,2,0,7218,7252,19
Task 7219,Job 0,6,4,1,8,0,7,14,7,1,1,2,7219,7253,7
Task 7219,Job 1,11,5,3,11,0,14,22,8,3,1,1,7219,7253,10
Task 7220,Job 0,9,6,2,11,0,11,20,9,2,1,2,7220,7254,10
Task 7220,Job 1,14,10,1,6,1,15,20,5,1,3,1,7220,7254,13
Task 7221,Job 0,8,5,1,11,0,9,19,10,1,2,0,7221,7255,4
Task 7221,Job 1,13,10,3,9,0,16,22,6,3,4,1,7221,7255,3
Task 7222,Job 0,5,5,2,9,1,7,14,7,2,1,1,7222,7256,7
Task 7222,Job 1,10,10,3,7,0,13,17,4,3,3,0,7222,7256,20
Task 7223,Job 0,6,9,1,6,0,7,12,5,1,3,0,7223,7256,8
Task 7223,Job 1,11,6,1,6,0,12,17,5,1,1,1,7223,7256,2
Task 7224,Job 0,9,4,1,8,0,10,17,7,1,2,2,7224,7257,11
Task 7224,Job 1,14,7,1,11,0,15,25,10,1,2,1,7224,7257,13
Task 7225,Job 0,2,4,1,11,0,3,13,10,1,2,2,7225,7258,6
Task 7225,Job 1,7,10,3,7,0,10,14,4,3,3,1,7225,7258,14
Task 7226,Job 0,9,4,3,10,0,12,19,7,3,2,2,7226,7260,4
Task 7226,Job 1,14,5,1,12,1,15,26,11,1,2,0,7226,7260,18
Task 7227,Job 0,7,4,3,8,0,10,15,5,3,1,1,7227,7260,6
Task 7227,Job 1,12,7,1,11,0,13,23,10,1,2,1,7227,7260,11
Task 7228,Job 0,9,10,3,10,1,12,19,7,3,2,2,7228,7261,17
Task 7228,Job 1,14,10,2,10,0,16,24,8,2,1,1,7228,7261,8
Task 7229,Job 0,1,5,2,12,1,3,13,10,2,4,2,7229,7263,15
Task 7229,Job 1,6,9,3,7,0,9,13,4,3,2,0,7229,7263,14
Task 7230,Job 0,5,7,4,10,0,9,15,6,4,1,1,7230,7264,6
Task 7230,Job 1,10,6,2,6,1,12,16,4,2,3,1,7230,7264,10
Task 7231,Job 0,3,7,1,6,1,4,9,5,1,4,0,7231,7264,18
Task 7231,Job 1,8,4,1,10,1,9,18,9,1,1,1,7231,7264,12
Task 7232,Job 0,3,10,2,12,0,5,15,10,2,1,1,7232,7265,16
Task 7232,Job 1,8,8,2,10,0,10,18,8,2,2,0,7232,7265,2
Task 7233,Job 0,4,6,1,9,0,5,13,8,1,1,0,7233,7267,3
Task 7233,Job 1,9,10,3,6,0,12,15,3,3,3,1,7233,7267,6
Task 7234,Job 0,4,9,4,6,0,8,10,2,4,2,2,7234,7268,16
Task 7234,Job 1,9,10,1,8,0,10,17,7,1,4,2,7234,7268,10
Task 7235,Job 0,5,9,2,6,0,7,11,4,2,3,2,7235,7269,4
Task 7235,Job 1,10,7,4,6,0,14,16,2,4,1,0,7235,7269,11
Task 7236,Job 0,5,10,1,7,0,6,12,6,1,2,1,7236,7269,7
Task 7236,Job 1,10,5,3,11,0,13,21,8,3,2,2,7236,7269,15
Task 7237,Job 0,3,6,2,7,1,5,10,5,2,1,1,7237,7271,16
Task 7237,Job 1,8,5,2,6,0,10,14,4,2,2,2,7237,7271,7
Task 7238,Job 0,1,10,3,9,0,4,10,6,3,1,1,7238,7271,7
Task 7238,Job 1,6,5,2,6,0,8,12,4,2,2,0,7238,7271,14
Task 7239,Job 0,5,5,3,11,0,8,16,8,3,4,0,7239,7272,6
Task 7239,Job 1,10,10,3,7,0,13,17,4,3,4,0,7239,7272,17
Task 7240,Job 0,5,7,3,6,0,8,11,3,3,2,2,7240,7273,16
Task 7240,Job 1,10,5,4,12,1,14,22,8,4,1,1,7240,7273,20
Task 7241,Job 0,6,8,2,7,0,8,13,5,2,2,1,7241,7274,3
Task 7241,Job 1,11,7,1,9,0,12,20,8,1,3,1,7241,7274,11
Task 7242,Job 0,6,8,3,10,0,9,16,7,3,3,1,7242,7276,10
Task 7242,Job 1,11,8,1,8,0,12,19,7,1,2,0,7242,7276,12
Task 7243,Job 0,3,8,2,12,0,5,15,10,2,4,0,7243,7276,5
Task 7243,Job 1,8,10,2,11,0,10,19,9,2,3,2,7243,7276,20
Task 7244,Job 0,7,10,2,11,0,9,18,9,2,1,0,7244,7278,10
Task 7244,Job 1,12,8,4,10,0,16,22,6,4,2,2,7244,7278,11
Task 7245,Job 0,8,4,4,11,0,12,19,7,4,4,1,7245,7279,7
Task 7245,Job 1,13,6,1,11,0,14,24,10,1,3,0,7245,7279,6
Task 7246,Job 0,3,8,2,8,0,5,11,6,2,1,0,7246,7280,4
Task 7246,Job 1,8,4,3,12,0,11,20,9,3,2,1,7246,7280,4
Task 7247,Job 0,9,10,2,9,1,11,18,7,2,4,2,7247,7281,10
Task 7247,Job 1,14,5,3,12,0,17,26,9,3,1,1,7247,7281,6
Task 7248,Job 0,3,10,3,9,0,6,12,6,3,1,1,7248,7282,17
Task 7248,Job 1,8,7,3,6,0,11,14,3,3,3,1,7248,7282,9
Task 7249,Job 0,8,5,2,12,0,10,20,10,2,2,0,7249,7282,5
Task 7249,Job 1,13,10,2,11,0,15,24,9,2,4,2,7249,7282,11
Task 7250,Job 0,1,5,2,11,0,3,12,9,2,1,0,7250,7284,12
Task 7250,Job 1,6,5,4,7,1,10,13,3,4,4,2,7250,7284,11
Task 7251,Job 0,2,9,1,12,1,3,14,11,1,3,0,7251,7284,4
Task 7251,Job 1,7,8,3,7,1,10,14,4,3,4,1,7251,7284,19
Task 7252,Job 0,9,6,4,9,0,13,18,5,4,3,1,7252,7286,5
Task 7252,Job 1,14,6,4,11,1,18,25,7,4,2,1,7252,7286,11
Task 7253,Job 0,3,5,4,11,0,7,14,7,4,4,0,7253,7287,17
Task 7253,Job 1,8,8,1,8,1,9,16,7,1,1,1,7253,7287,6
Task 7254,Job 0,1,9,1,12,0,2,13,11,1,4,2,7254,7287,9
Task 7254,Job 1,6,9,3,7,0,9,13,4,3,4,2,7254,7287,20
Task 7255,Job 0,7,4,3,6,0,10,13,3,3,4,1,7255,7288,7
Task 7255,Job 1,12,10,2,9,0,14,21,7,2,3,0,7255,7288,5
Task 7256,Job 0,1,9,2,9,0,3,10,7,2,4,0,7256,7289,14
Task 7256,Job 1,6,8,3,6,1,9,12,3,3,2,1,7256,7289,12
Task 7257,Job 0,1,7,3,7,0,4,8,4,3,4,1,7257,7291,20
Task 7257,Job 1,6,7,4,10,0,10,16,6,4,3,2,7257,7291,4
Task 7258,Job 0,8,6,2,6,1,10,14,4,2,2,0,7258,7291,16
Task 7258,Job 1,13,10,4,8,1,17,21,4,4,2,0,7258,7291,16
Task 7259,Job 0,3,7,1,9,0,4,12,8,1,3,2,7259,7293,7
Task 7259,Job 1,8,10,2,12,1,10,20,10,2,2,1,7259,7293,3
Task 7260,Job 0,3,8,1,11,1,4,14,10,1,3,2,7260,7294,4
Task 7260,Job 1,8,8,1,6,1,9,14,5,1,4,0,7260,7294,9
Task 7261,Job 0,4,5,2,11,0,6,15,9,2,3,1,7261,7295,10
Task 7261,Job 1,9,10,2,6,0,11,15,4,2,3,1,7261,7295,5
Task 7262,Job 0,1,8,4,8,0,5,9,4,4,4,2,7262,7295,6
Task 7262,Job 1,6,7,4,8,0,10,14,4,4,4,1,7262,7295,4
Task 7263,Job 0,6,10,1,10,0,7,16,9,1,3,2,7263,7297,20
Task 7263,Job 1,11,8,3,9,0,14,20,6,3,2,2,7263,7297,12
Task 7264,Job 0,10,6,3,11,0,13,21,8,3,3,2,7264,7297,18
Task 7264,Job 1,15,7,1,7,0,16,22,6,1,4,0,7264,7297,16
Task 7265,Job 0,5,9,4,10,0,9,15,6,4,1,1,7265,7298,4
Task 7265,Job 1,10,8,3,9,0,13,19,6,3,4,1,7265,7298,6
Task 7266,Job 0,3,8,3,10,0,6,13,7,3,2,1,7266,7300,5
Task 7266,Job 1,8,4,3,6,0,11,14,3,3,2,1,7266,7300,12
Task 7267,Job 0,10,5,3,8,0,13,18,5,3,1,0,7267,7301,20
Task 7267,Job 1,15,9,1,10,0,16,25,9,1,1,0,7267,7301,14
Task 7268,Job 0,3,10,2,8,0,5,11,6,2,2,1,7268,7301,5
Task 7268,Job 1,8,5,1,7,0,9,15,6,1,1,2,7268,7301,12
Task 7269,Job 0,6,5,1,11,1,7,17,10,1,3,1,7269,7303,16
Task 7269,Job 1,11,10,2,10,0,13,21,8,2,4,2,7269,7303,4
Task 7270,Job 0,1,9,4,10,1,5,11,6,4,3,0,7270,7303,3
Task 7270,Job 1,6,8,2,11,0,8,17,9,2,3,2,7270,7303,3
Task 7271,Job 0,10,4,1,6,0,11,16,5,1,4,1,7271,7305,5
Task 7271,Job 1,15,10,3,11,0,18,26,8,3,2,0,7271,7305,15
Task 7272,Job 0,5,9,4,12,0,9,17,8,4,3,0,7272,7306,18
Task 7272,Job 1,10,6,3,7,0,13,17,4,3,1,0,7272,7306,2
Task 7273,Job 0,2,7,3,7,1,5,9,4,3,4,2,7273,7307,2
Task 7273,Job 1,7,6,4,7,0,11,14,3,4,2,2,7273,7307,16
Task 7274,Job 0,1,7,1,9,1,2,10,8,1,1,0,7274,7308,11
Task 7274,Job 1,6,5,4,7,0,10,13,3,4,3,1,7274,7308,19
Task 7275,Job 0,6,9,3,8,0,9,14,5,3,2,1,7275,7308,14
Task 7275,Job 1,11,7,2,6,0,13,17,4,2,4,0,7275,7308,5
Task 7276,Job 0,10,4,1,8,0,11,18,7,1,1,1,7276,7310,18
Task 7276,Job 1,15,8,3,12,0,18,27,9,3,4,1,7276,7310,12
Task 7277,Job 0,6,5,2,12,0,8,18,10,2,3,2,7277,7310,16
Task 7277,Job 1,11,7,1,6,1,12,17,5,1,4,2,7277,7310,6
Task 7278,Job 0,2,8,1,6,1,3,8,5,1,3,2,7278,7312,19
Task 7278,Job 1,7,5,3,7,1,10,14,4,3,4,1,7278,7312,10
Task 7279,Job 0,2,6,2,9,0,4,11,7,2,1,0,7279,7313,7
Task 7279,Job 1,7,7,2,9,0,9,16,7,2,3,0,7279,7313,20
Task 7280,Job 0,2,4,4,10,0,6,12,6,4,1,1,7280,7314,17
Task 7280,Job 1,7,10,3,9,0,10,16,6,3,2,1,7280,7314,4
Task 7281,Job 0,6,4,2,9,0,8,15,7,2,1,2,7281,7315,6
Task 7281,Job 1,11,6,4,6,0,15,17,2,4,3,2,7281,7315,13
Task 7282,Job 0,1,7,3,7,0,4,8,4,3,4,0,7282,7315,4
Task 7282,Job 1,6,6,3,11,0,9,17,8,3,4,1,7282,7315,15
Task 7283,Job 0,4,7,4,11,0,8,15,7,4,2,2,7283,7317,6
Task 7283,Job 1,9,6,2,11,0,11,20,9,2,2,0,7283,7317,9
Task 7284,Job 0,5,5,3,12,1,8,17,9,3,4,1,7284,7317,13
Task 7284,Job 1,10,6,3,10,1,13,20,7,3,2,1,7284,7317,9
Task 7285,Job 0,4,9,2,6,0,6,10,4,2,1,2,7285,7319,17
Task 7285,Job 1,9,9,4,6,0,13,15,2,4,2,1,7285,7319,12
Task 7286,Job 0,3,4,3,7,1,6,10,4,3,2,2,7286,7320,12
Task 7286,Job 1,8,8,1,12,1,9,20,11,1,3,1,7286,7320,3
Task 7287,Job 0,8,4,1,8,0,9,16,7,1,1,1,7287,7320,19
Task 7287,Job 1,13,5,4,8,0,17,21,4,4,1,1,7287,7320,4
Task 7288,Job 0,5,7,3,11,0,8,16,8,3,4,2,7288,7321,10
Task 7288,Job 1,10,7,3,8,0,13,18,5,3,2,1,7288,7321,16
Task 7289,Job 0,10,8,1,9,0,11,19,8,1,2,0,7289,7323,17
Task 7289,Job 1,15,4,2,11,0,17,26,9,2,1,0,7289,7323,10
Task 7290,Job 0,1,7,2,9,1,3,10,7,2,4,2,7290,7324,14
Task 7290,Job 1,6,8,2,11,0,8,17,9,2,2,2,7290,7324,15
Task 7291,Job 0,6,7,3,6,0,9,12,3,3,4,0,7291,7325,11
Task 7291,Job 1,11,10,4,11,0,15,22,7,4,1,0,7291,7325,13
Task 7292,Job 0,5,9,1,10,0,6,15,9,1,3,0,7292,7326,5
Task 7292,Job 1,10,7,1,7,0,11,17,6,1,1,1,7292,7326,19
Task 7293,Job 0,2,5,4,11,0,6,13,7,4,3,0,7293,7327,9
Task 7293,Job 1,7,10,4,10,0,11,17,6,4,3,0,7293,7327,15
Task 7294,Job 0,7,4,3,11,1,10,18,8,3,1,1,7294,7327,19
Task 7294,Job 1,12,10,2,10,0,14,22,8,2,1,1,7294,7327,20
Task 7295,Job 0,6,8,1,10,1,7,16,9,1,3,1,7295,7329,7
Task 7295,Job 1,11,4,4,11,1,15,22,7,4,1,2,7295,7329,7
Task 7296,Job 0,3,5,2,10,0,5,13,8,2,4,0,7296,7329,5
Task 7296,Job 1,8,6,3,12,0,11,20,9,3,1,2,7296,7329,16
Task 7297,Job 0,1,4,2,12,0,3,13,10,2,1,2,7297,7330,8
Task 7297,Job 1,6,4,1,10,0,7,16,9,1,1,2,7297,7330,7
Task 7298,Job 0,7,5,2,7,0,9,14,5,2,4,2,7298,7332,5
Task 7298,Job 1,12,5,3,7,1,15,19,4,3,3,2,7298,7332,20
Task 7299,Job 0,2,4,1,11,0,3,13,10,1,2,1,7299,7332,17
Task 7299,Job 1,7,8,4,6,1,11,13,2,4,1,2,7299,7332,16
Task 7300,Job 0,1,4,2,10,0,3,11,8,2,4,1,7300,7333,20
Task 7300,Job 1,6,9,1,9,1,7,15,8,1,3,0,7300,7333,11
Task 7301,Job 0,6,9,2,11,0,8,17,9,2,2,2,7301,7335,7
Task 7301,Job 1,11,7,3,11,0,14,22,8,3,1,1,7301,7335,6
Task 7302,Job 0,9,7,4,6,0,13,15,2,4,1,0,7302,7335,10
Task 7302,Job 1,14,6,3,9,0,17,23,6,3,3,0,7302,7335,17
Task 7303,Job 0,7,8,3,12,0,10,19,9,3,4,1,7303,7337,18
Task 7303,Job 1,12,7,2,7,0,14,19,5,2,4,1,7303,7337,8
Task 7304,Job 0,2,6,2,8,1,4,10,6,2,1,2,7304,7337,20
Task 7304,Job 1,7,4,1,9,1,8,16,8,1,2,1,7304,7337,12
Task 7305,Job 0,10,7,1,9,1,11,19,8,1,3,2,7305,7339,2
Task 7305,Job 1,15,5,4,9,0,19,24,5,4,1,0,7305,7339,18
Task 7306,Job 0,7,9,4,11,0,11,18,7,4,2,2,7306,7340,17
Task 7306,Job 1,12,8,2,6,0,14,18,4,2,2,2,7306,7340,6
Task 7307,Job 0,5,9,4,9,1,9,14,5,4,4,1,7307,7341,3
Task 7307,Job 1,10,6,4,7,0,14,17,3,4,3,2,7307,7341,8
Task 7308,Job 0,9,5,2,6,0,11,15,4,2,2,0,7308,7342,6
Task 7308,Job 1,14,9,3,11,0,17,25,8,3,3,0,7308,7342,11
Task 7309,Job 0,6,7,2,6,0,8,12,4,2,1,1,7309,7342,15
Task 7309,Job 1,11,9,2,7,1,13,18,5,2,3,0,7309,7342,20
Task 7310,Job 0,1,10,3,12,1,4,13,9,3,3,0,7310,7344,17
Task 7310,Job 1,6,7,4,6,0,10,12,2,4,3,2,7310,7344,20
Task 7311,Job 0,7,10,3,11,0,10,18,8,3,2,2,7311,7345,12
Task 7311,Job 1,12,10,3,10,0,15,22,7,3,1,2,7311,7345,13
Task 7312,Job 0,1,8,2,9,0,3,10,7,2,3,1,7312,7345,17
Task 7312,Job 1,6,6,4,7,0,10,13,3,4,2,2,7312,7345,13
Task 7313,Job 0,10,7,4,12,1,14,22,8,4,3,1,7313,7347,3
Task 7313,Job 1,15,4,3,7,0,18,22,4,3,2,1,7313,7347,16
Task 7314,Job 0,1,8,3,12,0,4,13,9,3,3,2,7314,7347,11
Task 7314,Job 1,6,6,2,11,1,8,17,9,2,1,1,7314,7347,5
Task 7315,Job 0,8,7,2,9,1,10,17,7,2,3,0,7315,7348,8
Task 7315,Job 1,13,10,4,9,0,17,22,5,4,3,0,7315,7348,9
Task 7316,Job 0,10,10,2,11,0,12,21,9,2,1,1,7316,7350,4
Task 7316,Job 1,15,7,2,12,1,17,27,10,2,4,1,7316,7350,3
Task 7317,Job 0,7,9,3,10,0,10,17,7,3,2,2,7317,7350,17
Task 7317,Job 1,12,8,3,8,0,15,20,5,3,2,1,7317,7350,15
Task 7318,Job 0,10,5,1,11,1,11,21,10,1,1,0,7318,7351,20
Task 7318,Job 1,15,10,1,10,0,16,25,9,1,1,0,7318,7351,5
Task 7319,Job 0,6,10,4,9,1,10,15,5,4,4,2,7319,7352,9
Task 7319,Job 1,11,7,4,11,0,15,22,7,4,2,2,7319,7352,9
Task 7320,Job 0,7,8,4,12,1,11,19,8,4,1,0,7320,7353,11
Task 7320,Job 1,12,5,4,12,0,16,24,8,4,3,2,7320,7353,14
Task 7321,Job 0,2,7,4,9,0,6,11,5,4,3,0,7321,7355,11
Task 7321,Job 1,7,8,2,9,0,9,16,7,2,4,2,7321,7355,18
Task 7322,Job 0,3,4,1,12,0,4,15,11,1,1,1,7322,7356,10
Task 7322,Job 1,8,6,3,12,0,11,20,9,3,2,1,7322,7356,14
Task 7323,Job 0,3,7,3,6,0,6,9,3,3,1,0,7323,7357,5
Task 7323,Job 1,8,5,2,12,0,10,20,10,2,1,1,7323,7357,6
Task 7324,Job 0,10,6,4,6,1,14,16,2,4,2,2,7324,7358,14
Task 7324,Job 1,15,10,4,11,0,19,26,7,4,2,2,7324,7358,2
Task 7325,Job 0,5,10,1,6,0,6,11,5,1,3,0,7325,7359,3
Task 7325,Job 1,10,10,1,9,0,11,19,8,1,2,1,7325,7359,7
Task 7326,Job 0,2,9,4,7,0,6,9,3,4,4,0,7326,7359,10
Task 7326,Job 1,7,8,4,9,0,11,16,5,4,2,0,7326,7359,9
Task 7327,Job 0,2,5,4,12,0,6,14,8,4,2,1,7327,7360,4
Task 7327,Job 1,7,7,3,9,0,10,16,6,3,3,0,7327,7360,8
Task 7328,Job 0,8,8,3,11,0,11,19,8,3,2,2,7328,7361,19
Task 7328,Job 1,13,6,3,11,1,16,24,8,3,1,2,7328,7361,20
Task 7329,Job 0,2,4,3,9,0,5,11,6,3,1,1,7329,7362,4
Task 7329,Job 1,7,9,3,8,0,10,15,5,3,3,2,7329,7362,4
Task 7330,Job 0,2,5,4,8,0,6,10,4,4,1,1,7330,7363,13
Task 7330,Job 1,7,4,2,6,1,9,13,4,2,4,0,7330,7363,2
Task 7331,Job 0,9,9,1,6,0,10,15,5,1,3,2,7331,7364,8
Task 7331,Job 1,14,7,4,7,0,18,21,3,4,2,2,7331,7364,15
Task 7332,Job 0,8,6,1,12,0,9,20,11,1,3,2,7332,7365,14
Task 7332,Job 1,13,9,2,7,0,15,20,5,2,4,1,7332,7365,19
Task 7333,Job 0,3,4,3,12,0,6,15,9,3,3,2,7333,7367,13
Task 7333,Job 1,8,8,4,8,1,12,16,4,4,3,0,7333,7367,16
Task 7334,Job 0,10,5,4,7,0,14,17,3,4,4,2,7334,7368,16
Task 7334,Job 1,15,4,2,10,1,17,25,8,2,3,0,7334,7368,3
Task 7335,Job 0,3,5,1,9,0,4,12,8,1,2,1,7335,7369,14
Task 7335,Job 1,8,8,4,11,0,12,19,7,4,2,2,7335,7369,4
Task 7336,Job 0,4,6,3,12,0,7,16,9,3,1,1,7336,7369,19
Task 7336,Job 1,9,7,4,10,0,13,19,6,4,4,0,7336,7369,16
Task 7337,Job 0,1,8,1,11,0,2,12,10,1,2,0,7337,7371,8
Task 7337,Job 1,6,6,2,6,0,8,12,4,2,4,1,7337,7371,14
Task 7338,Job 0,7,4,4,6,0,11,13,2,4,1,1,7338,7371,3
Task 7338,Job 1,12,10,2,9,1,14,21,7,2,2,2,7338,7371,15
Task 7339,Job 0,5,4,2,7,0,7,12,5,2,3,1,7339,7373,5
Task 7339,Job 1,10,6,1,6,0,11,16,5,1,3,0,7339,7373,13
Task 7340,Job 0,3,10,3,11,0,6,14,8,3,2,1,7340,7373,13
Task 7340,Job 1,8,7,4,11,0,12,19,7,4,2,0,7340,7373,18
Task 7341,Job 0,7,6,3,10,1,10,17,7,3,1,1,7341,7375,10
Task 7341,Job 1,12,7,1,10,0,13,22,9,1,2,1,7341,7375,12
Task 7342,Job 0,3,8,1,11,0,4,14,10,1,2,2,7342,7375,8
Task 7342,Job 1,8,8,4,12,0,12,20,8,4,1,1,7342,7375,13
Task 7343,Job 0,2,7,3,10,1,5,12,7,3,2,1,7343,7377,8
Task 7343,Job 1,7,9,2,11,0,9,18,9,2,4,2,7343,7377,2
Task 7344,Job 0,1,6,4,11,0,5,12,7,4,1,1,7344,7378,17
Task 7344,Job 1,6,4,3,8,0,9,14,5,3,3,2,7344,7378,15
Task 7345,Job 0,2,6,4,10,1,6,12,6,4,1,1,7345,7378,5
Task 7345,Job 1,7,9,4,6,0,11,13,2,4,1,2,7345,7378,15
Task 7346,Job 0,6,10,3,12,0,9,18,9,3,2,0,7346,7380,14
Task 7346,Job 1,11,6,3,6,0,14,17,3,3,4,2,7346,7380,2
Task 7347,Job 0,9,5,4,11,1,13,20,7,4,1,0,7347,7380,14
Task 7347,Job 1,14,6,1,6,1,15,20,5,1,4,2,7347,7380,13
Task 7348,Job 0,10,8,4,7,1,14,17,3,4,4,0,7348,7381,18
Task 7348,Job 1,15,7,2,12,0,17,27,10,2,3,2,7348,7381,13
Task 7349,Job 0,4,6,1,11,1,5,15,10,1,2,1,7349,7383,11
Task 7349,Job 1,9,10,1,12,0,10,21,11,1,2,0,7349,7383,14
Task 7350,Job 0,2,5,3,10,0,5,12,7,3,1,2,7350,7383,15
Task 7350,Job 1,7,10,4,7,1,11,14,3,4,4,2,7350,7383,6
Task 7351,Job 0,4,9,3,7,0,7,11,4,3,1,0,7351,7385,9
Task 7351,Job 1,9,4,3,11,0,12,20,8,3,3,2,7351,7385,2
Task 7352,Job 0,7,7,4,10,0,11,17,6,4,3,2,7352,7386,14
Task 7352,Job 1,12,7,2,7,1,14,19,5,2,3,2,7352,7386,11
Task 7353,Job 0,10,10,1,7,0,11,17,6,1,2,2,7353,7386,16
Task 7353,Job 1,15,10,1,10,0,16,25,9,1,1,0,7353,7386,14
Task 7354,Job 0,7,6,2,6,0,9,13,4,2,1,1,7354,7387,8
Task 7354,Job 1,12,7,1,6,0,13,18,5,1,4,0,7354,7387,11
Task 7355,Job 0,6,7,2,11,0,8,17,9,2,1,0,7355,7389,3
Task 7355,Job 1,11,4,4,11,0,15,22,7,4,2,2,7355,7389,18
Task 7356,Job 0,7,10,3,12,0,10,19,9,3,4,1,7356,7389,17
Task 7356,Job 1,12,5,3,10,0,15,22,7,3,1,1,7356,7389,5
Task 7357,Job 0,3,5,3,10,1,6,13,7,3,2,0,7357,7390,5
Task 7357,Job 1,8,7,4,7,0,12,15,3,4,3,0,7357,7390,17
Task 7358,Job 0,2,10,1,7,0,3,9,6,1,3,2,7358,7392,10
Task 7358,Job 1,7,7,1,9,1,8,16,8,1,4,2,7358,7392,10
Task 7359,Job 0,4,9,4,8,0,8,12,4,4,1,0,7359,7393,17
Task 7359,Job 1,9,5,3,9,1,12,18,6,3,2,0,7359,7393,17
Task 7360,Job 0,5,9,1,6,0,6,11,5,1,2,0,7360,7394,8
Task 7360,Job 1,10,8,4,9,0,14,19,5,4,2,2,7360,7394,14
Task 7361,Job 0,4,6,4,8,0,8,12,4,4,3,0,7361,7394,13
Task 7361,Job 1,9,5,2,11,0,11,20,9,2,1,1,7361,7394,18
Task 7362,Job 0,7,8,2,6,1,9,13,4,2,3,0,7362,7395,7
Task 7362,Job 1,12,8,4,12,1,16,24,8,4,3,1,7362,7395,6
Task 7363,Job 0,3,8,4,12,0,7,15,8,4,2,0,7363,7396,11
Task 7363,Job 1,8,4,4,9,0,12,17,5,4,1,0,7363,7396,2
Task 7364,Job 0,2,7,3,8,0,5,10,5,3,2,2,7364,7398,16
Task 7364,Job 1,7,8,3,10,1,10,17,7,3,1,2,7364,7398,5
Task 7365,Job 0,7,7,3,7,0,10,14,4,3,2,2,7365,7399,13
Task 7365,Job 1,12,9,3,9,0,15,21,6,3,4,1,7365,7399,5
Task 7366,Job 0,7,5,2,8,0,9,15,6,2,1,0,7366,7399,8
Task 7366,Job 1,12,10,4,7,1,16,19,3,4,2,2,7366,7399,2
Task 7367,Job 0,9,5,2,12,0,11,21,10,2,4,0,7367,7400,6
Task 7367,Job 1,14,5,2,10,0,16,24,8,2,2,0,7367,7400,6
Task 7368,Job 0,8,5,4,9,1,12,17,5,4,2,0,7368,7402,18
Task 7368,Job 1,13,9,2,6,1,15,19,4,2,1,2,7368,7402,17
Task 7369,Job 0,2,10,1,11,0,3,13,10,1,1,0,7369,7403,16
Task 7369,Job 1,7,8,1,6,0,8,13,5,1,1,0,7369,7403,7
Task 7370,Job 0,9,4,4,10,0,13,19,6,4,1,1,7370,7403,12
Task 7370,Job 1,14,4,2,8,0,16,22,6,2,1,0,7370,7403,18
Task 7371,Job 0,1,5,4,6,0,5,7,2,4,2,0,7371,7405,2
Task 7371,Job 1,6,7,1,12,1,7,18,11,1,1,2,7371,7405,9
Task 7372,Job 0,6,8,3,12,0,9,18,9,3,2,0,7372,7405,8
Task 7372,Job 1,11,5,1,7,1,12,18,6,1,1,2,7372,7405,7
Task 7373,Job 0,6,7,2,10,0,8,16,8,2,2,1,7373,7407,14
Task 7373,Job 1,11,4,2,7,1,13,18,5,2,4,2,7373,7407,2
Task 7374,Job 0,3,10,4,11,1,7,14,7,4,1,2,7374,7407,13
Task 7374,Job 1,8,7,3,8,0,11,16,5,3,3,0,7374,7407,9
Task 7375,Job 0,7,6,4,11,1,11,18,7,4,1,0,7375,7408,5
Task 7375,Job 1,12,5,4,7,0,16,19,3,4,2,2,7375,7408,17
Task 7376,Job 0,5,7,1,9,0,6,14,8,1,1,1,7376,7409,6
Task 7376,Job 1,10,8,2,7,1,12,17,5,2,1,1,7376,7409,2
Task 7377,Job 0,6,9,1,6,0,7,12,5,1,2,2,7377,7410,4
Task 7377,Job 1,11,8,4,10,0,15,21,6,4,2,2,7377,7410,20
Task 7378,Job 0,8,9,3,9,0,11,17,6,3,1,2,7378,7411,4
Task 7378,Job 1,13,4,4,10,0,17,23,6,4,1,2,7378,7411,5
Task 7379,Job 0,6,5,1,7,0,7,13,6,1,1,2,7379,7413,18
Task 7379,Job 1,11,4,3,6,0,14,17,3,3,4,1,7379,7413,5
Task 7380,Job 0,8,5,2,10,0,10,18,8,2,3,0,7380,7414,3
Task 7380,Job 1,13,5,4,6,0,17,19,2,4,2,1,7380,7414,7
Task 7381,Job 0,7,9,2,10,0,9,17,8,2,4,2,7381,7415,4
Task 7381,Job 1,12,4,1,7,0,13,19,6,1,4,2,7381,7415,2
Task 7382,Job 0,3,5,1,10,0,4,13,9,1,4,1,7382,7415,3
Task 7382,Job 1,8,7,3,9,0,11,17,6,3,3,2,7382,7415,11
Task 7383,Job 0,9,6,2,8,0,11,17,6,2,4,2,7383,7416,10
Task 7383,Job 1,14,10,4,12,1,18,26,8,4,1,2,7383,7416,14
Task 7384,Job 0,10,7,2,8,0,12,18,6,2,3,2,7384,7418,14
Task 7384,Job 1,15,9,4,7,0,19,22,3,4,1,0,7384,7418,2
Task 7385,Job 0,5,6,2,11,0,7,16,9,2,4,0,7385,7418,6
Task 7385,Job 1,10,9,1,10,1,11,20,9,1,1,2,7385,7418,7
Task 7386,Job 0,1,4,1,11,0,2,12,10,1,3,2,7386,7419,7
Task 7386,Job 1,6,7,2,6,0,8,12,4,2,4,0,7386,7419,19
Task 7387,Job 0,8,9,2,11,0,10,19,9,2,3,0,7387,7421,19
Task 7387,Job 1,13,10,1,9,0,14,22,8,1,1,1,7387,7421,3
Task 7388,Job 0,10,5,2,7,0,12,17,5,2,4,0,7388,7421,10
Task 7388,Job 1,15,6,1,12,1,16,27,11,1,2,0,7388,7421,7
Task 7389,Job 0,7,9,2,11,0,9,18,9,2,3,0,7389,7422,18
Task 7389,Job 1,12,8,1,7,0,13,19,6,1,2,0,7389,7422,17
Task 7390,Job 0,5,6,4,11,1,9,16,7,4,3,0,7390,7423,17
Task 7390,Job 1,10,8,2,11,0,12,21,9,2,4,0,7390,7423,14
Task 7391,Job 0,9,4,1,9,0,10,18,8,1,4,2,7391,7424,3
Task 7391,Job 1,14,6,3,6,0,17,20,3,3,4,1,7391,7424,9
Task 7392,Job 0,1,8,3,6,1,4,7,3,3,2,1,7392,7425,14
Task 7392,Job 1,6,5,2,12,1,8,18,10,2,4,0,7392,7425,11
Task 7393,Job 0,7,5,4,11,0,11,18,7,4,3,2,7393,7426,7
Task 7393,Job 1,12,7,3,11,0,15,23,8,3,3,1,7393,7426,16
Task 7394,Job 0,2,4,2,12,0,4,14,10,2,4,2,7394,7428,9
Task 7394,Job 1,7,7,4,11,0,11,18,7,4,2,0,7394,7428,18
Task 7395,Job 0,9,7,2,10,0,11,19,8,2,2,0,7395,7428,8
Task 7395,Job 1,14,7,2,12,0,16,26,10,2,1,1,7395,7428,14
Task 7396,Job 0,1,6,3,8,0,4,9,5,3,1,2,7396,7430,15
Task 7396,Job 1,6,5,1,12,1,7,18,11,1,2,1,7396,7430,16
Task 7397,Job 0,6,5,3,9,0,9,15,6,3,1,1,7397,7430,12
Task 7397,Job 1,11,8,4,8,0,15,19,4,4,2,0,7397,7430,13
Task 7398,Job 0,10,5,3,8,0,13,18,5,3,3,1,7398,7432,4
Task 7398,Job 1,15,8,1,8,1,16,23,7,1,1,1,7398,7432,20
Task 7399,Job 0,6,4,2,8,1,8,14,6,2,3,2,7399,7432,4
Task 7399,Job 1,11,5,1,10,0,12,21,9,1,2,1,7399,7432,15
Task 7400,Job 0,4,4,4,6,0,8,10,2,4,1,2,7400,7433,18
Task 7400,Job 1,9,8,1,8,0,10,17,7,1,4,1,7400,7433,14
Task 7401,Job 0,1,7,4,12,0,5,13,8,4,1,2,7401,7434,5
Task 7401,Job 1,6,9,1,10,0,7,16,9,1,2,0,7401,7434,19
Task 7402,Job 0,9,10,1,11,0,10,20,10,1,2,1,7402,7436,4
Task 7402,Job 1,14,4,3,8,1,17,22,5,3,2,1,7402,7436,9
Task 7403,Job 0,3,4,4,10,1,7,13,6,4,3,1,7403,7437,12
Task 7403,Job 1,8,4,3,7,1,11,15,4,3,4,0,7403,7437,10
Task 7404,Job 0,9,9,1,10,0,10,19,9,1,2,0,7404,7438,3
Task 7404,Job 1,14,4,2,12,0,16,26,10,2,2,1,7404,7438,15
Task 7405,Job 0,7,7,3,6,0,10,13,3,3,4,0,7405,7438,2
Task 7405,Job 1,12,4,4,6,0,16,18,2,4,1,2,7405,7438,13
Task 7406,Job 0,6,10,2,6,0,8,12,4,2,1,0,7406,7439,12
Task 7406,Job 1,11,7,1,7,1,12,18,6,1,4,2,7406,7439,6
Task 7407,Job 0,3,7,3,12,0,6,15,9,3,1,2,7407,7440,19
Task 7407,Job 1,8,9,1,7,1,9,15,6,1,4,1,7407,7440,12
Task 7408,Job 0,4,5,1,11,1,5,15,10,1,4,0,7408,7442,2
Task 7408,Job 1,9,6,4,10,1,13,19,6,4,1,0,7408,7442,7
Task 7409,Job 0,3,8,4,8,0,7,11,4,4,3,1,7409,7443,5
Task 7409,Job 1,8,4,3,12,1,11,20,9,3,1,0,7409,7443,12
Task 7410,Job 0,1,5,1,9,0,2,10,8,1,4,1,7410,7444,17
Task 7410,Job 1,6,7,4,7,1,10,13,3,4,2,2,7410,7444,15
Task 7411,Job 0,3,6,1,8,1,4,11,7,1,3,0,7411,7444,5
Task 7411,Job 1,8,6,2,10,1,10,18,8,2,3,1,7411,7444,14
Task 7412,Job 0,6,6,1,10,1,7,16,9,1,1,1,7412,7445,6
Task 7412,Job 1,11,7,2,10,0,13,21,8,2,3,0,7412,7445,18
Task 7413,Job 0,4,9,3,6,0,7,10,3,3,3,0,7413,7447,9
Task 7413,Job 1,9,8,4,12,0,13,21,8,4,2,2,7413,7447,8
Task 7414,Job 0,2,6,1,11,0,3,13,10,1,4,1,7414,7448,5
Task 7414,Job 1,7,9,2,10,0,9,17,8,2,4,0,7414,7448,4
Task 7415,Job 0,8,8,2,12,1,10,20,10,2,2,2,7415,7449,16
Task 7415,Job 1,13,9,4,12,0,17,25,8,4,3,0,7415,7449,13
Task 7416,Job 0,7,7,3,9,0,10,16,6,3,4,1,7416,7449,17
Task 7416,Job 1,12,6,1,8,0,13,20,7,1,1,0,7416,7449,6
Task 7417,Job 0,4,4,3,9,0,7,13,6,3,1,2,7417,7451,14
Task 7417,Job 1,9,9,1,12,0,10,21,11,1,4,0,7417,7451,18
Task 7418,Job 0,7,10,4,8,0,11,15,4,4,1,0,7418,7452,16
Task 7418,Job 1,12,6,4,12,0,16,24,8,4,3,2,7418,7452,14
Task 7419,Job 0,5,6,3,12,0,8,17,9,3,4,2,7419,7453,10
Task 7419,Job 1,10,9,4,12,1,14,22,8,4,4,0,7419,7453,3
Task 7420,Job 0,2,4,1,10,0,3,12,9,1,2,2,7420,7453,9
Task 7420,Job 1,7,7,3,7,0,10,14,4,3,3,2,7420,7453,16
Task 7421,Job 0,10,6,4,8,1,14,18,4,4,4,1,7421,7454,7
Task 7421,Job 1,15,10,3,6,1,18,21,3,3,1,0,7421,7454,4
Task 7422,Job 0,2,7,4,9,0,6,11,5,4,3,2,7422,7456,18
Task 7422,Job 1,7,4,3,9,0,10,16,6,3,3,2,7422,7456,16
Task 7423,Job 0,5,10,1,9,0,6,14,8,1,4,2,7423,7457,18
Task 7423,Job 1,10,5,4,11,0,14,21,7,4,2,1,7423,7457,5
Task 7424,Job 0,10,9,2,11,0,12,21,9,2,3,1,7424,7457,11
Task 7424,Job 1,15,5,2,11,1,17,26,9,2,3,0,7424,7457,13
Task 7425,Job 0,3,4,3,12,1,6,15,9,3,2,2,7425,7458,13
Task 7425,Job 1,8,8,4,6,1,12,14,2,4,1,0,7425,7458,16
Task 7426,Job 0,8,9,3,11,0,11,19,8,3,4,0,7426,7459,15
Task 7426,Job 1,13,7,4,6,1,17,19,2,4,3,1,7426,7459,8
Task 7427,Job 0,3,4,2,6,1,5,9,4,2,2,2,7427,7460,10
Task 7427,Job 1,8,6,4,10,1,12,18,6,4,4,0,7427,7460,8
Task 7428,Job 0,10,5,1,6,0,11,16,5,1,2,0,7428,7461,14
Task 7428,Job 1,15,6,2,8,0,17,23,6,2,1,1,7428,7461,8
Task 7429,Job 0,6,6,1,12,0,7,18,11,1,2,2,7429,7462,4
Task 7429,Job 1,11,8,4,8,0,15,19,4,4,4,2,7429,7462,14
Task 7430,Job 0,4,7,4,12,0,8,16,8,4,2,0,7430,7463,8
Task 7430,Job 1,9,10,1,7,1,10,16,6,1,4,1,7430,7463,9
Task 7431,Job 0,5,9,3,9,0,8,14,6,3,4,1,7431,7464,14
Task 7431,Job 1,10,9,4,8,0,14,18,4,4,2,1,7431,7464,5
Task 7432,Job 0,4,5,2,8,1,6,12,6,2,1,2,7432,7466,16
Task 7432,Job 1,9,5,3,8,0,12,17,5,3,2,2,7432,7466,17
Task 7433,Job 0,8,10,1,8,0,9,16,7,1,2,1,7433,7466,15
Task 7433,Job 1,13,10,1,6,0,14,19,5,1,3,1,7433,7466,17
Task 7434,Job 0,4,10,3,9,0,7,13,6,3,4,1,7434,7467,16
Task 7434,Job 1,9,7,1,9,0,10,18,8,1,2,2,7434,7467,18
Task 7435,Job 0,8,6,2,7,0,10,15,5,2,1,0,7435,7468,13
Task 7435,Job 1,13,9,3,7,0,16,20,4,3,2,0,7435,7468,17
Task 7436,Job 0,7,7,2,6,1,9,13,4,2,4,1,7436,7470,8
Task 7436,Job 1,12,9,3,10,1,15,22,7,3,3,2,7436,7470,9
Task 7437,Job 0,9,10,1,7,1,10,16,6,1,1,0,7437,7470,10
Task 7437,Job 1,14,6,4,12,1,18,26,8,4,1,1,7437,7470,4
Task 7438,Job 0,6,5,2,8,1,8,14,6,2,1,2,7438,7471,7
Task 7438,Job 1,11,5,4,12,0,15,23,8,4,2,2,7438,7471,12
Task 7439,Job 0,10,4,1,7,1,11,17,6,1,4,2,7439,7473,19
Task 7439,Job 1,15,6,1,9,0,16,24,8,1,2,2,7439,7473,12
Task 7440,Job 0,5,8,3,7,0,8,12,4,3,4,2,7440,7474,20
Task 7440,Job 1,10,6,2,7,1,12,17,5,2,2,1,7440,7474,20
Task 7441,Job 0,3,4,3,10,0,6,13,7,3,2,0,7441,7475,3
Task 7441,Job 1,8,4,4,9,0,12,17,5,4,2,2,7441,7475,2
Task 7442,Job 0,3,5,1,12,0,4,15,11,1,4,0,7442,7475,5
Task 7442,Job 1,8,8,4,6,0,12,14,2,4,4,2,7442,7475,5
Task 7443,Job 0,5,5,2,12,0,7,17,10,2,1,0,7443,7477,11
Task 7443,Job 1,10,6,2,8,1,12,18,6,2,1,1,7443,7477,12
Task 7444,Job 0,3,8,3,11,1,6,14,8,3,2,0,7444,7478,8
Task 7444,Job 1,8,5,1,6,0,9,14,5,1,3,2,7444,7478,20
Task 7445,Job 0,3,6,1,7,0,4,10,6,1,2,0,7445,7478,11
Task 7445,Job 1,8,6,3,7,0,11,15,4,3,2,1,7445,7478,3
Task 7446,Job 0,9,5,3,12,0,12,21,9,3,2,0,7446,7479,18
Task 7446,Job 1,14,9,3,9,1,17,23,6,3,1,2,7446,7479,4
Task 7447,Job 0,5,8,2,11,0,7,16,9,2,3,0,7447,7481,9
Task 7447,Job 1,10,8,3,9,0,13,19,6,3,3,0,7447,7481,4
Task 7448,Job 0,8,10,4,11,0,12,19,7,4,1,2,7448,7481,16
Task 7448,Job 1,13,7,3,11,0,16,24,8,3,1,1,7448,7481,13
Task 7449,Job 0,2,10,1,7,0,3,9,6,1,2,0,7449,7482,7
Task 7449,Job 1,7,10,2,7,0,9,14,5,2,1,0,7449,7482,3
Task 7450,Job 0,5,6,4,11,1,9,16,7,4,4,1,7450,7483,11
Task 7450,Job 1,10,6,2,12,0,12,22,10,2,2,0,7450,7483,6
Task 7451,Job 0,9,8,1,10,0,10,19,9,1,3,1,7451,7484,13
Task 7451,Job 1,14,10,1,11,0,15,25,10,1,2,1,7451,7484,10
Task 7452,Job 0,5,6,4,12,0,9,17,8,4,1,2,7452,7486,17
Task 7452,Job 1,10,9,1,6,0,11,16,5,1,1,1,7452,7486,5
Task 7453,Job 0,9,4,4,6,0,13,15,2,4,3,0,7453,7487,7
Task 7453,Job 1,14,8,3,10,0,17,24,7,3,2,0,7453,7487,13
Task 7454,Job 0,9,5,3,8,1,12,17,5,3,3,0,7454,7488,14
Task 7454,Job 1,14,6,2,10,0,16,24,8,2,2,0,7454,7488,5
Task 7455,Job 0,1,10,4,11,0,5,12,7,4,2,1,7455,7488,15
Task 7455,Job 1,6,7,4,8,0,10,14,4,4,4,0,7455,7488,17
Task 7456,Job 0,5,5,1,9,0,6,14,8,1,3,2,7456,7490,20
Task 7456,Job 1,10,8,1,9,0,11,19,8,1,2,0,7456,7490,17
Task 7457,Job 0,5,8,4,11,1,9,16,7,4,2,1,7457,7490,8
Task 7457,Job 1,10,10,2,7,0,12,17,5,2,4,2,7457,7490,16
Task 7458,Job 0,8,4,3,12,0,11,20,9,3,3,2,7458,7491,15
Task 7458,Job 1,13,4,3,8,1,16,21,5,3,3,2,7458,7491,4
Task 7459,Job 0,1,8,2,12,1,3,13,10,2,1,1,7459,7492,19
Task 7459,Job 1,6,9,1,12,0,7,18,11,1,4,2,7459,7492,20
Task 7460,Job 0,3,7,4,8,0,7,11,4,4,3,1,7460,7494,14
Task 7460,Job 1,8,5,4,7,0,12,15,3,4,4,1,7460,7494,8
Task 7461,Job 0,8,6,3,11,1,11,19,8,3,3,1,7461,7495,19
Task 7461,Job 1,13,4,4,12,1,17,25,8,4,2,0,7461,7495,10
Task 7462,Job 0,6,5,2,8,1,8,14,6,2,1,1,7462,7495,16
Task 7462,Job 1,11,4,1,12,0,12,23,11,1,4,1,7462,7495,12
Task 7463,Job 0,8,10,3,11,0,11,19,8,3,1,0,7463,7497,5
Task 7463,Job 1,13,9,3,7,0,16,20,4,3,1,0,7463,7497,12
Task 7464,Job 0,8,9,2,12,0,10,20,10,2,4,0,7464,7498,19
Task 7464,Job 1,13,8,2,8,0,15,21,6,2,1,1,7464,7498,4
Task 7465,Job 0,6,10,2,9,0,8,15,7,2,1,1,7465,7498,11
Task 7465,Job 1,11,8,1,10,0,12,21,9,1,4,2,7465,7498,14
Task 7466,Job 0,4,6,3,7,0,7,11,4,3,4,2,7466,7500,13
Task 7466,Job 1,9,8,2,8,0,11,17,6,2,4,1,7466,7500,11
Task 7467,Job 0,7,10,2,10,0,9,17,8,2,1,1,7467,7501,10
Task 7467,Job 1,12,5,4,8,0,16,20,4,4,3,0,7467,7501,19
Task 7468,Job 0,10,6,2,10,0,12,20,8,2,4,0,7468,7502,11
Task 7468,Job 1,15,8,1,6,0,16,21,5,1,4,1,7468,7502,10
Task 7469,Job 0,2,6,3,7,0,5,9,4,3,4,2,7469,7503,17
Task 7469,Job 1,7,10,3,8,0,10,15,5,3,2,1,7469,7503,5
Task 7470,Job 0,5,7,4,12,0,9,17,8,4,2,0,7470,7504,6
Task 7470,Job 1,10,4,4,6,0,14,16,2,4,2,0,7470,7504,8
Task 7471,Job 0,1,6,2,7,0,3,8,5,2,4,0,7471,7505,20
Task 7471,Job 1,6,6,1,6,0,7,12,5,1,2,1,7471,7505,8
Task 7472,Job 0,3,7,2,10,0,5,13,8,2,2,1,7472,7505,20
Task 7472,Job 1,8,5,3,8,1,11,16,5,3,3,2,7472,7505,14
Task 7473,Job 0,5,6,4,7,1,9,12,3,4,4,2,7473,7507,15
Task 7473,Job 1,10,4,1,6,1,11,16,5,1,4,2,7473,7507,13
Task 7474,Job 0,9,5,4,10,0,13,19,6,4,4,2,7474,7508,12
Task 7474,Job 1,14,5,1,10,0,15,24,9,1,4,2,7474,7508,6
Task 7475,Job 0,8,7,4,9,1,12,17,5,4,1,1,7475,7509,15
Task 7475,Job 1,13,7,4,6,0,17,19,2,4,3,0,7475,7509,8
Task 7476,Job 0,3,9,3,10,0,6,13,7,3,3,2,7476,7509,3
Task 7476,Job 1,8,4,1,11,0,9,19,10,1,3,1,7476,7509,14
Task 7477,Job 0,5,7,3,12,0,8,17,9,3,1,0,7477,7511,9
Task 7477,Job 1,10,10,4,8,0,14,18,4,4,1,2,7477,7511,18
Task 7478,Job 0,10,9,2,8,0,12,18,6,2,3,0,7478,7512,16
Task 7478,Job 1,15,10,1,9,0,16,24,8,1,1,2,7478,7512,6
Task 7479,Job 0,9,6,2,12,0,11,21,10,2,4,0,7479,7512,19
Task 7479,Job 1,14,5,4,7,0,18,21,3,4,3,0,7479,7512,8
Task 7480,Job 0,3,4,4,10,0,7,13,6,4,4,2,7480,7513,16
Task 7480,Job 1,8,8,2,11,0,10,19,9,2,3,1,7480,7513,18
Task 7481,Job 0,7,5,4,7,0,11,14,3,4,2,1,7481,7514,7
Task 7481,Job 1,12,8,1,10,1,13,22,9,1,2,1,7481,7514,2
Task 7482,Job 0,7,9,1,9,0,8,16,8,1,4,2,7482,7515,3
Task 7482,Job 1,12,5,4,7,0,16,19,3,4,2,1,7482,7515,15
Task 7483,Job 0,8,7,3,9,1,11,17,6,3,1,1,7483,7516,8
Task 7483,Job 1,13,4,4,6,0,17,19,2,4,2,0,7483,7516,2
Task 7484,Job 0,5,5,2,9,0,7,14,7,2,4,1,7484,7517,2
Task 7484,Job 1,10,7,1,10,1,11,20,9,1,3,1,7484,7517,3
Task 7485,Job 0,7,8,2,7,0,9,14,5,2,4,2,7485,7518,15
Task 7485,Job 1,12,8,1,10,1,13,22,9,1,3,0,7485,7518,16
Task 7486,Job 0,2,5,2,6,0,4,8,4,2,2,0,7486,7519,6
Task 7486,Job 1,7,10,4,9,1,11,16,5,4,2,1,7486,7519,11
Task 7487,Job 0,6,9,1,9,0,7,15,8,1,3,0,7487,7521,2
Task 7487,Job 1,11,6,4,6,1,15,17,2,4,3,0,7487,7521,7
Task 7488,Job 0,2,10,3,11,1,5,13,8,3,1,1,7488,7522,15
Task 7488,Job 1,7,4,1,9,1,8,16,8,1,2,2,7488,7522,13
Task 7489,Job 0,6,6,2,8,1,8,14,6,2,2,1,7489,7522,10
Task 7489,Job 1,11,6,4,9,0,15,20,5,4,4,2,7489,7522,10
Task 7490,Job 0,9,9,1,12,1,10,21,11,1,4,0,7490,7524,5
Task 7490,Job 1,14,10,3,8,1,17,22,5,3,1,1,7490,7524,18
Task 7491,Job 0,9,4,2,6,1,11,15,4,2,1,1,7491,7525,15
Task 7491,Job 1,14,5,4,12,0,18,26,8,4,3,1,7491,7525,5
Task 7492,Job 0,5,10,4,10,0,9,15,6,4,2,1,7492,7525,16
Task 7492,Job 1,10,7,1,6,0,11,16,5,1,2,2,7492,7525,4
Task 7493,Job 0,9,8,2,8,0,11,17,6,2,1,2,7493,7527,15
Task 7493,Job 1,14,6,1,10,0,15,24,9,1,4,1,7493,7527,16
Task 7494,Job 0,2,4,4,6,0,6,8,2,4,1,0,7494,7528,2
Task 7494,Job 1,7,6,1,6,1,8,13,5,1,1,0,7494,7528,5
Task 7495,Job 0,2,10,1,7,0,3,9,6,1,2,1,7495,7528,7
Task 7495,Job 1,7,10,2,12,0,9,19,10,2,2,1,7495,7528,15
Task 7496,Job 0,2,10,4,9,0,6,11,5,4,3,0,7496,7529,7
Task 7496,Job 1,7,5,1,7,0,8,14,6,1,4,2,7496,7529,2
Task 7497,Job 0,6,10,4,12,0,10,18,8,4,2,2,7497,7531,13
Task 7497,Job 1,11,7,4,8,1,15,19,4,4,3,0,7497,7531,17
Task 7498,Job 0,9,5,2,11,0,11,20,9,2,2,2,7498,7531,9
Task 7498,Job 1,14,5,4,10,0,18,24,6,4,4,2,7498,7531,6
Task 7499,Job 0,2,7,3,11,0,5,13,8,3,2,2,7499,7532,16
Task 7499,Job 1,7,9,1,7,1,8,14,6,1,4,2,7499,7532,15
Task 7500,Job 0,4,10,1,12,0,5,16,11,1,1,0,7500,7533,17
Task 7500,Job 1,9,5,1,6,1,10,15,5,1,3,2,7500,7533,3
Task 7501,Job 0,9,5,1,12,1,10,21,11,1,4,1,7501,7535,15
Task 7501,Job 1,14,9,1,8,0,15,22,7,1,3,2,7501,7535,17
Task 7502,Job 0,6,5,1,9,0,7,15,8,1,3,0,7502,7535,7
Task 7502,Job 1,11,5,1,8,1,12,19,7,1,4,0,7502,7535,4
Task 7503,Job 0,3,10,3,10,1,6,13,7,3,2,0,7503,7536,19
Task 7503,Job 1,8,6,1,6,1,9,14,5,1,2,0,7503,7536,7
Task 7504,Job 0,8,7,2,6,1,10,14,4,2,4,0,7504,7537,11
Task 7504,Job 1,13,6,3,9,0,16,22,6,3,3,1,7504,7537,16
Task 7505,Job 0,9,8,3,11,1,12,20,8,3,3,0,7505,7539,5
Task 7505,Job 1,14,6,1,11,0,15,25,10,1,1,0,7505,7539,11
Task 7506,Job 0,1,8,1,8,0,2,9,7,1,3,0,7506,7539,15
Task 7506,Job 1,6,7,1,10,0,7,16,9,1,3,2,7506,7539,19
Task 7507,Job 0,5,8,2,6,0,7,11,4,2,3,0,7507,7541,13
Task 7507,Job 1,10,10,4,7,0,14,17,3,4,2,2,7507,7541,3
Task 7508,Job 0,2,9,4,8,0,6,10,4,4,2,2,7508,7542,17
Task 7508,Job 1,7,10,4,12,0,11,19,8,4,2,0,7508,7542,13
Task 7509,Job 0,5,4,1,9,0,6,14,8,1,2,1,7509,7543,6
Task 7509,Job 1,10,10,4,9,0,14,19,5,4,1,2,7509,7543,8
Task 7510,Job 0,6,6,2,7,1,8,13,5,2,2,0,7510,7544,3
Task 7510,Job 1,11,4,4,12,0,15,23,8,4,1,1,7510,7544,16
Task 7511,Job 0,6,9,1,11,0,7,17,10,1,3,1,7511,7545,5
Task 7511,Job 1,11,4,1,10,0,12,21,9,1,1,0,7511,7545,6
Task 7512,Job 0,3,10,3,11,1,6,14,8,3,2,1,7512,7545,5
Task 7512,Job 1,8,9,2,9,1,10,17,7,2,2,2,7512,7545,7
Task 7513,Job 0,1,4,1,11,0,2,12,10,1,1,1,7513,7546,6
Task 7513,Job 1,6,8,3,12,1,9,18,9,3,2,0,7513,7546,7
Task 7514,Job 0,4,5,3,10,0,7,14,7,3,1,0,7514,7547,10
Task 7514,Job 1,9,6,2,6,0,11,15,4,2,4,0,7514,7547,20
Task 7515,Job 0,10,5,4,7,0,14,17,3,4,3,0,7515,7549,18
Task 7515,Job 1,15,4,3,6,0,18,21,3,3,3,2,7515,7549,20
Task 7516,Job 0,5,9,1,7,1,6,12,6,1,4,0,7516,7550,15
Task 7516,Job 1,10,7,2,10,0,12,20,8,2,3,0,7516,7550,3
Task 7517,Job 0,2,8,2,11,0,4,13,9,2,2,0,7517,7551,12
Task 7517,Job 1,7,10,4,11,0,11,18,7,4,4,2,7517,7551,7
Task 7518,Job 0,8,6,3,9,0,11,17,6,3,3,1,7518,7552,2
Task 7518,Job 1,13,10,3,10,1,16,23,7,3,3,0,7518,7552,7
Task 7519,Job 0,2,10,3,6,0,5,8,3,3,1,1,7519,7553,8
Task 7519,Job 1,7,6,4,10,1,11,17,6,4,1,0,7519,7553,13
Task 7520,Job 0,10,9,2,6,0,12,16,4,2,3,1,7520,7554,5
Task 7520,Job 1,15,7,1,7,0,16,22,6,1,1,0,7520,7554,4
Task 7521,Job 0,3,7,4,12,0,7,15,8,4,3,2,7521,7555,14
Task 7521,Job 1,8,10,1,6,0,9,14,5,1,4,0,7521,7555,15
Task 7522,Job 0,1,5,4,12,0,5,13,8,4,2,0,7522,7555,14
Task 7522,Job 1,6,9,3,11,0,9,17,8,3,1,0,7522,7555,11
Task 7523,Job 0,8,4,3,12,1,11,20,9,3,2,2,7523,7556,6
Task 7523,Job 1,13,8,4,6,0,17,19,2,4,4,1,7523,7556,19
Task 7524,Job 0,9,6,1,12,0,10,21,11,1,4,0,7524,7558,16
Task 7524,Job 1,14,6,2,6,0,16,20,4,2,1,1,7524,7558,2
Task 7525,Job 0,3,10,3,12,0,6,15,9,3,3,0,7525,7558,15
Task 7525,Job 1,8,5,3,9,0,11,17,6,3,3,2,7525,7558,13
Task 7526,Job 0,4,6,4,10,0,8,14,6,4,1,0,7526,7560,14
Task 7526,Job 1,9,8,4,11,0,13,20,7,4,3,2,7526,7560,10
Task 7527,Job 0,10,7,1,10,1,11,20,9,1,2,0,7527,7560,6
Task 7527,Job 1,15,8,4,6,0,19,21,2,4,2,2,7527,7560,8
Task 7528,Job 0,10,7,1,12,0,11,22,11,1,3,2,7528,7562,17
Task 7528,Job 1,15,7,4,12,0,19,27,8,4,4,0,7528,7562,4
Task 7529,Job 0,7,4,2,9,0,9,16,7,2,4,1,7529,7563,14
Task 7529,Job 1,12,5,2,9,0,14,21,7,2,2,2,7529,7563,19
Task 7530,Job 0,4,10,3,6,1,7,10,3,3,2,2,7530,7563,8
Task 7530,Job 1,9,10,2,9,0,11,18,7,2,3,1,7530,7563,4
Task 7531,Job 0,5,4,4,7,0,9,12,3,4,4,2,7531,7565,19
Task 7531,Job 1,10,6,4,12,0,14,22,8,4,4,2,7531,7565,2
Task 7532,Job 0,3,5,4,10,1,7,13,6,4,4,0,7532,7566,3
Task 7532,Job 1,8,8,3,6,0,11,14,3,3,1,2,7532,7566,13
Task 7533,Job 0,9,6,1,12,0,10,21,11,1,3,1,7533,7566,5
Task 7533,Job 1,14,5,4,8,1,18,22,4,4,1,1,7533,7566,4
Task 7534,Job 0,7,7,1,9,0,8,16,8,1,2,0,7534,7568,2
Task 7534,Job 1,12,4,4,10,1,16,22,6,4,1,0,7534,7568,4
Task 7535,Job 0,1,6,1,7,0,2,8,6,1,2,1,7535,7569,9
Task 7535,Job 1,6,10,2,11,0,8,17,9,2,2,0,7535,7569,17
Task 7536,Job 0,6,7,3,10,0,9,16,7,3,3,2,7536,7569,16
Task 7536,Job 1,11,10,3,11,0,14,22,8,3,3,2,7536,7569,10
Task 7537,Job 0,9,6,1,12,1,10,21,11,1,2,1,7537,7571,7
Task 7537,Job 1,14,9,3,12,0,17,26,9,3,3,2,7537,7571,9
Task 7538,Job 0,7,4,4,6,1,11,13,2,4,1,2,7538,7572,6
Task 7538,Job 1,12,4,2,11,0,14,23,9,2,3,0,7538,7572,3
Task 7539,Job 0,6,7,1,10,0,7,16,9,1,4,2,7539,7573,17
Task 7539,Job 1,11,8,3,8,0,14,19,5,3,3,0,7539,7573,19
Task 7540,Job 0,6,8,3,6,0,9,12,3,3,1,1,7540,7573,10
Task 7540,Job 1,11,10,1,11,1,12,22,10,1,1,1,7540,7573,10
Task 7541,Job 0,8,7,2,12,0,10,20,10,2,2,1,7541,7574,12
Task 7541,Job 1,13,10,3,7,0,16,20,4,3,4,1,7541,7574,18
Task 7542,Job 0,5,10,2,7,0,7,12,5,2,3,2,7542,7575,11
Task 7542,Job 1,10,10,4,10,0,14,20,6,4,2,0,7542,7575,17
Task 7543,Job 0,6,9,2,11,1,8,17,9,2,4,1,7543,7577,20
Task 7543,Job 1,11,6,3,12,0,14,23,9,3,4,1,7543,7577,15
Task 7544,Job 0,6,8,2,10,0,8,16,8,2,3,0,7544,7578,2
Task 7544,Job 1,11,5,3,11,0,14,22,8,3,2,2,7544,7578,13
Task 7545,Job 0,5,6,1,8,0,6,13,7,1,3,0,7545,7578,2
Task 7545,Job 1,10,5,1,9,1,11,19,8,1,4,1,7545,7578,12
Task 7546,Job 0,5,9,3,12,0,8,17,9,3,2,1,7546,7580,10
Task 7546,Job 1,10,6,3,7,0,13,17,4,3,3,2,7546,7580,12
Task 7547,Job 0,4,8,1,7,0,5,11,6,1,1,2,7547,7581,19
Task 7547,Job 1,9,7,2,8,0,11,17,6,2,4,2,7547,7581,4
Task 7548,Job 0,7,7,2,8,0,9,15,6,2,1,2,7548,7582,11
Task 7548,Job 1,12,9,1,10,0,13,22,9,1,1,1,7548,7582,5
Task 7549,Job 0,3,8,3,8,0,6,11,5,3,1,1,7549,7582,19
Task 7549,Job 1,8,4,2,12,0,10,20,10,2,3,0,7549,7582,5
Task 7550,Job 0,2,7,3,7,0,5,9,4,3,2,0,7550,7584,5
Task 7550,Job 1,7,8,4,11,0,11,18,7,4,4,1,7550,7584,18
Task 7551,Job 0,8,5,1,10,1,9,18,9,1,1,1,7551,7585,20
Task 7551,Job 1,13,8,3,11,0,16,24,8,3,3,1,7551,7585,20
Task 7552,Job 0,9,10,1,12,0,10,21,11,1,1,2,7552,7585,10
Task 7552,Job 1,14,8,3,6,0,17,20,3,3,1,1,7552,7585,8
Task 7553,Job 0,1,10,2,11,0,3,12,9,2,2,1,7553,7586,7
Task 7553,Job 1,6,9,3,7,0,9,13,4,3,1,0,7553,7586,11
Task 7554,Job 0,2,8,4,10,1,6,12,6,4,3,2,7554,7587,16
Task 7554,Job 1,7,5,4,10,0,11,17,6,4,3,0,7554,7587,18
Task 7555,Job 0,10,7,4,9,1,14,19,5,4,2,1,7555,7589,3
Task 7555,Job 1,15,10,3,11,0,18,26,8,3,1,0,7555,7589,7
Task 7556,Job 0,7,6,3,9,0,10,16,6,3,2,1,7556,7590,5
Task 7556,Job 1,12,8,3,9,0,15,21,6,3,1,0,7556,7590,16
Task 7557,Job 0,6,5,3,11,0,9,17,8,3,2,2,7557,7590,3
Task 7557,Job 1,11,5,3,11,0,14,22,8,3,3,2,7557,7590,8
Task 7558,Job 0,9,9,3,7,0,12,16,4,3,3,2,7558,7592,13
Task 7558,Job 1,14,9,1,10,0,15,24,9,1,4,0,7558,7592,9
Task 7559,Job 0,3,6,4,10,0,7,13,6,4,3,2,7559,7593,3
Task 7559,Job 1,8,8,4,8,0,12,16,4,4,2,1,7559,7593,18
Task 7560,Job 0,7,10,1,10,1,8,17,9,1,1,0,7560,7593,16
Task 7560,Job 1,12,5,2,9,1,14,21,7,2,3,0,7560,7593,11
Task 7561,Job 0,9,6,2,9,0,11,18,7,2,4,1,7561,7594,10
Task 7561,Job 1,14,7,1,9,0,15,23,8,1,3,0,7561,7594,16
Task 7562,Job 0,9,10,1,11,0,10,20,10,1,1,2,7562,7595,17
Task 7562,Job 1,14,7,2,8,0,16,22,6,2,1,2,7562,7595,17
Task 7563,Job 0,7,5,4,6,0,11,13,2,4,4,0,7563,7596,11
Task 7563,Job 1,12,5,2,6,0,14,18,4,2,3,2,7563,7596,7
Task 7564,Job 0,3,6,4,7,0,7,10,3,4,3,0,7564,7598,16
Task 7564,Job 1,8,4,1,6,0,9,14,5,1,1,0,7564,7598,4
Task 7565,Job 0,2,10,4,6,1,6,8,2,4,2,1,7565,7599,9
Task 7565,Job 1,7,9,1,10,0,8,17,9,1,4,1,7565,7599,11
Task 7566,Job 0,6,6,2,7,0,8,13,5,2,2,2,7566,7600,17
Task 7566,Job 1,11,7,4,6,0,15,17,2,4,3,2,7566,7600,3
Task 7567,Job 0,9,9,3,12,0,12,21,9,3,2,1,7567,7601,8
Task 7567,Job 1,14,4,2,12,0,16,26,10,2,1,2,7567,7601,9
Task 7568,Job 0,5,6,3,8,0,8,13,5,3,3,1,7568,7601,19
Task 7568,Job 1,10,9,1,12,0,11,22,11,1,1,0,7568,7601,6
Task 7569,Job 0,9,4,3,12,0,12,21,9,3,1,1,7569,7603,5
Task 7569,Job 1,14,4,1,10,0,15,24,9,1,2,2,7569,7603,6
Task 7570,Job 0,2,8,2,7,0,4,9,5,2,2,0,7570,7604,12
Task 7570,Job 1,7,9,1,8,0,8,15,7,1,3,1,7570,7604,7
Task 7571,Job 0,6,10,2,9,1,8,15,7,2,4,1,7571,7604,4
Task 7571,Job 1,11,8,1,10,0,12,21,9,1,4,2,7571,7604,11
Task 7572,Job 0,10,5,3,9,0,13,19,6,3,1,2,7572,7606,11
Task 7572,Job 1,15,6,2,12,0,17,27,10,2,3,0,7572,7606,2
Task 7573,Job 0,3,10,3,8,0,6,11,5,3,3,2,7573,7607,15
Task 7573,Job 1,8,7,1,6,1,9,14,5,1,3,2,7573,7607,13
Task 7574,Job 0,1,6,4,12,0,5,13,8,4,4,2,7574,7608,6
Task 7574,Job 1,6,4,4,8,0,10,14,4,4,3,1,7574,7608,7
Task 7575,Job 0,6,9,1,8,1,7,14,7,1,2,0,7575,7609,20
Task 7575,Job 1,11,10,3,9,0,14,20,6,3,4,1,7575,7609,13
Task 7576,Job 0,7,7,2,7,1,9,14,5,2,1,2,7576,7609,9
Task 7576,Job 1,12,6,4,11,0,16,23,7,4,3,0,7576,7609,12
Task 7577,Job 0,7,9,4,9,0,11,16,5,4,3,0,7577,7610,17
Task 7577,Job 1,12,4,3,11,0,15,23,8,3,1,0,7577,7610,9
Task 7578,Job 0,8,9,3,6,1,11,14,3,3,3,1,7578,7611,7
Task 7578,Job 1,13,8,1,7,1,14,20,6,1,4,0,7578,7611,9
Task 7579,Job 0,9,5,1,8,0,10,17,7,1,3,1,7579,7612,9
Task 7579,Job 1,14,7,3,7,1,17,21,4,3,3,2,7579,7612,13
Task 7580,Job 0,7,8,3,8,1,10,15,5,3,2,1,7580,7614,6
Task 7580,Job 1,12,5,2,7,0,14,19,5,2,3,2,7580,7614,17
Task 7581,Job 0,8,6,2,7,1,10,15,5,2,2,0,7581,7615,3
Task 7581,Job 1,13,5,1,6,1,14,19,5,1,2,0,7581,7615,17
Task 7582,Job 0,1,9,4,9,0,5,10,5,4,1,1,7582,7615,6
Task 7582,Job 1,6,7,3,6,1,9,12,3,3,3,2,7582,7615,4
Task 7583,Job 0,3,4,2,12,0,5,15,10,2,4,2,7583,7617,18
Task 7583,Job 1,8,5,3,10,0,11,18,7,3,4,2,7583,7617,16
Task 7584,Job 0,9,7,1,7,1,10,16,6,1,2,1,7584,7618,6
Task 7584,Job 1,14,4,3,10,0,17,24,7,3,4,2,7584,7618,12
Task 7585,Job 0,8,8,4,8,0,12,16,4,4,1,0,7585,7618,4
Task 7585,Job 1,13,10,1,8,1,14,21,7,1,3,2,7585,7618,15
Task 7586,Job 0,6,7,2,7,0,8,13,5,2,1,0,7586,7620,16
Task 7586,Job 1,11,6,4,9,0,15,20,5,4,2,0,7586,7620,3
Task 7587,Job 0,2,5,1,8,1,3,10,7,1,1,1,7587,7621,9
Task 7587,Job 1,7,7,2,10,0,9,17,8,2,3,1,7587,7621,5
Task 7588,Job 0,10,7,2,7,1,12,17,5,2,3,0,7588,7622,12
Task 7588,Job 1,15,5,3,12,0,18,27,9,3,2,2,7588,7622,8
Task 7589,Job 0,7,10,3,9,0,10,16,6,3,3,0,7589,7622,3
Task 7589,Job 1,12,7,3,6,0,15,18,3,3,4,1,7589,7622,13
Task 7590,Job 0,9,5,3,9,1,12,18,6,3,4,0,7590,7624,5
Task 7590,Job 1,14,6,4,8,0,18,22,4,4,3,2,7590,7624,14
Task 7591,Job 0,1,8,3,10,1,4,11,7,3,1,2,7591,7625,18
Task 7591,Job 1,6,8,2,12,0,8,18,10,2,1,2,7591,7625,15
Task 7592,Job 0,4,10,2,8,0,6,12,6,2,3,2,7592,7626,12
Task 7592,Job 1,9,9,2,10,0,11,19,8,2,4,0,7592,7626,19
Task 7593,Job 0,1,9,3,11,0,4,12,8,3,3,1,7593,7626,12
Task 7593,Job 1,6,4,1,8,1,7,14,7,1,3,2,7593,7626,2
Task 7594,Job 0,3,6,2,6,1,5,9,4,2,3,2,7594,7627,14
Task 7594,Job 1,8,7,1,11,0,9,19,10,1,2,1,7594,7627,8
Task 7595,Job 0,5,9,2,8,0,7,13,6,2,4,2,7595,7629,10
Task 7595,Job 1,10,10,1,6,1,11,16,5,1,4,1,7595,7629,6
Task 7596,Job 0,5,8,2,6,0,7,11,4,2,3,2,7596,7629,7
Task 7596,Job 1,10,4,2,12,0,12,22,10,2,4,2,7596,7629,11
Task 7597,Job 0,7,6,4,11,1,11,18,7,4,2,0,7597,7631,19
Task 7597,Job 1,12,9,3,8,0,15,20,5,3,2,1,7597,7631,11
Task 7598,Job 0,3,10,1,11,1,4,14,10,1,3,2,7598,7631,20
Task 7598,Job 1,8,8,1,7,1,9,15,6,1,3,2,7598,7631,16
Task 7599,Job 0,5,4,2,8,1,7,13,6,2,1,2,7599,7632,15
Task 7599,Job 1,10,10,2,12,0,12,22,10,2,3,0,7599,7632,8
Task 7600,Job 0,8,4,2,7,1,10,15,5,2,2,1,7600,7633,8
Task 7600,Job 1,13,10,3,12,0,16,25,9,3,4,0,7600,7633,3
Task 7601,Job 0,7,9,3,7,0,10,14,4,3,3,2,7601,7635,8
Task 7601,Job 1,12,6,2,12,0,14,24,10,2,3,1,7601,7635,18
Task 7602,Job 0,8,9,1,9,0,9,17,8,1,4,0,7602,7635,10
Task 7602,Job 1,13,8,2,6,0,15,19,4,2,2,0,7602,7635,2
Task 7603,Job 0,2,10,3,11,0,5,13,8,3,1,0,7603,7637,4
Task 7603,Job 1,7,7,4,10,1,11,17,6,4,3,1,7603,7637,9
Task 7604,Job 0,3,5,1,12,1,4,15,11,1,3,0,7604,7637,15
Task 7604,Job 1,8,10,3,8,0,11,16,5,3,3,0,7604,7637,17
Task 7605,Job 0,7,9,2,7,0,9,14,5,2,4,2,7605,7639,16
Task 7605,Job 1,12,9,1,8,0,13,20,7,1,3,0,7605,7639,18
Task 7606,Job 0,2,9,4,11,1,6,13,7,4,1,0,7606,7640,13
Task 7606,Job 1,7,5,4,12,1,11,19,8,4,3,0,7606,7640,14
Task 7607,Job 0,5,9,1,8,0,6,13,7,1,3,0,7607,7640,14
Task 7607,Job 1,10,4,4,11,0,14,21,7,4,4,2,7607,7640,7
Task 7608,Job 0,1,5,2,9,1,3,10,7,2,1,2,7608,7641,4
Task 7608,Job 1,6,10,3,10,0,9,16,7,3,1,0,7608,7641,18
Task 7609,Job 0,10,5,4,10,0,14,20,6,4,1,0,7609,7642,10
Task 7609,Job 1,15,9,1,11,0,16,26,10,1,3,0,7609,7642,7
Task 7610,Job 0,10,9,4,7,0,14,17,3,4,3,1,7610,7643,15
Task 7610,Job 1,15,10,1,12,1,16,27,11,1,1,0,7610,7643,6
Task 7611,Job 0,5,7,4,8,0,9,13,4,4,4,1,7611,7645,7
Task 7611,Job 1,10,4,3,10,0,13,20,7,3,3,2,7611,7645,9
Task 7612,Job 0,2,7,2,6,0,4,8,4,2,4,2,7612,7646,5
Task 7612,Job 1,7,8,4,8,1,11,15,4,4,3,0,7612,7646,20
Task 7613,Job 0,7,6,4,10,0,11,17,6,4,1,0,7613,7646,10
Task 7613,Job 1,12,6,4,6,0,16,18,2,4,4,0,7613,7646,3
Task 7614,Job 0,4,4,4,10,0,8,14,6,4,2,2,7614,7647,17
Task 7614,Job 1,9,10,3,8,1,12,17,5,3,4,1,7614,7647,14
Task 7615,Job 0,1,9,1,8,0,2,9,7,1,3,1,7615,7649,4
Task 7615,Job 1,6,9,4,9,0,10,15,5,4,4,2,7615,7649,9
Task 7616,Job 0,4,9,2,12,0,6,16,10,2,3,1,7616,7650,17
Task 7616,Job 1,9,9,2,12,0,11,21,10,2,4,1,7616,7650,19
Task 7617,Job 0,3,10,4,7,0,7,10,3,4,3,0,7617,7651,18
Task 7617,Job 1,8,10,1,7,1,9,15,6,1,3,0,7617,7651,5
Task 7618,Job 0,8,4,3,11,0,11,19,8,3,2,0,7618,7651,7
Task 7618,Job 1,13,8,1,9,0,14,22,8,1,3,0,7618,7651,16
Task 7619,Job 0,7,9,2,11,1,9,18,9,2,3,2,7619,7652,15
Task 7619,Job 1,12,10,3,8,0,15,20,5,3,2,0,7619,7652,5
Task 7620,Job 0,3,9,2,9,0,5,12,7,2,1,1,7620,7654,2
Task 7620,Job 1,8,6,1,11,1,9,19,10,1,1,1,7620,7654,4
Task 7621,Job 0,10,7,1,7,0,11,17,6,1,4,0,7621,7655,8
Task 7621,Job 1,15,5,2,11,0,17,26,9,2,2,1,7621,7655,14
Task 7622,Job 0,5,8,1,6,0,6,11,5,1,4,2,7622,7655,19
Task 7622,Job 1,10,5,3,8,0,13,18,5,3,3,2,7622,7655,13
Task 7623,Job 0,2,9,1,6,1,3,8,5,1,2,2,7623,7657,7
Task 7623,Job 1,7,5,3,12,0,10,19,9,3,4,2,7623,7657,18
Task 7624,Job 0,3,6,1,8,0,4,11,7,1,1,1,7624,7658,12
Task 7624,Job 1,8,10,2,11,0,10,19,9,2,2,2,7624,7658,19
Task 7625,Job 0,6,5,1,6,0,7,12,5,1,1,1,7625,7658,7
Task 7625,Job 1,11,9,2,6,0,13,17,4,2,1,2,7625,7658,16
Task 7626,Job 0,4,5,2,8,0,6,12,6,2,1,2,7626,7659,20
Task 7626,Job 1,9,5,2,8,0,11,17,6,2,3,0,7626,7659,13
Task 7627,Job 0,7,6,1,6,1,8,13,5,1,4,2,7627,7661,8
Task 7627,Job 1,12,6,2,10,0,14,22,8,2,4,2,7627,7661,4
Task 7628,Job 0,6,8,4,6,1,10,12,2,4,1,0,7628,7661,9
Task 7628,Job 1,11,7,4,8,0,15,19,4,4,4,1,7628,7661,17
Task 7629,Job 0,10,8,2,9,0,12,19,7,2,4,1,7629,7663,18
Task 7629,Job 1,15,8,2,12,0,17,27,10,2,4,0,7629,7663,7
Task 7630,Job 0,3,9,4,11,1,7,14,7,4,3,0,7630,7664,20
Task 7630,Job 1,8,10,3,8,0,11,16,5,3,4,0,7630,7664,9
Task 7631,Job 0,2,7,4,11,0,6,13,7,4,1,2,7631,7665,12
Task 7631,Job 1,7,10,1,10,1,8,17,9,1,3,2,7631,7665,16
Task 7632,Job 0,3,4,1,7,0,4,10,6,1,4,2,7632,7666,16
Task 7632,Job 1,8,5,1,11,0,9,19,10,1,4,2,7632,7666,20
Task 7633,Job 0,5,10,4,8,0,9,13,4,4,4,1,7633,7666,13
Task 7633,Job 1,10,6,3,12,0,13,22,9,3,1,2,7633,7666,19
Task 7634,Job 0,7,7,2,7,0,9,14,5,2,1,0,7634,7668,8
Task 7634,Job 1,12,5,4,6,0,16,18,2,4,4,0,7634,7668,8
Task 7635,Job 0,8,4,3,9,1,11,17,6,3,3,0,7635,7668,19
Task 7635,Job 1,13,10,3,12,0,16,25,9,3,2,1,7635,7668,18
Task 7636,Job 0,4,10,2,8,1,6,12,6,2,1,0,7636,7669,14
Task 7636,Job 1,9,4,4,7,0,13,16,3,4,1,1,7636,7669,2
Task 7637,Job 0,7,8,3,12,0,10,19,9,3,4,2,7637,7671,9
Task 7637,Job 1,12,10,1,6,0,13,18,5,1,4,0,7637,7671,9
Task 7638,Job 0,7,5,4,11,0,11,18,7,4,3,0,7638,7672,12
Task 7638,Job 1,12,10,2,10,0,14,22,8,2,2,0,7638,7672,17
Task 7639,Job 0,7,5,3,9,1,10,16,6,3,4,1,7639,7673,9
Task 7639,Job 1,12,10,4,11,0,16,23,7,4,2,0,7639,7673,14
Task 7640,Job 0,9,6,4,8,0,13,17,4,4,1,0,7640,7673,9
Task 7640,Job 1,14,7,2,6,0,16,20,4,2,2,0,7640,7673,6
Task 7641,Job 0,4,6,1,7,0,5,11,6,1,4,0,7641,7675,19
Task 7641,Job 1,9,7,3,9,0,12,18,6,3,1,0,7641,7675,17
Task 7642,Job 0,6,9,1,7,1,7,13,6,1,1,1,7642,7675,8
Task 7642,Job 1,11,9,1,11,0,12,22,10,1,4,2,7642,7675,4
Task 7643,Job 0,8,9,3,10,0,11,18,7,3,1,0,7643,7676,16
Task 7643,Job 1,13,4,4,9,0,17,22,5,4,3,2,7643,7676,3
Task 7644,Job 0,8,9,4,11,0,12,19,7,4,4,0,7644,7677,13
Task 7644,Job 1,13,8,2,7,1,15,20,5,2,1,1,7644,7677,7
Task 7645,Job 0,2,9,1,8,0,3,10,7,1,4,1,7645,7679,14
Task 7645,Job 1,7,5,1,9,0,8,16,8,1,1,0,7645,7679,17
Task 7646,Job 0,4,6,1,7,0,5,11,6,1,3,0,7646,7680,16
Task 7646,Job 1,9,4,2,9,0,11,18,7,2,1,0,7646,7680,16
Task 7647,Job 0,10,5,4,9,1,14,19,5,4,4,2,7647,7680,19
Task 7647,Job 1,15,4,3,12,0,18,27,9,3,2,1,7647,7680,20
Task 7648,Job 0,5,6,2,12,0,7,17,10,2,4,2,7648,7681,4
Task 7648,Job 1,10,6,1,11,1,11,21,10,1,2,0,7648,7681,17
Task 7649,Job 0,2,8,2,12,0,4,14,10,2,3,1,7649,7682,2
Task 7649,Job 1,7,6,4,11,1,11,18,7,4,2,1,7649,7682,8
Task 7650,Job 0,7,10,4,11,0,11,18,7,4,3,0,7650,7684,10
Task 7650,Job 1,12,8,4,7,0,16,19,3,4,4,0,7650,7684,9
Task 7651,Job 0,4,9,2,11,0,6,15,9,2,4,2,7651,7684,6
Task 7651,Job 1,9,9,1,10,1,10,19,9,1,3,2,7651,7684,4
Task 7652,Job 0,8,5,4,12,1,12,20,8,4,2,2,7652,7685,13
Task 7652,Job 1,13,5,4,10,0,17,23,6,4,3,1,7652,7685,19
Task 7653,Job 0,2,4,3,6,1,5,8,3,3,3,0,7653,7686,11
Task 7653,Job 1,7,5,4,12,1,11,19,8,4,3,0,7653,7686,8
Task 7654,Job 0,4,6,2,6,1,6,10,4,2,4,0,7654,7688,11
Task 7654,Job 1,9,10,2,12,0,11,21,10,2,2,2,7654,7688,3
Task 7655,Job 0,3,5,4,9,0,7,12,5,4,3,1,7655,7688,14
Task 7655,Job 1,8,6,2,9,0,10,17,7,2,2,0,7655,7688,8
Task 7656,Job 0,6,6,4,7,1,10,13,3,4,4,1,7656,7690,16
Task 7656,Job 1,11,5,1,9,0,12,20,8,1,1,2,7656,7690,11
Task 7657,Job 0,1,7,2,6,0,3,7,4,2,2,0,7657,7690,5
Task 7657,Job 1,6,6,1,9,0,7,15,8,1,3,2,7657,7690,9
Task 7658,Job 0,8,10,4,8,1,12,16,4,4,4,2,7658,7691,19
Task 7658,Job 1,13,7,1,12,0,14,25,11,1,2,2,7658,7691,3
Task 7659,Job 0,1,5,4,12,0,5,13,8,4,3,2,7659,7692,12
Task 7659,Job 1,6,8,2,10,0,8,16,8,2,3,1,7659,7692,7
Task 7660,Job 0,1,4,3,9,1,4,10,6,3,2,0,7660,7693,4
Task 7660,Job 1,6,4,2,12,1,8,18,10,2,1,1,7660,7693,10
Task 7661,Job 0,1,4,4,11,0,5,12,7,4,4,1,7661,7695,11
Task 7661,Job 1,6,10,2,12,0,8,18,10,2,4,1,7661,7695,18
Task 7662,Job 0,9,5,1,6,0,10,15,5,1,3,2,7662,7695,19
Task 7662,Job 1,14,7,2,8,0,16,22,6,2,1,0,7662,7695,18
Task 7663,Job 0,5,10,2,9,0,7,14,7,2,2,0,7663,7696,13
Task 7663,Job 1,10,4,4,9,0,14,19,5,4,1,1,7663,7696,7
Task 7664,Job 0,7,7,2,12,0,9,19,10,2,4,2,7664,7698,7
Task 7664,Job 1,12,4,4,8,0,16,20,4,4,1,0,7664,7698,2
Task 7665,Job 0,3,7,1,11,0,4,14,10,1,4,0,7665,7699,9
Task 7665,Job 1,8,6,1,11,1,9,19,10,1,2,1,7665,7699,5
Task 7666,Job 0,6,4,3,7,0,9,13,4,3,4,1,7666,7699,17
Task 7666,Job 1,11,5,1,8,0,12,19,7,1,1,1,7666,7699,19
Task 7667,Job 0,7,6,3,11,0,10,18,8,3,4,1,7667,7701,4
Task 7667,Job 1,12,9,1,11,0,13,23,10,1,2,2,7667,7701,13
Task 7668,Job 0,7,4,1,9,0,8,16,8,1,3,1,7668,7701,18
Task 7668,Job 1,12,8,4,11,1,16,23,7,4,2,0,7668,7701,19
Task 7669,Job 0,7,7,3,12,0,10,19,9,3,4,0,7669,7702,6
Task 7669,Job 1,12,10,3,10,0,15,22,7,3,4,2,7669,7702,7
Task 7670,Job 0,5,10,2,9,1,7,14,7,2,3,2,7670,7703,16
Task 7670,Job 1,10,8,4,7,1,14,17,3,4,4,2,7670,7703,12
Task 7671,Job 0,5,5,1,6,0,6,11,5,1,3,2,7671,7705,9
Task 7671,Job 1,10,6,1,10,0,11,20,9,1,1,1,7671,7705,5
Task 7672,Job 0,8,10,1,12,0,9,20,11,1,4,1,7672,7705,14
Task 7672,Job 1,13,5,1,6,0,14,19,5,1,2,0,7672,7705,11
Task 7673,Job 0,6,7,3,6,0,9,12,3,3,2,0,7673,7707,13
Task 7673,Job 1,11,5,2,6,0,13,17,4,2,1,0,7673,7707,11
Task 7674,Job 0,9,7,1,9,1,10,18,8,1,1,0,7674,7707,15
Task 7674,Job 1,14,9,2,12,0,16,26,10,2,2,2,7674,7707,3
Task 7675,Job 0,10,6,3,11,0,13,21,8,3,2,1,7675,7709,5
Task 7675,Job 1,15,8,1,9,1,16,24,8,1,3,2,7675,7709,4
Task 7676,Job 0,8,4,4,11,0,12,19,7,4,2,2,7676,7710,12
Task 7676,Job 1,13,9,3,10,0,16,23,7,3,1,0,7676,7710,6
Task 7677,Job 0,1,8,1,8,1,2,9,7,1,1,2,7677,7710,6
Task 7677,Job 1,6,4,4,8,0,10,14,4,4,3,0,7677,7710,14
Task 7678,Job 0,5,9,2,7,0,7,12,5,2,2,1,7678,7711,18
Task 7678,Job 1,10,6,3,10,0,13,20,7,3,4,2,7678,7711,20
Task 7679,Job 0,3,10,3,10,0,6,13,7,3,3,1,7679,7712,4
Task 7679,Job 1,8,7,1,10,0,9,18,9,1,3,1,7679,7712,20
Task 7680,Job 0,1,7,2,10,1,3,11,8,2,4,0,7680,7714,11
Task 7680,Job 1,6,9,2,6,0,8,12,4,2,3,1,7680,7714,16
Task 7681,Job 0,1,7,3,6,0,4,7,3,3,2,2,7681,7715,12
Task 7681,Job 1,6,9,1,11,0,7,17,10,1,3,1,7681,7715,14
Task 7682,Job 0,1,10,2,11,0,3,12,9,2,1,1,7682,7716,18
Task 7682,Job 1,6,4,3,6,0,9,12,3,3,2,0,7682,7716,12
Task 7683,Job 0,9,10,2,11,1,11,20,9,2,4,2,7683,7717,3
Task 7683,Job 1,14,10,4,7,1,18,21,3,4,4,1,7683,7717,6
Task 7684,Job 0,5,7,3,11,1,8,16,8,3,4,0,7684,7717,19
Task 7684,Job 1,10,7,1,12,1,11,22,11,1,3,2,7684,7717,20
Task 7685,Job 0,6,7,4,12,0,10,18,8,4,1,2,7685,7718,18
Task 7685,Job 1,11,10,1,8,0,12,19,7,1,2,2,7685,7718,19
Task 7686,Job 0,7,8,1,6,0,8,13,5,1,1,2,7686,7719,5
Task 7686,Job 1,12,8,4,11,1,16,23,7,4,1,2,7686,7719,13
Task 7687,Job 0,9,7,1,11,0,10,20,10,1,2,2,7687,7721,4
Task 7687,Job 1,14,7,3,12,0,17,26,9,3,1,2,7687,7721,16
Task 7688,Job 0,4,8,2,11,0,6,15,9,2,3,1,7688,7722,10
Task 7688,Job 1,9,8,4,11,0,13,20,7,4,2,2,7688,7722,14
Task 7689,Job 0,9,4,3,9,0,12,18,6,3,4,0,7689,7723,15
Task 7689,Job 1,14,10,3,10,0,17,24,7,3,3,1,7689,7723,16
Task 7690,Job 0,2,4,3,6,0,5,8,3,3,1,0,7690,7724,2
Task 7690,Job 1,7,10,2,10,0,9,17,8,2,1,0,7690,7724,16
Task 7691,Job 0,8,8,4,9,1,12,17,5,4,3,2,7691,7724,3
Task 7691,Job 1,13,6,1,10,0,14,23,9,1,2,0,7691,7724,2
Task 7692,Job 0,2,6,4,6,0,6,8,2,4,3,2,7692,7726,6
Task 7692,Job 1,7,4,3,12,0,10,19,9,3,2,2,7692,7726,2
Task 7693,Job 0,6,5,4,9,1,10,15,5,4,3,0,7693,7727,20
Task 7693,Job 1,11,5,1,6,0,12,17,5,1,1,1,7693,7727,14
Task 7694,Job 0,9,6,4,11,1,13,20,7,4,2,2,7694,7728,8
Task 7694,Job 1,14,10,2,12,0,16,26,10,2,1,1,7694,7728,8
Task 7695,Job 0,2,8,1,9,0,3,11,8,1,2,0,7695,7728,10
Task 7695,Job 1,7,4,2,10,0,9,17,8,2,1,0,7695,7728,4
Task 7696,Job 0,4,10,3,12,0,7,16,9,3,3,2,7696,7730,11
Task 7696,Job 1,9,7,2,6,0,11,15,4,2,3,2,7696,7730,19
Task 7697,Job 0,6,5,4,9,0,10,15,5,4,2,2,7697,7731,14
Task 7697,Job 1,11,10,2,6,0,13,17,4,2,3,0,7697,7731,6
Task 7698,Job 0,5,6,4,6,1,9,11,2,4,2,1,7698,7732,18
Task 7698,Job 1,10,9,1,11,0,11,21,10,1,3,2,7698,7732,14
Task 7699,Job 0,6,4,1,7,1,7,13,6,1,3,1,7699,7732,13
Task 7699,Job 1,11,5,2,9,0,13,20,7,2,3,2,7699,7732,4
Task 7700,Job 0,10,10,1,6,0,11,16,5,1,4,0,7700,7733,9
Task 7700,Job 1,15,6,1,11,1,16,26,10,1,2,0,7700,7733,4
Task 7701,Job 0,6,9,4,12,0,10,18,8,4,4,1,7701,7735,8
Task 7701,Job 1,11,10,3,7,0,14,18,4,3,2,1,7701,7735,6
Task 7702,Job 0,10,4,1,11,1,11,21,10,1,2,0,7702,7735,4
Task 7702,Job 1,15,9,2,10,0,17,25,8,2,4,1,7702,7735,15
Task 7703,Job 0,3,6,2,6,0,5,9,4,2,1,0,7703,7736,2
Task 7703,Job 1,8,5,2,8,1,10,16,6,2,3,0,7703,7736,6
Task 7704,Job 0,6,9,3,12,0,9,18,9,3,3,1,7704,7737,8
Task 7704,Job 1,11,8,3,12,1,14,23,9,3,3,1,7704,7737,7
Task 7705,Job 0,5,7,3,12,1,8,17,9,3,4,1,7705,7739,6
Task 7705,Job 1,10,7,1,6,0,11,16,5,1,1,1,7705,7739,17
Task 7706,Job 0,2,9,3,9,1,5,11,6,3,3,1,7706,7740,14
Task 7706,Job 1,7,6,4,7,0,11,14,3,4,2,1,7706,7740,8
Task 7707,Job 0,5,6,1,10,1,6,15,9,1,3,2,7707,7741,4
Task 7707,Job 1,10,4,3,11,0,13,21,8,3,4,1,7707,7741,19
Task 7708,Job 0,1,10,2,7,1,3,8,5,2,2,2,7708,7742,4
Task 7708,Job 1,6,7,4,9,0,10,15,5,4,3,0,7708,7742,4
Task 7709,Job 0,3,8,1,10,0,4,13,9,1,3,1,7709,7742,10
Task 7709,Job 1,8,7,4,10,0,12,18,6,4,1,2,7709,7742,5
Task 7710,Job 0,5,6,3,11,0,8,16,8,3,1,2,7710,7744,17
Task 7710,Job 1,10,6,3,9,0,13,19,6,3,4,0,7710,7744,10
Task 7711,Job 0,2,8,2,10,0,4,12,8,2,3,2,7711,7744,10
Task 7711,Job 1,7,7,1,12,0,8,19,11,1,1,0,7711,7744,4
Task 7712,Job 0,10,9,4,6,0,14,16,2,4,1,1,7712,7745,3
Task 7712,Job 1,15,4,4,6,0,19,21,2,4,4,2,7712,7745,8
Task 7713,Job 0,7,4,3,7,0,10,14,4,3,2,0,7713,7746,18
Task 7713,Job 1,12,10,1,10,0,13,22,9,1,4,1,7713,7746,19
Task 7714,Job 0,1,10,4,7,0,5,8,3,4,3,2,7714,7747,19
Task 7714,Job 1,6,5,1,12,0,7,18,11,1,4,1,7714,7747,5
Task 7715,Job 0,2,10,1,7,0,3,9,6,1,4,0,7715,7748,10
Task 7715,Job 1,7,6,1,6,1,8,13,5,1,4,0,7715,7748,7
Task 7716,Job 0,7,7,3,10,1,10,17,7,3,1,0,7716,7750,14
Task 7716,Job 1,12,8,4,7,0,16,19,3,4,3,1,7716,7750,9
Task 7717,Job 0,3,9,4,8,0,7,11,4,4,4,2,7717,7750,12
Task 7717,Job 1,8,8,4,10,0,12,18,6,4,2,0,7717,7750,14
Task 7718,Job 0,3,5,4,9,0,7,12,5,4,4,1,7718,7752,14
Task 7718,Job 1,8,10,4,7,0,12,15,3,4,1,1,7718,7752,3
Task 7719,Job 0,10,4,3,6,0,13,16,3,3,2,0,7719,7753,3
Task 7719,Job 1,15,9,3,8,0,18,23,5,3,3,0,7719,7753,14
Task 7720,Job 0,3,4,2,12,0,5,15,10,2,1,0,7720,7754,16
Task 7720,Job 1,8,8,3,7,0,11,15,4,3,3,1,7720,7754,6
Task 7721,Job 0,5,5,3,12,0,8,17,9,3,3,2,7721,7755,10
Task 7721,Job 1,10,6,4,6,0,14,16,2,4,4,1,7721,7755,19
Task 7722,Job 0,2,7,2,8,1,4,10,6,2,4,0,7722,7756,18
Task 7722,Job 1,7,6,3,12,1,10,19,9,3,2,0,7722,7756,11
Task 7723,Job 0,8,8,3,8,0,11,16,5,3,3,0,7723,7757,17
Task 7723,Job 1,13,8,4,11,0,17,24,7,4,4,2,7723,7757,8
Task 7724,Job 0,10,9,4,9,0,14,19,5,4,3,0,7724,7758,11
Task 7724,Job 1,15,4,1,10,0,16,25,9,1,3,1,7724,7758,18
Task 7725,Job 0,6,10,3,10,0,9,16,7,3,3,0,7725,7758,6
Task 7725,Job 1,11,5,4,11,0,15,22,7,4,2,2,7725,7758,15
Task 7726,Job 0,5,6,4,6,1,9,11,2,4,4,2,7726,7760,3
Task 7726,Job 1,10,10,1,6,1,11,16,5,1,3,2,7726,7760,6
Task 7727,Job 0,2,9,2,6,0,4,8,4,2,1,2,7727,7761,2
Task 7727,Job 1,7,5,2,7,0,9,14,5,2,3,2,7727,7761,8
Task 7728,Job 0,6,9,4,10,0,10,16,6,4,2,2,7728,7762,15
Task 7728,Job 1,11,7,2,12,0,13,23,10,2,3,1,7728,7762,15
Task 7729,Job 0,1,10,2,9,0,3,10,7,2,4,0,7729,7762,6
Task 7729,Job 1,6,7,1,9,0,7,15,8,1,1,2,7729,7762,15
Task 7730,Job 0,8,9,3,6,1,11,14,3,3,3,0,7730,7764,10
Task 7730,Job 1,13,7,3,11,0,16,24,8,3,2,0,7730,7764,2
Task 7731,Job 0,8,8,3,9,1,11,17,6,3,3,2,7731,7765,12
Task 7731,Job 1,13,7,1,12,1,14,25,11,1,3,1,7731,7765,9
Task 7732,Job 0,1,10,3,10,0,4,11,7,3,1,2,7732,7766,12
Task 7732,Job 1,6,7,1,8,0,7,14,7,1,3,0,7732,7766,5
Task 7733,Job 0,9,4,4,7,0,13,16,3,4,3,2,7733,7766,5
Task 7733,Job 1,14,7,4,8,0,18,22,4,4,2,1,7733,7766,10
Task 7734,Job 0,7,7,2,8,1,9,15,6,2,4,2,7734,7768,9
Task 7734,Job 1,12,7,4,8,0,16,20,4,4,3,1,7734,7768,20
Task 7735,Job 0,4,9,2,7,0,6,11,5,2,4,0,7735,7769,12
Task 7735,Job 1,9,6,3,10,0,12,19,7,3,2,0,7735,7769,5
Task 7736,Job 0,10,10,4,12,0,14,22,8,4,1,1,7736,7770,20
Task 7736,Job 1,15,6,1,7,0,16,22,6,1,3,2,7736,7770,8
Task 7737,Job 0,1,5,2,11,1,3,12,9,2,2,2,7737,7771,5
Task 7737,Job 1,6,9,3,9,0,9,15,6,3,2,1,7737,7771,14
Task 7738,Job 0,1,7,4,6,0,5,7,2,4,2,1,7738,7772,8
Task 7738,Job 1,6,6,2,10,0,8,16,8,2,3,1,7738,7772,3
Task 7739,Job 0,4,10,1,10,0,5,14,9,1,3,2,7739,7773,7
Task 7739,Job 1,9,5,1,8,0,10,17,7,1,2,2,7739,7773,19
Task 7740,Job 0,10,5,1,7,0,11,17,6,1,3,2,7740,7773,19
Task 7740,Job 1,15,4,3,9,0,18,24,6,3,2,2,7740,7773,7
Task 7741,Job 0,1,5,3,11,1,4,12,8,3,4,0,7741,7774,2
Task 7741,Job 1,6,5,2,12,0,8,18,10,2,4,0,7741,7774,12
Task 7742,Job 0,8,8,4,7,0,12,15,3,4,4,0,7742,7775,6
Task 7742,Job 1,13,4,4,7,0,17,20,3,4,2,0,7742,7775,3
Task 7743,Job 0,4,7,4,10,0,8,14,6,4,4,2,7743,7777,18
Task 7743,Job 1,9,8,1,8,1,10,17,7,1,3,1,7743,7777,2
Task 7744,Job 0,9,6,4,12,1,13,21,8,4,4,0,7744,7777,6
Task 7744,Job 1,14,4,4,6,0,18,20,2,4,3,1,7744,7777,17
Task 7745,Job 0,7,5,3,6,0,10,13,3,3,3,0,7745,7778,19
Task 7745,Job 1,12,8,1,10,0,13,22,9,1,4,2,7745,7778,7
Task 7746,Job 0,6,4,1,12,0,7,18,11,1,3,0,7746,7780,16
Task 7746,Job 1,11,10,4,9,0,15,20,5,4,3,0,7746,7780,6
Task 7747,Job 0,2,7,1,12,0,3,14,11,1,2,0,7747,7781,10
Task 7747,Job 1,7,8,4,9,0,11,16,5,4,1,2,7747,7781,5
Task 7748,Job 0,5,10,3,7,1,8,12,4,3,1,2,7748,7782,4
Task 7748,Job 1,10,4,1,10,0,11,20,9,1,1,1,7748,7782,14
Task 7749,Job 0,3,10,3,11,0,6,14,8,3,1,2,7749,7783,8
Task 7749,Job 1,8,5,4,9,1,12,17,5,4,4,0,7749,7783,16
Task 7750,Job 0,8,5,3,6,1,11,14,3,3,1,0,7750,7783,8
Task 7750,Job 1,13,6,3,9,0,16,22,6,3,3,0,7750,7783,13
Task 7751,Job 0,5,4,1,6,0,6,11,5,1,4,0,7751,7784,7
Task 7751,Job 1,10,10,2,6,0,12,16,4,2,2,2,7751,7784,7
Task 7752,Job 0,5,10,2,12,0,7,17,10,2,2,1,7752,7786,9
Task 7752,Job 1,10,6,2,10,1,12,20,8,2,4,2,7752,7786,19
Task 7753,Job 0,8,8,4,8,0,12,16,4,4,1,1,7753,7787,11
Task 7753,Job 1,13,4,4,10,0,17,23,6,4,3,2,7753,7787,7
Task 7754,Job 0,7,4,2,7,1,9,14,5,2,1,2,7754,7788,14
Task 7754,Job 1,12,10,1,11,1,13,23,10,1,1,0,7754,7788,3
Task 7755,Job 0,2,7,1,10,0,3,12,9,1,1,0,7755,7788,19
Task 7755,Job 1,7,7,1,9,1,8,16,8,1,4,2,7755,7788,15
Task 7756,Job 0,4,4,3,9,0,7,13,6,3,4,1,7756,7789,3
Task 7756,Job 1,9,9,1,6,1,10,15,5,1,2,0,7756,7789,10
Task 7757,Job 0,7,6,4,10,0,11,17,6,4,2,2,7757,7790,11
Task 7757,Job 1,12,7,4,7,0,16,19,3,4,3,0,7757,7790,20
Task 7758,Job 0,3,5,1,12,1,4,15,11,1,4,1,7758,7792,15
Task 7758,Job 1,8,6,3,10,0,11,18,7,3,4,2,7758,7792,13
Task 7759,Job 0,3,4,4,7,0,7,10,3,4,2,1,7759,7793,8
Task 7759,Job 1,8,5,2,10,1,10,18,8,2,4,1,7759,7793,6
Task 7760,Job 0,6,6,3,9,0,9,15,6,3,4,1,7760,7793,16
Task 7760,Job 1,11,7,4,12,0,15,23,8,4,2,1,7760,7793,17
Task 7761,Job 0,7,8,1,10,0,8,17,9,1,4,1,7761,7794,5
Task 7761,Job 1,12,6,4,6,1,16,18,2,4,4,0,7761,7794,7
Task 7762,Job 0,2,9,4,6,1,6,8,2,4,4,1,7762,7795,17
Task 7762,Job 1,7,10,3,8,1,10,15,5,3,2,1,7762,7795,14
Task 7763,Job 0,6,4,2,10,1,8,16,8,2,2,1,7763,7796,14
Task 7763,Job 1,11,10,3,10,1,14,21,7,3,4,0,7763,7796,16
Task 7764,Job 0,10,6,2,7,0,12,17,5,2,1,2,7764,7797,2
Task 7764,Job 1,15,8,1,7,0,16,22,6,1,3,2,7764,7797,14
Task 7765,Job 0,3,10,1,9,0,4,12,8,1,3,0,7765,7799,8
Task 7765,Job 1,8,10,1,6,0,9,14,5,1,2,1,7765,7799,3
Task 7766,Job 0,10,10,4,12,0,14,22,8,4,4,2,7766,7799,10
Task 7766,Job 1,15,9,1,12,0,16,27,11,1,3,0,7766,7799,5
Task 7767,Job 0,3,6,2,6,0,5,9,4,2,3,0,7767,7801,18
Task 7767,Job 1,8,8,2,6,0,10,14,4,2,4,1,7767,7801,3
Task 7768,Job 0,1,5,2,7,0,3,8,5,2,4,0,7768,7801,4
Task 7768,Job 1,6,5,1,12,0,7,18,11,1,4,0,7768,7801,20
Task 7769,Job 0,3,7,4,6,0,7,9,2,4,4,2,7769,7803,11
Task 7769,Job 1,8,6,4,9,1,12,17,5,4,3,0,7769,7803,2
Task 7770,Job 0,8,10,4,7,0,12,15,3,4,1,1,7770,7804,12
Task 7770,Job 1,13,5,2,11,0,15,24,9,2,2,0,7770,7804,8
Task 7771,Job 0,6,4,4,11,0,10,17,7,4,4,0,7771,7804,2
Task 7771,Job 1,11,7,2,11,1,13,22,9,2,1,0,7771,7804,2
Task 7772,Job 0,4,5,1,11,0,5,15,10,1,3,1,7772,7806,3
Task 7772,Job 1,9,7,4,9,0,13,18,5,4,3,0,7772,7806,15
Task 7773,Job 0,4,4,4,8,0,8,12,4,4,4,1,7773,7806,6
Task 7773,Job 1,9,4,3,10,0,12,19,7,3,3,0,7773,7806,8
Task 7774,Job 0,10,7,4,6,1,14,16,2,4,2,1,7774,7807,15
Task 7774,Job 1,15,7,3,9,0,18,24,6,3,4,2,7774,7807,17
Task 7775,Job 0,6,8,1,6,0,7,12,5,1,4,1,7775,7808,2
Task 7775,Job 1,11,9,2,7,1,13,18,5,2,3,1,7775,7808,20
Task 7776,Job 0,8,10,2,6,0,10,14,4,2,2,2,7776,7809,10
Task 7776,Job 1,13,6,2,9,0,15,22,7,2,1,0,7776,7809,16
Task 7777,Job 0,7,9,2,6,0,9,13,4,2,2,0,7777,7811,7
Task 7777,Job 1,12,7,4,12,0,16,24,8,4,1,1,7777,7811,20
Task 7778,Job 0,7,5,2,9,0,9,16,7,2,4,2,7778,7812,10
Task 7778,Job 1,12,9,1,7,1,13,19,6,1,1,0,7778,7812,14
Task 7779,Job 0,9,6,3,8,0,12,17,5,3,1,0,7779,7813,15
Task 7779,Job 1,14,7,4,8,0,18,22,4,4,2,2,7779,7813,8
Task 7780,Job 0,2,5,4,9,0,6,11,5,4,2,1,7780,7814,11
Task 7780,Job 1,7,7,2,11,0,9,18,9,2,4,0,7780,7814,9
Task 7781,Job 0,6,7,4,8,1,10,14,4,4,2,2,7781,7814,11
Task 7781,Job 1,11,10,1,8,1,12,19,7,1,4,1,7781,7814,8
Task 7782,Job 0,8,6,4,11,0,12,19,7,4,2,1,7782,7816,3
Task 7782,Job 1,13,6,3,9,0,16,22,6,3,1,2,7782,7816,19
Task 7783,Job 0,6,7,2,6,0,8,12,4,2,1,0,7783,7816,12
Task 7783,Job 1,11,6,2,7,0,13,18,5,2,1,0,7783,7816,12
Task 7784,Job 0,4,6,4,7,0,8,11,3,4,2,2,7784,7817,20
Task 7784,Job 1,9,5,1,10,0,10,19,9,1,4,2,7784,7817,11
Task 7785,Job 0,9,8,1,11,0,10,20,10,1,3,0,7785,7818,16
Task 7785,Job 1,14,7,4,8,0,18,22,4,4,2,0,7785,7818,2
Task 7786,Job 0,6,5,2,12,0,8,18,10,2,2,2,7786,7819,19
Task 7786,Job 1,11,6,3,12,1,14,23,9,3,2,0,7786,7819,15
Task 7787,Job 0,9,7,4,8,0,13,17,4,4,2,0,7787,7821,20
Task 7787,Job 1,14,6,2,9,0,16,23,7,2,2,1,7787,7821,15
Task 7788,Job 0,1,5,4,12,0,5,13,8,4,3,1,7788,7822,17
Task 7788,Job 1,6,4,2,9,0,8,15,7,2,4,0,7788,7822,19
Task 7789,Job 0,5,9,4,7,1,9,12,3,4,4,2,7789,7822,5
Task 7789,Job 1,10,9,1,10,0,11,20,9,1,4,1,7789,7822,4
Task 7790,Job 0,9,5,3,10,0,12,19,7,3,4,1,7790,7823,9
Task 7790,Job 1,14,6,4,6,1,18,20,2,4,2,2,7790,7823,10
Task 7791,Job 0,6,8,3,6,1,9,12,3,3,1,1,7791,7824,3
Task 7791,Job 1,11,5,2,12,0,13,23,10,2,2,0,7791,7824,12
Task 7792,Job 0,3,7,3,11,1,6,14,8,3,3,0,7792,7826,14
Task 7792,Job 1,8,7,1,9,0,9,17,8,1,3,0,7792,7826,2
Task 7793,Job 0,9,6,2,7,0,11,16,5,2,2,1,7793,7827,16
Task 7793,Job 1,14,9,4,11,0,18,25,7,4,4,1,7793,7827,14
Task 7794,Job 0,4,10,2,12,0,6,16,10,2,1,1,7794,7827,13
Task 7794,Job 1,9,9,2,12,1,11,21,10,2,2,1,7794,7827,11
Task 7795,Job 0,10,8,3,11,0,13,21,8,3,2,1,7795,7829,6
Task 7795,Job 1,15,4,1,6,1,16,21,5,1,1,0,7795,7829,19
Task 7796,Job 0,4,7,1,6,0,5,10,5,1,2,0,7796,7830,7
Task 7796,Job 1,9,4,3,7,0,12,16,4,3,1,2,7796,7830,17
Task 7797,Job 0,6,5,1,8,0,7,14,7,1,4,2,7797,7830,17
Task 7797,Job 1,11,9,2,8,1,13,19,6,2,1,1,7797,7830,6
Task 7798,Job 0,2,9,4,12,0,6,14,8,4,3,0,7798,7832,18
Task 7798,Job 1,7,5,4,8,1,11,15,4,4,1,1,7798,7832,6
Task 7799,Job 0,7,10,2,6,0,9,13,4,2,3,1,7799,7833,19
Task 7799,Job 1,12,8,3,9,0,15,21,6,3,3,0,7799,7833,3
Task 7800,Job 0,10,7,2,7,0,12,17,5,2,2,2,7800,7833,10
Task 7800,Job 1,15,5,3,7,0,18,22,4,3,2,1,7800,7833,5
Task 7801,Job 0,10,6,2,7,0,12,17,5,2,1,2,7801,7835,8
Task 7801,Job 1,15,8,3,10,0,18,25,7,3,3,2,7801,7835,15
Task 7802,Job 0,8,7,3,11,0,11,19,8,3,2,2,7802,7835,12
Task 7802,Job 1,13,9,2,8,0,15,21,6,2,4,2,7802,7835,2
Task 7803,Job 0,7,9,4,8,1,11,15,4,4,3,2,7803,7837,20
Task 7803,Job 1,12,5,4,11,0,16,23,7,4,4,0,7803,7837,7
Task 7804,Job 0,3,4,3,10,0,6,13,7,3,4,2,7804,7838,13
Task 7804,Job 1,8,5,2,6,1,10,14,4,2,2,2,7804,7838,5
Task 7805,Job 0,5,9,3,6,1,8,11,3,3,1,0,7805,7839,15
Task 7805,Job 1,10,6,4,8,0,14,18,4,4,3,1,7805,7839,14
Task 7806,Job 0,9,4,3,6,0,12,15,3,3,4,1,7806,7840,2
Task 7806,Job 1,14,7,2,9,0,16,23,7,2,3,2,7806,7840,3
Task 7807,Job 0,8,8,1,10,1,9,18,9,1,1,2,7807,7840,12
Task 7807,Job 1,13,8,4,8,0,17,21,4,4,1,0,7807,7840,2
Task 7808,Job 0,3,7,4,8,0,7,11,4,4,4,0,7808,7841,15
Task 7808,Job 1,8,4,3,8,1,11,16,5,3,3,1,7808,7841,19
Task 7809,Job 0,2,10,2,11,0,4,13,9,2,1,2,7809,7843,7
Task 7809,Job 1,7,10,3,11,0,10,18,8,3,3,1,7809,7843,13
Task 7810,Job 0,4,6,3,11,1,7,15,8,3,4,1,7810,7844,5
Task 7810,Job 1,9,10,4,9,0,13,18,5,4,1,2,7810,7844,16
Task 7811,Job 0,6,9,2,9,1,8,15,7,2,1,1,7811,7844,19
Task 7811,Job 1,11,6,4,6,0,15,17,2,4,4,0,7811,7844,18
Task 7812,Job 0,9,8,1,8,0,10,17,7,1,1,1,7812,7845,8
Task 7812,Job 1,14,9,1,6,1,15,20,5,1,1,1,7812,7845,17
Task 7813,Job 0,8,6,3,6,0,11,14,3,3,2,2,7813,7846,5
Task 7813,Job 1,13,10,1,12,0,14,25,11,1,4,0,7813,7846,6
Task 7814,Job 0,2,7,1,12,1,3,14,11,1,2,1,7814,7848,9
Task 7814,Job 1,7,6,3,8,0,10,15,5,3,3,2,7814,7848,2
Task 7815,Job 0,2,8,1,10,0,3,12,9,1,2,1,7815,7848,4
Task 7815,Job 1,7,6,2,8,0,9,15,6,2,1,2,7815,7848,10
Task 7816,Job 0,4,5,2,12,0,6,16,10,2,3,2,7816,7849,9
Task 7816,Job 1,9,4,1,8,0,10,17,7,1,4,1,7816,7849,18
Task 7817,Job 0,6,4,2,6,0,8,12,4,2,1,2,7817,7850,9
Task 7817,Job 1,11,6,4,12,0,15,23,8,4,4,1,7817,7850,10
Task 7818,Job 0,5,7,3,8,0,8,13,5,3,4,0,7818,7852,7
Task 7818,Job 1,10,9,1,9,0,11,19,8,1,3,0,7818,7852,3
Task 7819,Job 0,7,5,4,8,0,11,15,4,4,4,2,7819,7852,14
Task 7819,Job 1,12,7,1,12,0,13,24,11,1,1,1,7819,7852,5
Task 7820,Job 0,8,7,4,8,0,12,16,4,4,1,2,7820,7854,15
Task 7820,Job 1,13,10,4,11,0,17,24,7,4,3,2,7820,7854,15
Task 7821,Job 0,8,4,4,12,0,12,20,8,4,2,0,7821,7854,9
Task 7821,Job 1,13,5,4,10,0,17,23,6,4,2,2,7821,7854,17
Task 7822,Job 0,9,5,1,11,0,10,20,10,1,4,2,7822,7855,12
Task 7822,Job 1,14,6,3,7,0,17,21,4,3,4,0,7822,7855,20
Task 7823,Job 0,3,6,1,12,0,4,15,11,1,4,1,7823,7857,14
Task 7823,Job 1,8,4,4,9,0,12,17,5,4,1,1,7823,7857,9
Task 7824,Job 0,10,6,3,6,0,13,16,3,3,1,2,7824,7858,12
Task 7824,Job 1,15,9,1,10,0,16,25,9,1,4,1,7824,7858,10
Task 7825,Job 0,3,8,1,6,0,4,9,5,1,4,2,7825,7858,16
Task 7825,Job 1,8,8,3,10,0,11,18,7,3,1,2,7825,7858,6
Task 7826,Job 0,5,10,1,10,0,6,15,9,1,2,0,7826,7860,17
Task 7826,Job 1,10,5,3,6,0,13,16,3,3,1,0,7826,7860,16
Task 7827,Job 0,5,7,1,10,0,6,15,9,1,2,2,7827,7860,2
Task 7827,Job 1,10,6,4,9,0,14,19,5,4,2,2,7827,7860,19
Task 7828,Job 0,9,8,1,6,1,10,15,5,1,2,0,7828,7862,4
Task 7828,Job 1,14,8,4,11,0,18,25,7,4,1,0,7828,7862,14
Task 7829,Job 0,6,9,1,6,0,7,12,5,1,1,2,7829,7862,3
Task 7829,Job 1,11,7,4,10,1,15,21,6,4,2,2,7829,7862,9
Task 7830,Job 0,10,6,1,6,0,11,16,5,1,2,1,7830,7864,8
Task 7830,Job 1,15,6,1,9,0,16,24,8,1,3,0,7830,7864,10
Task 7831,Job 0,7,4,4,11,0,11,18,7,4,2,2,7831,7865,16
Task 7831,Job 1,12,8,3,6,0,15,18,3,3,2,1,7831,7865,15
Task 7832,Job 0,9,8,3,7,0,12,16,4,3,1,1,7832,7865,14
Task 7832,Job 1,14,5,4,11,0,18,25,7,4,3,2,7832,7865,15
Task 7833,Job 0,4,8,4,6,0,8,10,2,4,1,1,7833,7866,16
Task 7833,Job 1,9,5,3,6,0,12,15,3,3,3,1,7833,7866,6
Task 7834,Job 0,4,7,3,6,0,7,10,3,3,4,0,7834,7867,17
Task 7834,Job 1,9,6,1,12,0,10,21,11,1,1,1,7834,7867,14
Task 7835,Job 0,5,5,3,11,0,8,16,8,3,1,2,7835,7868,4
Task 7835,Job 1,10,5,4,10,0,14,20,6,4,2,1,7835,7868,2
Task 7836,Job 0,3,10,1,6,1,4,9,5,1,3,0,7836,7870,11
Task 7836,Job 1,8,7,2,12,0,10,20,10,2,1,0,7836,7870,20
Task 7837,Job 0,6,5,4,7,0,10,13,3,4,3,0,7837,7871,5
Task 7837,Job 1,11,4,2,11,1,13,22,9,2,4,1,7837,7871,17
Task 7838,Job 0,9,10,2,7,0,11,16,5,2,4,0,7838,7871,18
Task 7838,Job 1,14,8,4,8,0,18,22,4,4,3,0,7838,7871,6
Task 7839,Job 0,9,5,4,7,0,13,16,3,4,4,2,7839,7873,6
Task 7839,Job 1,14,10,3,9,0,17,23,6,3,4,1,7839,7873,19
Task 7840,Job 0,2,9,3,11,1,5,13,8,3,2,1,7840,7873,18
Task 7840,Job 1,7,7,1,10,1,8,17,9,1,1,0,7840,7873,19
Task 7841,Job 0,6,8,2,10,1,8,16,8,2,4,0,7841,7874,10
Task 7841,Job 1,11,4,4,8,0,15,19,4,4,3,1,7841,7874,20
Task 7842,Job 0,8,5,3,10,0,11,18,7,3,4,2,7842,7876,17
Task 7842,Job 1,13,10,4,10,0,17,23,6,4,2,2,7842,7876,10
Task 7843,Job 0,7,10,4,7,0,11,14,3,4,3,1,7843,7876,11
Task 7843,Job 1,12,9,4,10,0,16,22,6,4,3,1,7843,7876,19
Task 7844,Job 0,4,8,1,8,0,5,12,7,1,3,1,7844,7878,13
Task 7844,Job 1,9,6,4,11,0,13,20,7,4,1,2,7844,7878,10
Task 7845,Job 0,3,6,2,7,1,5,10,5,2,4,2,7845,7879,3
Task 7845,Job 1,8,9,1,6,0,9,14,5,1,4,2,7845,7879,13
Task 7846,Job 0,7,4,2,11,0,9,18,9,2,1,0,7846,7879,17
Task 7846,Job 1,12,4,3,9,1,15,21,6,3,2,2,7846,7879,10
Task 7847,Job 0,10,6,3,8,0,13,18,5,3,3,2,7847,7881,15
Task 7847,Job 1,15,8,1,12,1,16,27,11,1,3,1,7847,7881,20
Task 7848,Job 0,10,7,1,9,0,11,19,8,1,1,0,7848,7881,14
Task 7848,Job 1,15,4,3,7,0,18,22,4,3,3,1,7848,7881,6
Task 7849,Job 0,6,8,3,12,1,9,18,9,3,1,1,7849,7882,12
Task 7849,Job 1,11,9,3,7,0,14,18,4,3,3,1,7849,7882,10
Task 7850,Job 0,6,6,1,8,0,7,14,7,1,3,0,7850,7883,7
Task 7850,Job 1,11,5,4,6,0,15,17,2,4,2,2,7850,7883,9
Task 7851,Job 0,4,6,2,12,0,6,16,10,2,4,1,7851,7885,10
Task 7851,Job 1,9,9,2,8,0,11,17,6,2,2,2,7851,7885,16
Task 7852,Job 0,2,5,2,10,1,4,12,8,2,2,2,7852,7886,6
Task 7852,Job 1,7,7,3,12,1,10,19,9,3,4,2,7852,7886,6
Task 7853,Job 0,10,10,2,10,0,12,20,8,2,3,0,7853,7886,20
Task 7853,Job 1,15,8,4,9,0,19,24,5,4,4,0,7853,7886,15
Task 7854,Job 0,3,8,1,10,0,4,13,9,1,1,2,7854,7888,8
Task 7854,Job 1,8,6,4,12,0,12,20,8,4,3,0,7854,7888,12
Task 7855,Job 0,7,8,1,7,1,8,14,6,1,4,2,7855,7888,17
Task 7855,Job 1,12,4,1,6,0,13,18,5,1,3,0,7855,7888,19
Task 7856,Job 0,4,7,2,11,0,6,15,9,2,2,2,7856,7889,4
Task 7856,Job 1,9,9,3,9,1,12,18,6,3,1,0,7856,7889,4
Task 7857,Job 0,6,10,4,10,0,10,16,6,4,3,0,7857,7891,10
Task 7857,Job 1,11,8,2,6,1,13,17,4,2,4,0,7857,7891,13
Task 7858,Job 0,2,5,1,12,0,3,14,11,1,2,0,7858,7892,3
Task 7858,Job 1,7,9,4,6,0,11,13,2,4,4,2,7858,7892,14
Task 7859,Job 0,1,4,3,10,1,4,11,7,3,2,2,7859,7892,5
Task 7859,Job 1,6,9,2,11,0,8,17,9,2,1,1,7859,7892,13
Task 7860,Job 0,7,9,1,7,1,8,14,6,1,3,0,7860,7894,14
Task 7860,Job 1,12,9,4,9,1,16,21,5,4,4,0,7860,7894,3
Task 7861,Job 0,9,4,2,9,1,11,18,7,2,2,1,7861,7895,11
Task 7861,Job 1,14,5,1,7,0,15,21,6,1,1,1,7861,7895,11
Task 7862,Job 0,2,5,1,8,1,3,10,7,1,4,0,7862,7896,18
Task 7862,Job 1,7,7,3,9,0,10,16,6,3,2,2,7862,7896,17
Task 7863,Job 0,7,10,2,10,0,9,17,8,2,4,0,7863,7896,8
Task 7863,Job 1,12,5,2,9,0,14,21,7,2,1,2,7863,7896,14
Task 7864,Job 0,8,9,4,8,1,12,16,4,4,1,2,7864,7897,8
Task 7864,Job 1,13,4,1,9,0,14,22,8,1,3,1,7864,7897,19
Task 7865,Job 0,6,10,3,7,0,9,13,4,3,1,1,7865,7899,4
Task 7865,Job 1,11,4,4,9,0,15,20,5,4,4,2,7865,7899,18
Task 7866,Job 0,7,8,3,7,0,10,14,4,3,3,1,7866,7899,18
Task 7866,Job 1,12,6,2,7,0,14,19,5,2,3,2,7866,7899,10
Task 7867,Job 0,3,5,4,10,1,7,13,6,4,1,1,7867,7901,20
Task 7867,Job 1,8,5,1,9,0,9,17,8,1,4,0,7867,7901,7
Task 7868,Job 0,2,6,2,8,0,4,10,6,2,2,2,7868,7902,4
Task 7868,Job 1,7,9,4,6,1,11,13,2,4,1,1,7868,7902,6
Task 7869,Job 0,3,5,1,6,0,4,9,5,1,1,1,7869,7903,13
Task 7869,Job 1,8,9,3,11,0,11,19,8,3,1,0,7869,7903,3
Task 7870,Job 0,1,5,2,6,0,3,7,4,2,3,2,7870,7903,7
Task 7870,Job 1,6,9,4,9,0,10,15,5,4,3,0,7870,7903,6
Task 7871,Job 0,5,6,3,11,0,8,16,8,3,4,2,7871,7905,5
Task 7871,Job 1,10,10,3,6,0,13,16,3,3,4,2,7871,7905,8
Task 7872,Job 0,7,9,4,12,0,11,19,8,4,1,2,7872,7905,8
Task 7872,Job 1,12,9,2,8,0,14,20,6,2,3,0,7872,7905,6
Task 7873,Job 0,5,7,4,7,1,9,12,3,4,3,2,7873,7907,2
Task 7873,Job 1,10,10,1,12,0,11,22,11,1,3,0,7873,7907,3
Task 7874,Job 0,6,5,1,11,0,7,17,10,1,1,0,7874,7907,4
Task 7874,Job 1,11,4,1,12,0,12,23,11,1,2,2,7874,7907,4
Task 7875,Job 0,10,5,1,7,0,11,17,6,1,2,0,7875,7909,20
Task 7875,Job 1,15,8,4,7,1,19,22,3,4,1,2,7875,7909,17
Task 7876,Job 0,7,8,4,6,0,11,13,2,4,4,1,7876,7910,7
Task 7876,Job 1,12,7,4,8,0,16,20,4,4,3,0,7876,7910,14
Task 7877,Job 0,6,9,4,11,1,10,17,7,4,2,0,7877,7911,18
Task 7877,Job 1,11,5,2,10,0,13,21,8,2,1,0,7877,7911,6
Task 7878,Job 0,6,8,2,7,0,8,13,5,2,4,2,7878,7911,5
Task 7878,Job 1,11,5,3,8,1,14,19,5,3,4,0,7878,7911,3
Task 7879,Job 0,3,6,3,6,0,6,9,3,3,4,0,7879,7912,15
Task 7879,Job 1,8,5,2,10,1,10,18,8,2,1,2,7879,7912,8
Task 7880,Job 0,2,6,3,7,0,5,9,4,3,4,2,7880,7913,12
Task 7880,Job 1,7,7,2,11,0,9,18,9,2,2,2,7880,7913,16
Task 7881,Job 0,3,6,4,7,0,7,10,3,4,2,0,7881,7915,17
Task 7881,Job 1,8,10,2,9,0,10,17,7,2,2,1,7881,7915,3
Task 7882,Job 0,4,5,3,7,0,7,11,4,3,2,0,7882,7916,5
Task 7882,Job 1,9,8,2,11,0,11,20,9,2,1,0,7882,7916,12
Task 7883,Job 0,4,7,4,8,1,8,12,4,4,4,0,7883,7916,10
Task 7883,Job 1,9,4,4,7,0,13,16,3,4,1,2,7883,7916,15
Task 7884,Job 0,6,9,4,12,1,10,18,8,4,1,2,7884,7918,13
Task 7884,Job 1,11,4,4,10,0,15,21,6,4,3,2,7884,7918,4
Task 7885,Job 0,9,6,4,11,0,13,20,7,4,1,1,7885,7919,11
Task 7885,Job 1,14,4,1,8,0,15,22,7,1,3,1,7885,7919,6
Task 7886,Job 0,8,6,1,11,0,9,19,10,1,3,0,7886,7920,20
Task 7886,Job 1,13,6,2,7,1,15,20,5,2,1,0,7886,7920,8
Task 7887,Job 0,9,10,4,7,0,13,16,3,4,3,2,7887,7920,4
Task 7887,Job 1,14,7,1,12,0,15,26,11,1,2,1,7887,7920,18
Task 7888,Job 0,9,4,2,9,0,11,18,7,2,3,2,7888,7922,10
Task 7888,Job 1,14,10,2,8,1,16,22,6,2,1,1,7888,7922,3
Task 7889,Job 0,8,8,1,8,0,9,16,7,1,3,2,7889,7923,9
Task 7889,Job 1,13,4,3,12,0,16,25,9,3,3,0,7889,7923,14
Task 7890,Job 0,4,8,1,9,0,5,13,8,1,4,1,7890,7924,9
Task 7890,Job 1,9,6,1,6,0,10,15,5,1,3,2,7890,7924,10
Task 7891,Job 0,2,4,1,12,0,3,14,11,1,3,1,7891,7925,6
Task 7891,Job 1,7,5,4,6,0,11,13,2,4,2,2,7891,7925,17
Task 7892,Job 0,4,6,1,12,0,5,16,11,1,2,0,7892,7926,8
Task 7892,Job 1,9,5,1,8,0,10,17,7,1,4,2,7892,7926,5
Task 7893,Job 0,6,6,3,10,0,9,16,7,3,3,2,7893,7927,6
Task 7893,Job 1,11,10,2,7,0,13,18,5,2,3,2,7893,7927,13
Task 7894,Job 0,6,8,4,10,1,10,16,6,4,2,2,7894,7927,5
Task 7894,Job 1,11,8,3,7,0,14,18,4,3,2,0,7894,7927,9
Task 7895,Job 0,9,10,4,9,1,13,18,5,4,3,1,7895,7928,4
Task 7895,Job 1,14,5,4,10,0,18,24,6,4,2,0,7895,7928,20
Task 7896,Job 0,4,6,1,9,0,5,13,8,1,1,0,7896,7930,6
Task 7896,Job 1,9,10,3,8,0,12,17,5,3,1,1,7896,7930,15
Task 7897,Job 0,3,10,4,8,0,7,11,4,4,2,0,7897,7931,4
Task 7897,Job 1,8,7,3,10,0,11,18,7,3,1,0,7897,7931,11
Task 7898,Job 0,5,7,4,12,0,9,17,8,4,1,0,7898,7931,5
Task 7898,Job 1,10,9,3,12,0,13,22,9,3,4,1,7898,7931,4
Task 7899,Job 0,2,5,2,6,0,4,8,4,2,1,0,7899,7933,8
Task 7899,Job 1,7,8,2,6,0,9,13,4,2,3,2,7899,7933,7
Task 7900,Job 0,6,8,2,6,0,8,12,4,2,3,2,7900,7934,8
Task 7900,Job 1,11,5,4,6,0,15,17,2,4,2,2,7900,7934,15
Task 7901,Job 0,5,6,3,10,0,8,15,7,3,4,2,7901,7935,5
Task 7901,Job 1,10,6,4,9,0,14,19,5,4,4,1,7901,7935,5
Task 7902,Job 0,9,8,4,8,0,13,17,4,4,3,1,7902,7936,12
Task 7902,Job 1,14,8,4,9,0,18,23,5,4,1,0,7902,7936,8
Task 7903,Job 0,6,4,4,11,0,10,17,7,4,3,2,7903,7937,13
Task 7903,Job 1,11,5,2,7,0,13,18,5,2,4,0,7903,7937,13
Task 7904,Job 0,7,5,2,12,0,9,19,10,2,1,2,7904,7938,19
Task 7904,Job 1,12,8,3,6,0,15,18,3,3,1,1,7904,7938,12
Task 7905,Job 0,7,7,3,8,0,10,15,5,3,1,2,7905,7939,17
Task 7905,Job 1,12,7,1,12,1,13,24,11,1,4,1,7905,7939,20
Task 7906,Job 0,1,7,3,8,0,4,9,5,3,3,2,7906,7940,18
Task 7906,Job 1,6,8,2,7,0,8,13,5,2,3,2,7906,7940,7
Task 7907,Job 0,4,6,3,9,1,7,13,6,3,2,2,7907,7940,10
Task 7907,Job 1,9,9,4,12,0,13,21,8,4,3,0,7907,7940,16
Task 7908,Job 0,6,4,2,8,0,8,14,6,2,3,2,7908,7941,7
Task 7908,Job 1,11,4,1,12,0,12,23,11,1,4,2,7908,7941,19
Task 7909,Job 0,2,5,2,10,0,4,12,8,2,2,2,7909,7942,9
Task 7909,Job 1,7,10,4,7,0,11,14,3,4,4,1,7909,7942,17
Task 7910,Job 0,3,8,3,11,0,6,14,8,3,3,0,7910,7944,16
Task 7910,Job 1,8,7,1,8,0,9,16,7,1,1,0,7910,7944,10
Task 7911,Job 0,10,6,4,7,1,14,17,3,4,3,2,7911,7944,13
Task 7911,Job 1,15,8,1,8,1,16,23,7,1,1,1,7911,7944,17
Task 7912,Job 0,2,9,4,6,1,6,8,2,4,1,1,7912,7946,2
Task 7912,Job 1,7,4,4,10,0,11,17,6,4,1,1,7912,7946,18
Task 7913,Job 0,10,4,4,7,0,14,17,3,4,2,2,7913,7947,14
Task 7913,Job 1,15,6,3,11,0,18,26,8,3,4,2,7913,7947,15
Task 7914,Job 0,1,8,4,8,0,5,9,4,4,4,1,7914,7947,7
Task 7914,Job 1,6,4,4,10,0,10,16,6,4,2,0,7914,7947,18
Task 7915,Job 0,9,9,1,10,0,10,19,9,1,3,1,7915,7949,9
Task 7915,Job 1,14,9,2,12,0,16,26,10,2,3,1,7915,7949,2
Task 7916,Job 0,7,8,4,10,1,11,17,6,4,2,1,7916,7949,11
Task 7916,Job 1,12,6,1,6,1,13,18,5,1,2,0,7916,7949,13
Task 7917,Job 0,9,5,3,10,0,12,19,7,3,3,1,7917,7951,12
Task 7917,Job 1,14,6,1,11,0,15,25,10,1,3,0,7917,7951,16
Task 7918,Job 0,1,7,4,8,0,5,9,4,4,4,2,7918,7951,2
Task 7918,Job 1,6,10,1,7,0,7,13,6,1,3,2,7918,7951,15
Task 7919,Job 0,7,6,3,12,0,10,19,9,3,1,1,7919,7952,7
Task 7919,Job 1,12,5,2,7,0,14,19,5,2,2,2,7919,7952,10
Task 7920,Job 0,6,7,4,11,0,10,17,7,4,3,1,7920,7954,5
Task 7920,Job 1,11,8,1,12,0,12,23,11,1,1,0,7920,7954,9
Task 7921,Job 0,9,10,4,7,0,13,16,3,4,3,2,7921,7954,12
Task 7921,Job 1,14,6,1,8,0,15,22,7,1,1,0,7921,7954,6
Task 7922,Job 0,6,8,2,12,0,8,18,10,2,2,0,7922,7955,4
Task 7922,Job 1,11,5,4,8,0,15,19,4,4,4,0,7922,7955,16
Task 7923,Job 0,9,6,2,10,0,11,19,8,2,2,1,7923,7957,11
Task 7923,Job 1,14,8,3,6,1,17,20,3,3,3,2,7923,7957,10
Task 7924,Job 0,4,8,1,11,0,5,15,10,1,2,0,7924,7957,13
Task 7924,Job 1,9,7,1,12,0,10,21,11,1,1,2,7924,7957,20
Task 7925,Job 0,3,10,4,9,0,7,12,5,4,4,1,7925,7959,6
Task 7925,Job 1,8,7,4,11,0,12,19,7,4,4,0,7925,7959,8
Task 7926,Job 0,2,6,4,9,1,6,11,5,4,2,2,7926,7959,2
Task 7926,Job 1,7,4,3,7,0,10,14,4,3,4,1,7926,7959,10
Task 7927,Job 0,3,9,4,8,0,7,11,4,4,4,0,7927,7960,13
Task 7927,Job 1,8,5,3,11,1,11,19,8,3,4,2,7927,7960,2
Task 7928,Job 0,8,8,2,9,0,10,17,7,2,2,0,7928,7961,10
Task 7928,Job 1,13,5,4,7,0,17,20,3,4,4,0,7928,7961,17
Task 7929,Job 0,9,7,2,12,0,11,21,10,2,4,2,7929,7962,7
Task 7929,Job 1,14,7,3,7,0,17,21,4,3,3,2,7929,7962,2
Task 7930,Job 0,3,9,2,9,0,5,12,7,2,3,1,7930,7963,7
Task 7930,Job 1,8,8,1,9,0,9,17,8,1,1,1,7930,7963,7
Task 7931,Job 0,2,6,2,8,1,4,10,6,2,3,1,7931,7964,13
Task 7931,Job 1,7,5,2,10,1,9,17,8,2,3,0,7931,7964,15
Task 7932,Job 0,3,9,4,10,0,7,13,6,4,2,2,7932,7965,5
Task 7932,Job 1,8,8,4,11,0,12,19,7,4,2,0,7932,7965,18
Task 7933,Job 0,7,5,4,7,1,11,14,3,4,2,1,7933,7967,15
Task 7933,Job 1,12,9,2,7,0,14,19,5,2,2,0,7933,7967,13
Task 7934,Job 0,4,6,2,12,1,6,16,10,2,1,0,7934,7967,14
Task 7934,Job 1,9,10,1,7,1,10,16,6,1,2,2,7934,7967,19
Task 7935,Job 0,3,7,1,12,1,4,15,11,1,1,2,7935,7969,7
Task 7935,Job 1,8,7,4,9,0,12,17,5,4,1,1,7935,7969,13
Task 7936,Job 0,3,4,1,10,1,4,13,9,1,3,0,7936,7969,20
Task 7936,Job 1,8,9,3,7,0,11,15,4,3,4,2,7936,7969,5
Task 7937,Job 0,5,6,2,6,1,7,11,4,2,1,0,7937,7970,17
Task 7937,Job 1,10,9,3,12,0,13,22,9,3,1,0,7937,7970,19
Task 7938,Job 0,4,9,4,9,1,8,13,5,4,2,2,7938,7972,8
Task 7938,Job 1,9,7,1,6,0,10,15,5,1,2,0,7938,7972,15
Task 7939,Job 0,9,7,2,12,0,11,21,10,2,2,1,7939,7972,9
Task 7939,Job 1,14,6,3,9,0,17,23,6,3,2,0,7939,7972,16
Task 7940,Job 0,3,4,2,7,0,5,10,5,2,2,0,7940,7974,6
Task 7940,Job 1,8,4,1,6,0,9,14,5,1,3,1,7940,7974,10
Task 7941,Job 0,10,8,2,6,0,12,16,4,2,4,2,7941,7974,5
Task 7941,Job 1,15,6,3,8,1,18,23,5,3,3,1,7941,7974,9
Task 7942,Job 0,5,6,2,7,0,7,12,5,2,1,1,7942,7975,12
Task 7942,Job 1,10,6,4,9,0,14,19,5,4,1,1,7942,7975,18
Task 7943,Job 0,7,8,1,7,0,8,14,6,1,3,0,7943,7977,9
Task 7943,Job 1,12,6,1,12,0,13,24,11,1,3,1,7943,7977,19
Task 7944,Job 0,5,8,1,6,0,6,11,5,1,1,1,7944,7978,2
Task 7944,Job 1,10,7,3,12,0,13,22,9,3,4,1,7944,7978,14
Task 7945,Job 0,2,6,3,7,0,5,9,4,3,1,2,7945,7979,13
Task 7945,Job 1,7,4,3,7,0,10,14,4,3,3,1,7945,7979,7
Task 7946,Job 0,3,7,1,6,0,4,9,5,1,4,1,7946,7980,17
Task 7946,Job 1,8,7,2,7,0,10,15,5,2,2,2,7946,7980,17
Task 7947,Job 0,10,10,2,9,0,12,19,7,2,4,0,7947,7981,2
Task 7947,Job 1,15,6,2,7,0,17,22,5,2,4,0,7947,7981,2
Task 7948,Job 0,6,5,4,8,0,10,14,4,4,2,2,7948,7981,10
Task 7948,Job 1,11,4,4,8,0,15,19,4,4,1,2,7948,7981,17
Task 7949,Job 0,1,4,4,9,1,5,10,5,4,3,0,7949,7982,9
Task 7949,Job 1,6,4,1,6,0,7,12,5,1,2,2,7949,7982,17
Task 7950,Job 0,1,8,3,7,0,4,8,4,3,1,2,7950,7983,9
Task 7950,Job 1,6,9,2,6,0,8,12,4,2,2,1,7950,7983,5
Task 7951,Job 0,7,9,2,8,1,9,15,6,2,2,1,7951,7985,16
Task 7951,Job 1,12,9,2,12,0,14,24,10,2,2,2,7951,7985,18
Task 7952,Job 0,2,5,3,7,1,5,9,4,3,1,2,7952,7986,17
Task 7952,Job 1,7,6,2,10,0,9,17,8,2,3,2,7952,7986,11
Task 7953,Job 0,7,7,3,11,0,10,18,8,3,1,1,7953,7986,2
Task 7953,Job 1,12,6,4,9,0,16,21,5,4,3,2,7953,7986,11
Task 7954,Job 0,1,7,2,10,1,3,11,8,2,3,2,7954,7987,20
Task 7954,Job 1,6,7,3,11,0,9,17,8,3,2,0,7954,7987,11
Task 7955,Job 0,1,9,4,7,1,5,8,3,4,4,1,7955,7989,16
Task 7955,Job 1,6,9,3,11,0,9,17,8,3,4,1,7955,7989,4
Task 7956,Job 0,4,4,3,8,0,7,12,5,3,2,0,7956,7989,17
Task 7956,Job 1,9,5,1,7,0,10,16,6,1,1,1,7956,7989,20
Task 7957,Job 0,2,10,1,8,0,3,10,7,1,3,0,7957,7990,12
Task 7957,Job 1,7,5,1,9,0,8,16,8,1,2,1,7957,7990,2
Task 7958,Job 0,5,5,4,8,0,9,13,4,4,3,0,7958,7992,4
Task 7958,Job 1,10,5,1,11,1,11,21,10,1,4,2,7958,7992,9
Task 7959,Job 0,3,10,4,7,1,7,10,3,4,2,1,7959,7992,15
Task 7959,Job 1,8,4,3,12,0,11,20,9,3,2,1,7959,7992,9
Task 7960,Job 0,8,7,2,10,1,10,18,8,2,2,2,7960,7994,15
Task 7960,Job 1,13,9,3,7,0,16,20,4,3,2,1,7960,7994,14
Task 7961,Job 0,2,5,4,9,0,6,11,5,4,2,2,7961,7995,9
Task 7961,Job 1,7,4,4,11,0,11,18,7,4,2,0,7961,7995,2
Task 7962,Job 0,2,8,3,8,0,5,10,5,3,4,2,7962,7996,7
Task 7962,Job 1,7,5,1,7,1,8,14,6,1,3,1,7962,7996,2
Task 7963,Job 0,5,10,2,12,1,7,17,10,2,3,2,7963,7996,13
Task 7963,Job 1,10,7,1,6,0,11,16,5,1,4,0,7963,7996,5
Task 7964,Job 0,4,4,4,6,1,8,10,2,4,3,2,7964,7997,14
Task 7964,Job 1,9,10,3,8,0,12,17,5,3,1,0,7964,7997,14
Task 7965,Job 0,8,4,2,11,0,10,19,9,2,4,0,7965,7998,18
Task 7965,Job 1,13,10,2,8,0,15,21,6,2,1,2,7965,7998,8
Task 7966,Job 0,6,7,1,10,0,7,16,9,1,4,1,7966,8000,16
Task 7966,Job 1,11,8,1,12,0,12,23,11,1,1,2,7966,8000,6
Task 7967,Job 0,3,10,2,12,0,5,15,10,2,1,2,7967,8000,15
Task 7967,Job 1,8,6,4,6,1,12,14,2,4,3,1,7967,8000,15
Task 7968,Job 0,2,6,2,11,1,4,13,9,2,4,1,7968,8002,9
Task 7968,Job 1,7,5,3,7,0,10,14,4,3,4,0,7968,8002,10
Task 7969,Job 0,7,5,3,10,0,10,17,7,3,4,0,7969,8002,10
Task 7969,Job 1,12,6,1,10,1,13,22,9,1,4,1,7969,8002,13
Task 7970,Job 0,5,6,1,11,0,6,16,10,1,4,2,7970,8004,17
Task 7970,Job 1,10,5,2,12,0,12,22,10,2,2,2,7970,8004,20
Task 7971,Job 0,5,5,4,11,0,9,16,7,4,1,0,7971,8005,4
Task 7971,Job 1,10,6,2,9,1,12,19,7,2,3,2,7971,8005,9
Task 7972,Job 0,9,6,3,12,0,12,21,9,3,4,0,7972,8006,6
Task 7972,Job 1,14,10,2,6,0,16,20,4,2,3,0,7972,8006,8
Task 7973,Job 0,5,7,4,11,0,9,16,7,4,4,0,7973,8007,2
Task 7973,Job 1,10,6,1,7,0,11,17,6,1,2,0,7973,8007,7
Task 7974,Job 0,3,6,3,7,0,6,10,4,3,4,2,7974,8007,5
Task 7974,Job 1,8,9,3,7,1,11,15,4,3,1,0,7974,8007,6
Task 7975,Job 0,2,10,2,9,1,4,11,7,2,4,2,7975,8008,16
Task 7975,Job 1,7,9,4,7,0,11,14,3,4,3,1,7975,8008,6
Task 7976,Job 0,9,7,4,9,0,13,18,5,4,3,0,7976,8010,11
Task 7976,Job 1,14,4,1,6,0,15,20,5,1,1,2,7976,8010,15
Task 7977,Job 0,2,8,3,9,0,5,11,6,3,1,2,7977,8010,9
Task 7977,Job 1,7,10,3,11,0,10,18,8,3,2,2,7977,8010,8
Task 7978,Job 0,2,7,3,11,0,5,13,8,3,3,0,7978,8011,4
Task 7978,Job 1,7,8,3,6,0,10,13,3,3,3,2,7978,8011,20
Task 7979,Job 0,10,7,3,8,1,13,18,5,3,4,0,7979,8012,10
Task 7979,Job 1,15,8,2,12,1,17,27,10,2,2,2,7979,8012,8
Task 7980,Job 0,9,8,2,6,0,11,15,4,2,4,0,7980,8014,13
Task 7980,Job 1,14,8,2,12,0,16,26,10,2,4,2,7980,8014,19
Task 7981,Job 0,1,7,2,6,0,3,7,4,2,4,1,7981,8015,11
Task 7981,Job 1,6,8,4,6,0,10,12,2,4,3,2,7981,8015,4
Task 7982,Job 0,3,5,3,11,0,6,14,8,3,2,0,7982,8016,12
Task 7982,Job 1,8,8,4,8,0,12,16,4,4,2,2,7982,8016,7
Task 7983,Job 0,2,5,2,7,0,4,9,5,2,4,2,7983,8017,9
Task 7983,Job 1,7,9,1,11,0,8,18,10,1,3,0,7983,8017,8
Task 7984,Job 0,3,8,4,8,1,7,11,4,4,1,0,7984,8017,20
Task 7984,Job 1,8,5,1,8,0,9,16,7,1,2,1,7984,8017,11
Task 7985,Job 0,5,5,4,8,1,9,13,4,4,1,1,7985,8019,4
Task 7985,Job 1,10,10,1,12,0,11,22,11,1,3,2,7985,8019,11
Task 7986,Job 0,5,10,1,8,0,6,13,7,1,2,1,7986,8019,4
Task 7986,Job 1,10,6,4,11,0,14,21,7,4,2,2,7986,8019,3
Task 7987,Job 0,4,9,2,6,0,6,10,4,2,1,0,7987,8021,9
Task 7987,Job 1,9,5,4,7,0,13,16,3,4,4,1,7987,8021,2
Task 7988,Job 0,2,7,4,9,0,6,11,5,4,3,1,7988,8021,6
Task 7988,Job 1,7,6,4,10,0,11,17,6,4,2,1,7988,8021,2
Task 7989,Job 0,1,5,3,9,0,4,10,6,3,1,2,7989,8023,8
Task 7989,Job 1,6,8,2,6,0,8,12,4,2,2,2,7989,8023,3
Task 7990,Job 0,5,5,2,8,0,7,13,6,2,4,1,7990,8023,2
Task 7990,Job 1,10,4,1,8,1,11,18,7,1,2,0,7990,8023,14
Task 7991,Job 0,8,4,4,12,0,12,20,8,4,2,2,7991,8024,11
Task 7991,Job 1,13,6,1,9,1,14,22,8,1,3,2,7991,8024,19
Task 7992,Job 0,9,8,2,7,0,11,16,5,2,1,2,7992,8025,2
Task 7992,Job 1,14,5,1,8,0,15,22,7,1,1,1,7992,8025,14
Task 7993,Job 0,9,10,2,6,0,11,15,4,2,2,2,7993,8026,5
Task 7993,Job 1,14,4,1,11,0,15,25,10,1,1,0,7993,8026,9
Task 7994,Job 0,9,6,2,9,1,11,18,7,2,3,0,7994,8027,14
Task 7994,Job 1,14,5,3,6,1,17,20,3,3,2,1,7994,8027,8
Task 7995,Job 0,5,5,2,9,0,7,14,7,2,4,2,7995,8028,7
Task 7995,Job 1,10,10,2,6,1,12,16,4,2,3,2,7995,8028,2
Task 7996,Job 0,6,7,1,7,1,7,13,6,1,4,0,7996,8029,10
Task 7996,Job 1,11,6,3,6,0,14,17,3,3,4,0,7996,8029,11
Task 7997,Job 0,5,5,4,6,1,9,11,2,4,2,0,7997,8030,19
Task 7997,Job 1,10,10,4,7,0,14,17,3,4,1,0,7997,8030,7
Task 7998,Job 0,10,7,2,11,0,12,21,9,2,3,1,7998,8032,8
Task 7998,Job 1,15,10,4,9,0,19,24,5,4,2,0,7998,8032,16
Task 7999,Job 0,4,10,1,11,1,5,15,10,1,1,1,7999,8033,4
Task 7999,Job 1,9,6,1,12,1,10,21,11,1,4,0,7999,8033,7
Task 8000,Job 0,7,10,3,8,0,10,15,5,3,3,1,8000,8033,5
Task 8000,Job 1,12,6,4,10,0,16,22,6,4,2,0,8000,8033,17
Task 8001,Job 0,2,7,3,9,0,5,11,6,3,1,2,8001,8034,17
Task 8001,Job 1,7,5,2,10,0,9,17,8,2,2,2,8001,8034,7
Task 8002,Job 0,4,4,4,10,0,8,14,6,4,3,1,8002,8036,14
Task 8002,Job 1,9,9,4,6,1,13,15,2,4,4,2,8002,8036,17
Task 8003,Job 0,5,5,3,9,0,8,14,6,3,2,2,8003,8036,11
Task 8003,Job 1,10,4,2,10,0,12,20,8,2,1,1,8003,8036,9
Task 8004,Job 0,3,7,3,7,1,6,10,4,3,1,1,8004,8037,14
Task 8004,Job 1,8,7,4,6,0,12,14,2,4,2,2,8004,8037,11
Task 8005,Job 0,6,4,3,11,0,9,17,8,3,3,2,8005,8038,17
Task 8005,Job 1,11,9,3,6,0,14,17,3,3,3,2,8005,8038,12
Task 8006,Job 0,4,4,4,8,0,8,12,4,4,1,1,8006,8040,10
Task 8006,Job 1,9,6,2,10,1,11,19,8,2,3,0,8006,8040,8
Task 8007,Job 0,2,5,2,10,0,4,12,8,2,1,2,8007,8040,4
Task 8007,Job 1,7,8,2,7,0,9,14,5,2,1,2,8007,8040,19
Task 8008,Job 0,6,8,4,12,1,10,18,8,4,1,2,8008,8041,11
Task 8008,Job 1,11,6,3,12,0,14,23,9,3,1,0,8008,8041,18
Task 8009,Job 0,6,5,1,8,0,7,14,7,1,1,0,8009,8043,15
Task 8009,Job 1,11,7,4,9,0,15,20,5,4,2,0,8009,8043,8
Task 8010,Job 0,5,4,1,9,0,6,14,8,1,1,0,8010,8044,2
Task 8010,Job 1,10,4,3,7,1,13,17,4,3,1,1,8010,8044,15
Task 8011,Job 0,6,8,3,9,1,9,15,6,3,1,1,8011,8044,2
Task 8011,Job 1,11,5,4,9,0,15,20,5,4,3,2,8011,8044,11
Task 8012,Job 0,3,10,4,6,0,7,9,2,4,3,1,8012,8045,16
Task 8012,Job 1,8,6,4,9,0,12,17,5,4,4,0,8012,8045,13
Task 8013,Job 0,10,10,1,9,0,11,19,8,1,2,0,8013,8047,8
Task 8013,Job 1,15,6,4,8,0,19,23,4,4,1,2,8013,8047,10
Task 8014,Job 0,9,4,4,9,1,13,18,5,4,3,2,8014,8047,17
Task 8014,Job 1,14,9,3,9,0,17,23,6,3,4,0,8014,8047,15
Task 8015,Job 0,4,7,1,11,1,5,15,10,1,2,0,8015,8048,4
Task 8015,Job 1,9,7,4,12,0,13,21,8,4,2,2,8015,8048,13
Task 8016,Job 0,10,5,4,10,0,14,20,6,4,2,1,8016,8049,14
Task 8016,Job 1,15,4,1,9,1,16,24,8,1,1,2,8016,8049,7
Task 8017,Job 0,7,8,2,9,0,9,16,7,2,2,2,8017,8051,20
Task 8017,Job 1,12,5,2,6,0,14,18,4,2,3,0,8017,8051,12
Task 8018,Job 0,3,9,1,9,1,4,12,8,1,1,2,8018,8051,18
Task 8018,Job 1,8,4,1,6,0,9,14,5,1,2,0,8018,8051,4
Task 8019,Job 0,2,8,4,9,0,6,11,5,4,1,2,8019,8053,11
Task 8019,Job 1,7,7,3,8,0,10,15,5,3,4,0,8019,8053,9
Task 8020,Job 0,5,6,3,10,1,8,15,7,3,4,0,8020,8053,20
Task 8020,Job 1,10,6,4,12,0,14,22,8,4,4,2,8020,8053,15
Task 8021,Job 0,10,6,3,11,0,13,21,8,3,2,0,8021,8055,3
Task 8021,Job 1,15,5,2,12,0,17,27,10,2,3,0,8021,8055,20
Task 8022,Job 0,6,8,1,10,1,7,16,9,1,4,1,8022,8055,4
Task 8022,Job 1,11,7,4,8,0,15,19,4,4,2,1,8022,8055,5
Task 8023,Job 0,5,8,1,8,1,6,13,7,1,2,1,8023,8057,6
Task 8023,Job 1,10,6,1,11,0,11,21,10,1,4,1,8023,8057,9
Task 8024,Job 0,2,9,2,8,0,4,10,6,2,3,1,8024,8058,10
Task 8024,Job 1,7,7,3,8,0,10,15,5,3,4,0,8024,8058,20
Task 8025,Job 0,4,6,1,12,1,5,16,11,1,1,0,8025,8058,12
Task 8025,Job 1,9,7,4,11,1,13,20,7,4,1,1,8025,8058,15
Task 8026,Job 0,9,8,2,10,0,11,19,8,2,1,1,8026,8059,10
Task 8026,Job 1,14,9,1,12,0,15,26,11,1,3,1,8026,8059,14
Task 8027,Job 0,9,8,3,9,0,12,18,6,3,1,0,8027,8061,7
Task 8027,Job 1,14,5,2,11,0,16,25,9,2,2,1,8027,8061,11
Task 8028,Job 0,4,9,4,8,1,8,12,4,4,2,0,8028,8061,3
Task 8028,Job 1,9,7,1,10,0,10,19,9,1,1,2,8028,8061,19
Task 8029,Job 0,1,8,1,7,1,2,8,6,1,3,0,8029,8062,2
Task 8029,Job 1,6,7,3,12,0,9,18,9,3,1,1,8029,8062,7
Task 8030,Job 0,10,5,4,9,0,14,19,5,4,3,2,8030,8063,18
Task 8030,Job 1,15,10,3,6,1,18,21,3,3,2,2,8030,8063,15
Task 8031,Job 0,7,10,2,11,0,9,18,9,2,1,2,8031,8065,6
Task 8031,Job 1,12,6,2,8,0,14,20,6,2,1,2,8031,8065,2
Task 8032,Job 0,7,8,2,12,0,9,19,10,2,3,0,8032,8066,17
Task 8032,Job 1,12,8,3,9,1,15,21,6,3,1,2,8032,8066,6
Task 8033,Job 0,8,6,2,7,0,10,15,5,2,2,0,8033,8066,6
Task 8033,Job 1,13,10,2,6,0,15,19,4,2,1,0,8033,8066,3
Task 8034,Job 0,3,4,4,7,0,7,10,3,4,3,2,8034,8067,8
Task 8034,Job 1,8,5,2,9,0,10,17,7,2,1,2,8034,8067,8
Task 8035,Job 0,6,9,1,12,0,7,18,11,1,2,0,8035,8069,20
Task 8035,Job 1,11,4,3,7,0,14,18,4,3,1,0,8035,8069,17
Task 8036,Job 0,7,6,2,6,0,9,13,4,2,2,1,8036,8070,19
Task 8036,Job 1,12,5,2,11,0,14,23,9,2,4,0,8036,8070,10
Task 8037,Job 0,4,10,4,11,1,8,15,7,4,3,1,8037,8070,19
Task 8037,Job 1,9,8,3,11,0,12,20,8,3,2,1,8037,8070,12
Task 8038,Job 0,7,7,3,7,0,10,14,4,3,4,0,8038,8072,12
Task 8038,Job 1,12,10,1,12,0,13,24,11,1,4,0,8038,8072,5
Task 8039,Job 0,7,4,2,6,0,9,13,4,2,1,2,8039,8072,2
Task 8039,Job 1,12,9,4,7,0,16,19,3,4,2,1,8039,8072,11
Task 8040,Job 0,7,5,1,8,0,8,15,7,1,4,1,8040,8074,6
Task 8040,Job 1,12,5,3,6,0,15,18,3,3,1,2,8040,8074,16
Task 8041,Job 0,4,10,2,11,0,6,15,9,2,4,1,8041,8074,9
Task 8041,Job 1,9,8,4,7,0,13,16,3,4,4,2,8041,8074,5
Task 8042,Job 0,2,4,3,12,0,5,14,9,3,1,1,8042,8076,4
Task 8042,Job 1,7,5,4,12,1,11,19,8,4,1,2,8042,8076,19
Task 8043,Job 0,9,8,2,8,0,11,17,6,2,3,1,8043,8077,16
Task 8043,Job 1,14,6,2,7,0,16,21,5,2,3,2,8043,8077,19
Task 8044,Job 0,8,4,3,8,0,11,16,5,3,3,0,8044,8077,20
Task 8044,Job 1,13,6,2,6,0,15,19,4,2,3,2,8044,8077,20
Task 8045,Job 0,6,4,2,12,1,8,18,10,2,1,1,8045,8078,17
Task 8045,Job 1,11,5,4,6,0,15,17,2,4,2,0,8045,8078,5
Task 8046,Job 0,10,5,1,11,0,11,21,10,1,4,1,8046,8079,5
Task 8046,Job 1,15,6,1,7,1,16,22,6,1,1,1,8046,8079,2
Task 8047,Job 0,4,10,2,12,0,6,16,10,2,2,2,8047,8080,18
Task 8047,Job 1,9,4,3,12,0,12,21,9,3,2,2,8047,8080,6
Task 8048,Job 0,3,6,4,6,1,7,9,2,4,3,0,8048,8081,14
Task 8048,Job 1,8,4,3,8,0,11,16,5,3,2,2,8048,8081,11
Task 8049,Job 0,6,6,2,10,0,8,16,8,2,4,0,8049,8083,8
Task 8049,Job 1,11,7,4,8,0,15,19,4,4,4,0,8049,8083,6
Task 8050,Job 0,1,8,1,9,0,2,10,8,1,1,1,8050,8084,10
Task 8050,Job 1,6,6,2,9,0,8,15,7,2,1,0,8050,8084,2
Task 8051,Job 0,6,10,4,10,0,10,16,6,4,2,2,8051,8085,19
Task 8051,Job 1,11,9,1,6,0,12,17,5,1,4,0,8051,8085,18
Task 8052,Job 0,10,9,2,7,1,12,17,5,2,4,1,8052,8086,12
Task 8052,Job 1,15,6,4,11,0,19,26,7,4,4,1,8052,8086,16
Task 8053,Job 0,9,7,3,11,0,12,20,8,3,2,0,8053,8087,6
Task 8053,Job 1,14,6,3,7,0,17,21,4,3,4,1,8053,8087,13
Task 8054,Job 0,2,7,2,10,1,4,12,8,2,1,0,8054,8088,10
Task 8054,Job 1,7,4,3,11,1,10,18,8,3,1,2,8054,8088,8
Task 8055,Job 0,8,4,4,12,0,12,20,8,4,2,1,8055,8089,12
Task 8055,Job 1,13,10,3,7,0,16,20,4,3,2,0,8055,8089,17
Task 8056,Job 0,3,10,2,10,0,5,13,8,2,4,0,8056,8090,20
Task 8056,Job 1,8,10,1,10,0,9,18,9,1,1,1,8056,8090,8
Task 8057,Job 0,8,5,4,11,1,12,19,7,4,2,0,8057,8090,5
Task 8057,Job 1,13,7,3,12,1,16,25,9,3,1,0,8057,8090,13
Task 8058,Job 0,4,10,4,10,1,8,14,6,4,3,0,8058,8092,17
Task 8058,Job 1,9,9,4,12,0,13,21,8,4,1,2,8058,8092,17
Task 8059,Job 0,3,5,3,8,0,6,11,5,3,3,0,8059,8092,5
Task 8059,Job 1,8,6,1,9,0,9,17,8,1,2,1,8059,8092,15
Task 8060,Job 0,10,6,2,8,0,12,18,6,2,3,1,8060,8094,8
Task 8060,Job 1,15,10,1,11,0,16,26,10,1,4,2,8060,8094,9
Task 8061,Job 0,8,8,1,7,1,9,15,6,1,3,0,8061,8094,19
Task 8061,Job 1,13,6,3,10,0,16,23,7,3,1,1,8061,8094,14
Task 8062,Job 0,9,10,1,9,0,10,18,8,1,3,1,8062,8096,20
Task 8062,Job 1,14,7,4,7,0,18,21,3,4,1,0,8062,8096,3
Task 8063,Job 0,10,8,2,11,0,12,21,9,2,2,2,8063,8096,19
Task 8063,Job 1,15,8,2,9,0,17,24,7,2,4,2,8063,8096,9
Task 8064,Job 0,2,6,3,6,0,5,8,3,3,4,2,8064,8097,9
Task 8064,Job 1,7,4,1,8,0,8,15,7,1,1,1,8064,8097,19
Task 8065,Job 0,3,8,3,8,1,6,11,5,3,3,2,8065,8098,11
Task 8065,Job 1,8,5,2,11,0,10,19,9,2,1,0,8065,8098,5
Task 8066,Job 0,8,7,4,8,0,12,16,4,4,1,0,8066,8100,16
Task 8066,Job 1,13,5,1,8,0,14,21,7,1,1,2,8066,8100,4
Task 8067,Job 0,6,10,2,6,1,8,12,4,2,2,0,8067,8100,17
Task 8067,Job 1,11,4,1,10,0,12,21,9,1,4,2,8067,8100,10
Task 8068,Job 0,1,9,3,8,0,4,9,5,3,4,1,8068,8101,15
Task 8068,Job 1,6,5,4,6,1,10,12,2,4,1,1,8068,8101,11
Task 8069,Job 0,6,7,4,8,0,10,14,4,4,2,1,8069,8103,7
Task 8069,Job 1,11,8,2,6,0,13,17,4,2,3,1,8069,8103,7
Task 8070,Job 0,8,8,2,7,0,10,15,5,2,4,2,8070,8103,14
Task 8070,Job 1,13,7,3,8,0,16,21,5,3,4,0,8070,8103,19
Task 8071,Job 0,1,9,4,7,0,5,8,3,4,4,0,8071,8105,2
Task 8071,Job 1,6,5,3,8,0,9,14,5,3,3,1,8071,8105,7
Task 8072,Job 0,9,7,4,7,1,13,16,3,4,4,1,8072,8106,11
Task 8072,Job 1,14,4,2,12,0,16,26,10,2,4,1,8072,8106,13
Task 8073,Job 0,8,8,2,9,0,10,17,7,2,3,2,8073,8107,20
Task 8073,Job 1,13,10,4,9,0,17,22,5,4,3,0,8073,8107,6
Task 8074,Job 0,5,7,2,9,0,7,14,7,2,4,1,8074,8108,18
Task 8074,Job 1,10,9,2,11,0,12,21,9,2,2,0,8074,8108,10
Task 8075,Job 0,1,4,2,8,1,3,9,6,2,1,2,8075,8108,15
Task 8075,Job 1,6,10,1,6,1,7,12,5,1,3,2,8075,8108,17
Task 8076,Job 0,2,8,2,10,0,4,12,8,2,1,0,8076,8110,16
Task 8076,Job 1,7,5,4,12,0,11,19,8,4,2,1,8076,8110,2
Task 8077,Job 0,2,6,3,6,1,5,8,3,3,4,2,8077,8110,15
Task 8077,Job 1,7,9,3,9,0,10,16,6,3,4,1,8077,8110,14
Task 8078,Job 0,5,8,2,11,0,7,16,9,2,4,1,8078,8112,9
Task 8078,Job 1,10,9,4,12,0,14,22,8,4,4,2,8078,8112,9
Task 8079,Job 0,4,5,1,10,0,5,14,9,1,4,0,8079,8112,8
Task 8079,Job 1,9,4,3,10,0,12,19,7,3,2,2,8079,8112,3
Task 8080,Job 0,10,8,4,12,0,14,22,8,4,2,1,8080,8113,14
Task 8080,Job 1,15,5,2,8,0,17,23,6,2,4,1,8080,8113,14
Task 8081,Job 0,5,4,4,8,1,9,13,4,4,3,2,8081,8114,8
Task 8081,Job 1,10,5,2,7,0,12,17,5,2,3,0,8081,8114,2
Task 8082,Job 0,9,5,2,10,0,11,19,8,2,4,0,8082,8116,5
Task 8082,Job 1,14,5,4,6,1,18,20,2,4,4,1,8082,8116,4
Task 8083,Job 0,3,9,2,9,1,5,12,7,2,4,2,8083,8116,13
Task 8083,Job 1,8,9,4,7,1,12,15,3,4,1,2,8083,8116,20
Task 8084,Job 0,2,7,1,9,1,3,11,8,1,4,0,8084,8117,6
Task 8084,Job 1,7,4,2,12,0,9,19,10,2,3,1,8084,8117,15
Task 8085,Job 0,2,9,1,7,0,3,9,6,1,3,0,8085,8118,13
Task 8085,Job 1,7,5,2,6,0,9,13,4,2,2,0,8085,8118,12
Task 8086,Job 0,2,5,2,8,0,4,10,6,2,1,0,8086,8119,17
Task 8086,Job 1,7,5,2,10,0,9,17,8,2,3,0,8086,8119,12
Task 8087,Job 0,7,10,2,10,0,9,17,8,2,4,0,8087,8120,9
Task 8087,Job 1,12,6,2,6,0,14,18,4,2,2,2,8087,8120,12
Task 8088,Job 0,9,4,2,8,0,11,17,6,2,2,0,8088,8121,5
Task 8088,Job 1,14,4,4,8,0,18,22,4,4,1,0,8088,8121,14
Task 8089,Job 0,1,8,2,11,0,3,12,9,2,3,0,8089,8122,20
Task 8089,Job 1,6,10,1,10,0,7,16,9,1,2,1,8089,8122,5
Task 8090,Job 0,4,4,2,9,0,6,13,7,2,1,0,8090,8124,10
Task 8090,Job 1,9,10,1,9,0,10,18,8,1,2,2,8090,8124,16
Task 8091,Job 0,5,6,3,6,0,8,11,3,3,3,0,8091,8124,18
Task 8091,Job 1,10,7,4,10,0,14,20,6,4,1,1,8091,8124,5
Task 8092,Job 0,4,8,4,6,0,8,10,2,4,4,0,8092,8125,2
Task 8092,Job 1,9,5,2,7,0,11,16,5,2,1,0,8092,8125,14
Task 8093,Job 0,10,6,2,10,0,12,20,8,2,4,0,8093,8126,13
Task 8093,Job 1,15,5,4,6,0,19,21,2,4,3,2,8093,8126,5
Task 8094,Job 0,6,5,4,8,1,10,14,4,4,2,2,8094,8128,9
Task 8094,Job 1,11,6,4,11,1,15,22,7,4,3,1,8094,8128,19
Task 8095,Job 0,9,5,2,7,1,11,16,5,2,4,1,8095,8129,18
Task 8095,Job 1,14,9,2,11,1,16,25,9,2,3,0,8095,8129,12
Task 8096,Job 0,6,5,2,9,0,8,15,7,2,1,1,8096,8130,8
Task 8096,Job 1,11,8,1,7,0,12,18,6,1,3,2,8096,8130,12
Task 8097,Job 0,2,7,3,12,0,5,14,9,3,1,2,8097,8131,6
Task 8097,Job 1,7,7,3,12,1,10,19,9,3,4,2,8097,8131,3
Task 8098,Job 0,5,4,3,9,0,8,14,6,3,2,0,8098,8131,12
Task 8098,Job 1,10,6,1,11,0,11,21,10,1,3,0,8098,8131,11
Task 8099,Job 0,2,9,1,8,0,3,10,7,1,1,0,8099,8133,16
Task 8099,Job 1,7,9,2,11,0,9,18,9,2,4,2,8099,8133,9
Task 8100,Job 0,4,6,4,12,0,8,16,8,4,1,1,8100,8133,5
Task 8100,Job 1,9,6,2,9,0,11,18,7,2,3,0,8100,8133,7
Task 8101,Job 0,1,10,2,11,0,3,12,9,2,4,0,8101,8135,15
Task 8101,Job 1,6,4,1,9,0,7,15,8,1,1,1,8101,8135,12
Task 8102,Job 0,10,9,4,10,0,14,20,6,4,1,0,8102,8135,2
Task 8102,Job 1,15,7,4,8,0,19,23,4,4,4,1,8102,8135,19
Task 8103,Job 0,1,10,2,11,1,3,12,9,2,1,1,8103,8137,17
Task 8103,Job 1,6,9,2,10,0,8,16,8,2,4,1,8103,8137,4
Task 8104,Job 0,1,9,4,10,0,5,11,6,4,3,1,8104,8137,11
Task 8104,Job 1,6,9,2,7,0,8,13,5,2,4,0,8104,8137,5
Task 8105,Job 0,2,8,4,11,1,6,13,7,4,2,0,8105,8138,18
Task 8105,Job 1,7,10,1,11,0,8,18,10,1,4,0,8105,8138,16
Task 8106,Job 0,5,4,2,8,1,7,13,6,2,2,2,8106,8139,15
Task 8106,Job 1,10,9,1,7,0,11,17,6,1,1,0,8106,8139,2
Task 8107,Job 0,9,5,4,12,0,13,21,8,4,1,0,8107,8141,10
Task 8107,Job 1,14,8,1,12,0,15,26,11,1,4,2,8107,8141,14
Task 8108,Job 0,1,6,1,11,0,2,12,10,1,2,1,8108,8142,8
Task 8108,Job 1,6,7,1,7,0,7,13,6,1,4,1,8108,8142,11
Task 8109,Job 0,1,4,3,7,0,4,8,4,3,1,0,8109,8142,6
Task 8109,Job 1,6,8,2,10,0,8,16,8,2,1,0,8109,8142,14
Task 8110,Job 0,2,9,2,11,1,4,13,9,2,2,0,8110,8144,13
Task 8110,Job 1,7,5,2,9,0,9,16,7,2,2,1,8110,8144,15
Task 8111,Job 0,2,10,4,10,1,6,12,6,4,4,1,8111,8144,16
Task 8111,Job 1,7,10,3,7,0,10,14,4,3,4,2,8111,8144,13
Task 8112,Job 0,2,4,3,9,0,5,11,6,3,1,0,8112,8145,4
Task 8112,Job 1,7,9,1,8,0,8,15,7,1,2,0,8112,8145,12
Task 8113,Job 0,2,4,2,10,0,4,12,8,2,2,0,8113,8146,20
Task 8113,Job 1,7,9,1,8,0,8,15,7,1,2,0,8113,8146,7
Task 8114,Job 0,5,8,1,8,0,6,13,7,1,1,1,8114,8148,19
Task 8114,Job 1,10,8,4,10,0,14,20,6,4,1,1,8114,8148,12
Task 8115,Job 0,5,4,4,12,0,9,17,8,4,4,1,8115,8148,15
Task 8115,Job 1,10,8,4,11,1,14,21,7,4,3,1,8115,8148,11
Task 8116,Job 0,5,6,3,12,1,8,17,9,3,2,2,8116,8150,17
Task 8116,Job 1,10,8,3,12,0,13,22,9,3,4,2,8116,8150,3
Task 8117,Job 0,5,5,1,7,1,6,12,6,1,1,0,8117,8150,8
Task 8117,Job 1,10,7,2,8,1,12,18,6,2,3,1,8117,8150,10
Task 8118,Job 0,7,6,2,7,0,9,14,5,2,3,2,8118,8151,6
Task 8118,Job 1,12,7,3,10,0,15,22,7,3,4,2,8118,8151,15
Task 8119,Job 0,1,10,4,11,0,5,12,7,4,1,0,8119,8152,13
Task 8119,Job 1,6,10,2,7,0,8,13,5,2,1,1,8119,8152,3
Task 8120,Job 0,6,10,2,10,1,8,16,8,2,1,2,8120,8153,3
Task 8120,Job 1,11,10,4,6,0,15,17,2,4,2,0,8120,8153,15
Task 8121,Job 0,5,9,2,12,0,7,17,10,2,4,2,8121,8155,11
Task 8121,Job 1,10,4,3,8,1,13,18,5,3,2,2,8121,8155,10
Task 8122,Job 0,5,10,3,7,0,8,12,4,3,3,2,8122,8156,3
Task 8122,Job 1,10,5,1,6,0,11,16,5,1,4,0,8122,8156,7
Task 8123,Job 0,7,4,1,10,0,8,17,9,1,2,1,8123,8156,9
Task 8123,Job 1,12,9,1,8,1,13,20,7,1,3,0,8123,8156,10
Task 8124,Job 0,1,8,4,8,0,5,9,4,4,3,1,8124,8157,11
Task 8124,Job 1,6,9,2,10,0,8,16,8,2,4,0,8124,8157,20
Task 8125,Job 0,6,8,2,6,1,8,12,4,2,2,0,8125,8158,5
Task 8125,Job 1,11,4,2,9,0,13,20,7,2,1,0,8125,8158,7
Task 8126,Job 0,7,9,4,11,0,11,18,7,4,3,1,8126,8159,19
Task 8126,Job 1,12,7,4,7,1,16,19,3,4,4,1,8126,8159,16
Task 8127,Job 0,8,10,2,11,1,10,19,9,2,3,0,8127,8160,3
Task 8127,Job 1,13,6,1,11,0,14,24,10,1,4,2,8127,8160,16
Task 8128,Job 0,7,4,2,8,0,9,15,6,2,2,2,8128,8161,3
Task 8128,Job 1,12,5,2,10,1,14,22,8,2,2,2,8128,8161,16
Task 8129,Job 0,7,9,3,6,0,10,13,3,3,1,0,8129,8162,5
Task 8129,Job 1,12,9,3,9,0,15,21,6,3,1,1,8129,8162,14
Task 8130,Job 0,3,8,2,7,0,5,10,5,2,4,2,8130,8163,13
Task 8130,Job 1,8,4,3,7,1,11,15,4,3,3,0,8130,8163,7
Task 8131,Job 0,7,10,1,7,0,8,14,6,1,2,1,8131,8164,9
Task 8131,Job 1,12,10,2,11,0,14,23,9,2,1,0,8131,8164,7
Task 8132,Job 0,10,4,4,11,0,14,21,7,4,3,0,8132,8166,17
Task 8132,Job 1,15,6,2,9,0,17,24,7,2,2,0,8132,8166,8
Task 8133,Job 0,4,6,1,9,0,5,13,8,1,1,1,8133,8166,14
Task 8133,Job 1,9,9,2,9,1,11,18,7,2,3,0,8133,8166,2
Task 8134,Job 0,9,8,2,6,0,11,15,4,2,2,2,8134,8168,18
Task 8134,Job 1,14,9,4,7,0,18,21,3,4,1,0,8134,8168,11
Task 8135,Job 0,10,6,1,8,1,11,18,7,1,4,2,8135,8169,11
Task 8135,Job 1,15,8,4,8,1,19,23,4,4,1,2,8135,8169,17
Task 8136,Job 0,9,4,4,11,0,13,20,7,4,1,1,8136,8169,20
Task 8136,Job 1,14,7,4,8,1,18,22,4,4,1,2,8136,8169,6
Task 8137,Job 0,2,9,2,11,0,4,13,9,2,2,1,8137,8170,16
Task 8137,Job 1,7,7,2,7,1,9,14,5,2,3,1,8137,8170,14
Task 8138,Job 0,3,10,4,7,0,7,10,3,4,1,1,8138,8172,2
Task 8138,Job 1,8,8,2,8,0,10,16,6,2,1,1,8138,8172,8
Task 8139,Job 0,5,9,2,10,0,7,15,8,2,3,1,8139,8173,3
Task 8139,Job 1,10,4,1,7,0,11,17,6,1,2,2,8139,8173,17
Task 8140,Job 0,1,6,2,6,0,3,7,4,2,2,0,8140,8174,5
Task 8140,Job 1,6,9,2,11,0,8,17,9,2,4,0,8140,8174,4
Task 8141,Job 0,3,6,3,11,0,6,14,8,3,2,1,8141,8175,13
Task 8141,Job 1,8,8,1,8,0,9,16,7,1,3,1,8141,8175,7
Task 8142,Job 0,9,6,4,6,1,13,15,2,4,1,1,8142,8176,15
Task 8142,Job 1,14,6,1,6,1,15,20,5,1,1,0,8142,8176,2
Task 8143,Job 0,8,7,1,10,0,9,18,9,1,3,0,8143,8176,14
Task 8143,Job 1,13,9,4,10,0,17,23,6,4,1,1,8143,8176,19
Task 8144,Job 0,1,4,3,7,0,4,8,4,3,4,0,8144,8178,17
Task 8144,Job 1,6,9,4,7,0,10,13,3,4,1,0,8144,8178,15
Task 8145,Job 0,8,8,1,6,1,9,14,5,1,1,2,8145,8179,11
Task 8145,Job 1,13,4,4,8,0,17,21,4,4,3,2,8145,8179,19
Task 8146,Job 0,7,8,1,9,0,8,16,8,1,3,2,8146,8179,3
Task 8146,Job 1,12,10,4,12,1,16,24,8,4,2,1,8146,8179,13
Task 8147,Job 0,5,4,4,9,1,9,14,5,4,2,2,8147,8181,7
Task 8147,Job 1,10,8,1,8,0,11,18,7,1,1,1,8147,8181,17
Task 8148,Job 0,8,9,4,6,0,12,14,2,4,3,1,8148,8181,5
Task 8148,Job 1,13,9,4,12,0,17,25,8,4,2,2,8148,8181,11
Task 8149,Job 0,6,7,3,9,0,9,15,6,3,3,0,8149,8183,5
Task 8149,Job 1,11,5,1,9,1,12,20,8,1,2,0,8149,8183,10
Task 8150,Job 0,5,5,3,9,0,8,14,6,3,4,2,8150,8183,6
Task 8150,Job 1,10,6,3,8,0,13,18,5,3,1,1,8150,8183,3
Task 8151,Job 0,2,4,4,9,1,6,11,5,4,2,2,8151,8185,7
Task 8151,Job 1,7,5,2,7,1,9,14,5,2,2,0,8151,8185,3
Task 8152,Job 0,2,4,1,11,0,3,13,10,1,3,0,8152,8186,10
Task 8152,Job 1,7,8,1,10,0,8,17,9,1,4,1,8152,8186,9
Task 8153,Job 0,3,7,2,6,1,5,9,4,2,3,2,8153,8187,17
Task 8153,Job 1,8,6,4,9,0,12,17,5,4,1,2,8153,8187,5
Task 8154,Job 0,4,5,1,11,0,5,15,10,1,1,0,8154,8187,13
Task 8154,Job 1,9,9,3,11,1,12,20,8,3,4,1,8154,8187,4
Task 8155,Job 0,4,9,1,8,0,5,12,7,1,3,0,8155,8189,14
Task 8155,Job 1,9,8,3,10,1,12,19,7,3,1,0,8155,8189,11
Task 8156,Job 0,2,6,2,7,1,4,9,5,2,1,0,8156,8190,17
Task 8156,Job 1,7,4,1,10,0,8,17,9,1,1,2,8156,8190,15
Task 8157,Job 0,2,4,3,8,0,5,10,5,3,2,2,8157,8190,14
Task 8157,Job 1,7,8,1,8,0,8,15,7,1,2,2,8157,8190,5
Task 8158,Job 0,7,4,2,7,1,9,14,5,2,4,0,8158,8191,11
Task 8158,Job 1,12,8,3,6,0,15,18,3,3,3,0,8158,8191,2
Task 8159,Job 0,9,9,4,8,0,13,17,4,4,4,1,8159,8192,9
Task 8159,Job 1,14,7,3,12,0,17,26,9,3,4,2,8159,8192,13
Task 8160,Job 0,9,7,1,11,1,10,20,10,1,2,0,8160,8193,19
Task 8160,Job 1,14,9,1,9,0,15,23,8,1,2,1,8160,8193,13
Task 8161,Job 0,1,9,4,7,0,5,8,3,4,4,1,8161,8195,17
Task 8161,Job 1,6,9,4,9,0,10,15,5,4,2,2,8161,8195,7
Task 8162,Job 0,7,6,4,9,0,11,16,5,4,3,1,8162,8196,14
Task 8162,Job 1,12,9,1,6,1,13,18,5,1,4,0,8162,8196,15
Task 8163,Job 0,1,7,2,8,1,3,9,6,2,3,1,8163,8196,16
Task 8163,Job 1,6,10,1,6,1,7,12,5,1,3,1,8163,8196,20
Task 8164,Job 0,4,5,3,12,0,7,16,9,3,4,1,8164,8197,7
Task 8164,Job 1,9,9,4,7,0,13,16,3,4,4,0,8164,8197,5
Task 8165,Job 0,1,7,4,10,1,5,11,6,4,3,1,8165,8199,7
Task 8165,Job 1,6,6,4,12,1,10,18,8,4,3,2,8165,8199,15
Task 8166,Job 0,4,5,3,7,1,7,11,4,3,4,1,8166,8199,17
Task 8166,Job 1,9,10,1,6,0,10,15,5,1,1,0,8166,8199,4
Task 8167,Job 0,10,7,3,8,0,13,18,5,3,4,2,8167,8200,12
Task 8167,Job 1,15,10,1,8,0,16,23,7,1,3,0,8167,8200,9
Task 8168,Job 0,9,4,1,11,0,10,20,10,1,3,0,8168,8201,7
Task 8168,Job 1,14,6,2,9,0,16,23,7,2,2,2,8168,8201,7
Task 8169,Job 0,2,7,1,10,0,3,12,9,1,3,2,8169,8202,20
Task 8169,Job 1,7,10,4,9,0,11,16,5,4,3,0,8169,8202,3
Task 8170,Job 0,5,5,1,7,0,6,12,6,1,2,1,8170,8203,5
Task 8170,Job 1,10,6,3,10,1,13,20,7,3,4,0,8170,8203,12
Task 8171,Job 0,4,5,4,11,0,8,15,7,4,3,2,8171,8204,20
Task 8171,Job 1,9,9,1,10,0,10,19,9,1,1,2,8171,8204,19
Task 8172,Job 0,10,7,3,9,0,13,19,6,3,4,1,8172,8206,16
Task 8172,Job 1,15,8,1,6,1,16,21,5,1,4,0,8172,8206,6
Task 8173,Job 0,6,7,1,11,0,7,17,10,1,4,2,8173,8207,9
Task 8173,Job 1,11,4,4,9,1,15,20,5,4,2,1,8173,8207,14
Task 8174,Job 0,2,8,1,12,0,3,14,11,1,1,2,8174,8207,7
Task 8174,Job 1,7,6,3,7,0,10,14,4,3,1,2,8174,8207,13
Task 8175,Job 0,1,6,2,11,0,3,12,9,2,3,0,8175,8209,18
Task 8175,Job 1,6,8,2,12,0,8,18,10,2,2,1,8175,8209,12
Task 8176,Job 0,3,9,1,12,1,4,15,11,1,1,2,8176,8209,4
Task 8176,Job 1,8,5,2,8,0,10,16,6,2,4,1,8176,8209,18
Task 8177,Job 0,10,7,3,9,1,13,19,6,3,4,2,8177,8210,18
Task 8177,Job 1,15,4,4,7,1,19,22,3,4,1,1,8177,8210,11
Task 8178,Job 0,5,6,2,9,0,7,14,7,2,4,0,8178,8212,16
Task 8178,Job 1,10,8,3,7,0,13,17,4,3,1,1,8178,8212,18
Task 8179,Job 0,3,7,2,6,1,5,9,4,2,1,0,8179,8212,15
Task 8179,Job 1,8,4,1,10,0,9,18,9,1,4,1,8179,8212,7
Task 8180,Job 0,4,6,2,9,1,6,13,7,2,1,2,8180,8214,15
Task 8180,Job 1,9,10,3,8,0,12,17,5,3,1,1,8180,8214,4
Task 8181,Job 0,5,5,2,10,0,7,15,8,2,1,2,8181,8214,20
Task 8181,Job 1,10,10,3,9,0,13,19,6,3,3,2,8181,8214,4
Task 8182,Job 0,9,5,1,12,0,10,21,11,1,4,1,8182,8215,5
Task 8182,Job 1,14,6,2,8,0,16,22,6,2,1,2,8182,8215,16
Task 8183,Job 0,6,8,1,8,0,7,14,7,1,2,2,8183,8216,7
Task 8183,Job 1,11,6,2,10,1,13,21,8,2,3,2,8183,8216,8
Task 8184,Job 0,9,8,2,7,1,11,16,5,2,3,2,8184,8218,10
Task 8184,Job 1,14,9,2,10,0,16,24,8,2,3,1,8184,8218,18
Task 8185,Job 0,7,8,1,11,1,8,18,10,1,2,2,8185,8218,17
Task 8185,Job 1,12,9,2,10,1,14,22,8,2,4,2,8185,8218,18
Task 8186,Job 0,7,8,2,6,0,9,13,4,2,2,2,8186,8219,10
Task 8186,Job 1,12,7,2,11,0,14,23,9,2,2,2,8186,8219,3
Task 8187,Job 0,10,4,2,11,0,12,21,9,2,4,0,8187,8221,4
Task 8187,Job 1,15,10,4,12,1,19,27,8,4,4,1,8187,8221,3
Task 8188,Job 0,9,8,1,7,0,10,16,6,1,1,1,8188,8222,15
Task 8188,Job 1,14,7,1,10,0,15,24,9,1,1,2,8188,8222,17
Task 8189,Job 0,2,4,4,8,0,6,10,4,4,2,0,8189,8223,10
Task 8189,Job 1,7,9,2,6,0,9,13,4,2,3,2,8189,8223,4
Task 8190,Job 0,3,10,4,10,0,7,13,6,4,4,2,8190,8224,15
Task 8190,Job 1,8,5,3,10,0,11,18,7,3,2,1,8190,8224,5
Task 8191,Job 0,9,6,1,9,0,10,18,8,1,1,2,8191,8225,6
Task 8191,Job 1,14,9,1,10,0,15,24,9,1,1,0,8191,8225,18
Task 8192,Job 0,8,8,3,11,0,11,19,8,3,3,0,8192,8226,18
Task 8192,Job 1,13,8,2,10,0,15,23,8,2,2,1,8192,8226,20
Task 8193,Job 0,5,4,4,8,0,9,13,4,4,3,2,8193,8227,17
Task 8193,Job 1,10,7,1,11,0,11,21,10,1,3,0,8193,8227,12
Task 8194,Job 0,5,10,4,11,0,9,16,7,4,3,1,8194,8228,8
Task 8194,Job 1,10,7,1,11,0,11,21,10,1,2,0,8194,8228,7
Task 8195,Job 0,8,9,2,12,0,10,20,10,2,4,1,8195,8229,14
Task 8195,Job 1,13,10,3,12,1,16,25,9,3,1,1,8195,8229,12
Task 8196,Job 0,10,5,3,12,1,13,22,9,3,1,2,8196,8230,10
Task 8196,Job 1,15,8,4,12,0,19,27,8,4,2,0,8196,8230,14
Task 8197,Job 0,1,5,4,8,0,5,9,4,4,3,2,8197,8231,13
Task 8197,Job 1,6,8,4,9,1,10,15,5,4,2,0,8197,8231,10
Task 8198,Job 0,8,5,2,10,0,10,18,8,2,1,1,8198,8232,20
Task 8198,Job 1,13,7,1,8,0,14,21,7,1,1,2,8198,8232,19
Task 8199,Job 0,7,7,1,11,0,8,18,10,1,3,0,8199,8232,10
Task 8199,Job 1,12,8,1,6,0,13,18,5,1,3,2,8199,8232,10
Task 8200,Job 0,7,8,2,9,1,9,16,7,2,1,1,8200,8233,14
Task 8200,Job 1,12,6,4,7,0,16,19,3,4,3,1,8200,8233,2
Task 8201,Job 0,8,5,2,12,0,10,20,10,2,2,1,8201,8234,11
Task 8201,Job 1,13,10,4,7,1,17,20,3,4,2,1,8201,8234,14
Task 8202,Job 0,7,4,1,8,0,8,15,7,1,2,1,8202,8235,6
Task 8202,Job 1,12,7,2,12,1,14,24,10,2,3,2,8202,8235,3
Task 8203,Job 0,4,8,4,11,0,8,15,7,4,3,1,8203,8236,4
Task 8203,Job 1,9,6,4,12,0,13,21,8,4,2,0,8203,8236,3
Task 8204,Job 0,4,5,2,10,1,6,14,8,2,2,0,8204,8237,3
Task 8204,Job 1,9,7,1,11,1,10,20,10,1,1,1,8204,8237,14
Task 8205,Job 0,7,4,3,9,0,10,16,6,3,1,1,8205,8238,5
Task 8205,Job 1,12,9,4,7,0,16,19,3,4,2,2,8205,8238,7
Task 8206,Job 0,2,4,2,11,0,4,13,9,2,4,2,8206,8240,10
Task 8206,Job 1,7,6,3,9,1,10,16,6,3,3,2,8206,8240,18
Task 8207,Job 0,4,10,3,9,1,7,13,6,3,4,2,8207,8240,12
Task 8207,Job 1,9,6,2,10,0,11,19,8,2,1,0,8207,8240,12
Task 8208,Job 0,8,10,1,10,0,9,18,9,1,2,2,8208,8242,11
Task 8208,Job 1,13,9,4,9,0,17,22,5,4,4,2,8208,8242,10
Task 8209,Job 0,7,10,2,7,0,9,14,5,2,4,0,8209,8242,6
Task 8209,Job 1,12,7,2,12,0,14,24,10,2,1,1,8209,8242,13
Task 8210,Job 0,10,10,4,6,0,14,16,2,4,3,0,8210,8243,13
Task 8210,Job 1,15,10,1,8,1,16,23,7,1,2,1,8210,8243,15
Task 8211,Job 0,3,7,2,6,0,5,9,4,2,4,0,8211,8245,18
Task 8211,Job 1,8,10,2,10,0,10,18,8,2,3,2,8211,8245,6
Task 8212,Job 0,7,4,2,10,0,9,17,8,2,2,0,8212,8245,18
Task 8212,Job 1,12,8,4,10,0,16,22,6,4,4,0,8212,8245,14
Task 8213,Job 0,6,4,2,9,0,8,15,7,2,2,0,8213,8246,3
Task 8213,Job 1,11,6,4,12,0,15,23,8,4,1,1,8213,8246,5
Task 8214,Job 0,7,8,1,7,0,8,14,6,1,3,2,8214,8247,19
Task 8214,Job 1,12,4,3,12,0,15,24,9,3,1,1,8214,8247,6
Task 8215,Job 0,6,5,2,7,0,8,13,5,2,2,1,8215,8248,15
Task 8215,Job 1,11,6,2,7,0,13,18,5,2,3,2,8215,8248,15
Task 8216,Job 0,4,5,2,7,1,6,11,5,2,3,1,8216,8249,6
Task 8216,Job 1,9,6,2,7,1,11,16,5,2,4,2,8216,8249,13
Task 8217,Job 0,5,10,4,10,1,9,15,6,4,4,0,8217,8251,17
Task 8217,Job 1,10,5,2,8,0,12,18,6,2,3,1,8217,8251,9
Task 8218,Job 0,6,6,2,12,0,8,18,10,2,1,1,8218,8252,2
Task 8218,Job 1,11,4,3,12,0,14,23,9,3,4,2,8218,8252,20
Task 8219,Job 0,6,4,4,10,0,10,16,6,4,2,1,8219,8253,12
Task 8219,Job 1,11,4,4,10,1,15,21,6,4,4,1,8219,8253,13
Task 8220,Job 0,7,5,2,6,0,9,13,4,2,3,0,8220,8253,15
Task 8220,Job 1,12,7,2,7,0,14,19,5,2,1,1,8220,8253,8
Task 8221,Job 0,4,9,3,10,0,7,14,7,3,2,0,8221,8254,13
Task 8221,Job 1,9,8,1,9,0,10,18,8,1,3,2,8221,8254,17
Task 8222,Job 0,3,7,3,11,0,6,14,8,3,3,1,8222,8255,4
Task 8222,Job 1,8,8,2,8,0,10,16,6,2,2,2,8222,8255,10
Task 8223,Job 0,1,4,4,6,1,5,7,2,4,3,1,8223,8257,20
Task 8223,Job 1,6,9,4,7,0,10,13,3,4,1,2,8223,8257,8
Task 8224,Job 0,4,4,1,12,0,5,16,11,1,4,2,8224,8257,20
Task 8224,Job 1,9,4,4,11,0,13,20,7,4,1,1,8224,8257,18
Task 8225,Job 0,9,8,3,8,0,12,17,5,3,4,2,8225,8259,16
Task 8225,Job 1,14,7,1,6,1,15,20,5,1,2,2,8225,8259,19
Task 8226,Job 0,9,5,1,6,0,10,15,5,1,2,0,8226,8259,19
Task 8226,Job 1,14,7,2,7,0,16,21,5,2,1,1,8226,8259,11
Task 8227,Job 0,6,7,2,6,0,8,12,4,2,1,2,8227,8261,14
Task 8227,Job 1,11,8,4,8,0,15,19,4,4,3,0,8227,8261,12
Task 8228,Job 0,2,10,2,12,0,4,14,10,2,1,2,8228,8261,5
Task 8228,Job 1,7,10,3,6,0,10,13,3,3,3,0,8228,8261,16
Task 8229,Job 0,9,4,2,11,0,11,20,9,2,3,0,8229,8262,5
Task 8229,Job 1,14,5,3,11,1,17,25,8,3,3,2,8229,8262,15
Task 8230,Job 0,4,6,3,11,1,7,15,8,3,3,1,8230,8264,17
Task 8230,Job 1,9,8,2,11,1,11,20,9,2,1,2,8230,8264,20
Task 8231,Job 0,5,8,1,12,0,6,17,11,1,2,1,8231,8264,5
Task 8231,Job 1,10,9,1,6,0,11,16,5,1,2,0,8231,8264,10
Task 8232,Job 0,5,6,1,12,0,6,17,11,1,4,0,8232,8265,3
Task 8232,Job 1,10,7,1,12,0,11,22,11,1,2,0,8232,8265,12
Task 8233,Job 0,4,10,1,8,1,5,12,7,1,4,1,8233,8267,19
Task 8233,Job 1,9,6,1,8,0,10,17,7,1,2,1,8233,8267,12
Task 8234,Job 0,4,9,4,9,1,8,13,5,4,3,1,8234,8267,19
Task 8234,Job 1,9,8,1,7,0,10,16,6,1,1,2,8234,8267,15
Task 8235,Job 0,2,9,1,8,0,3,10,7,1,1,2,8235,8269,11
Task 8235,Job 1,7,4,3,11,1,10,18,8,3,3,2,8235,8269,5
Task 8236,Job 0,6,7,4,7,0,10,13,3,4,3,2,8236,8269,16
Task 8236,Job 1,11,10,4,6,0,15,17,2,4,1,0,8236,8269,9
Task 8237,Job 0,10,6,3,8,0,13,18,5,3,4,0,8237,8270,13
Task 8237,Job 1,15,10,4,12,0,19,27,8,4,3,0,8237,8270,2
Task 8238,Job 0,1,7,3,11,0,4,12,8,3,3,2,8238,8272,11
Task 8238,Job 1,6,10,2,12,1,8,18,10,2,3,2,8238,8272,5
Task 8239,Job 0,2,4,2,10,0,4,12,8,2,2,1,8239,8272,2
Task 8239,Job 1,7,5,3,8,0,10,15,5,3,1,0,8239,8272,16
Task 8240,Job 0,7,4,4,9,0,11,16,5,4,2,1,8240,8274,3
Task 8240,Job 1,12,7,3,12,0,15,24,9,3,1,1,8240,8274,12
Task 8241,Job 0,4,5,4,10,0,8,14,6,4,2,0,8241,8274,15
Task 8241,Job 1,9,6,4,10,1,13,19,6,4,2,1,8241,8274,5
Task 8242,Job 0,2,7,1,6,1,3,8,5,1,3,0,8242,8275,19
Task 8242,Job 1,7,7,3,10,0,10,17,7,3,3,2,8242,8275,19
Task 8243,Job 0,7,6,3,10,0,10,17,7,3,4,0,8243,8277,2
Task 8243,Job 1,12,5,3,8,0,15,20,5,3,4,0,8243,8277,7
Task 8244,Job 0,7,4,2,7,1,9,14,5,2,3,1,8244,8277,8
Task 8244,Job 1,12,6,1,9,0,13,21,8,1,1,1,8244,8277,19
Task 8245,Job 0,3,9,2,6,0,5,9,4,2,3,1,8245,8279,14
Task 8245,Job 1,8,8,2,10,0,10,18,8,2,3,2,8245,8279,5
Task 8246,Job 0,5,5,1,10,0,6,15,9,1,4,1,8246,8280,15
Task 8246,Job 1,10,5,4,12,0,14,22,8,4,2,2,8246,8280,14
Task 8247,Job 0,1,9,1,12,0,2,13,11,1,4,0,8247,8280,17
Task 8247,Job 1,6,7,3,10,0,9,16,7,3,3,1,8247,8280,11
Task 8248,Job 0,7,7,2,6,0,9,13,4,2,3,0,8248,8281,19
Task 8248,Job 1,12,10,4,7,0,16,19,3,4,3,0,8248,8281,18
Task 8249,Job 0,1,7,2,8,1,3,9,6,2,2,1,8249,8282,5
Task 8249,Job 1,6,7,2,10,0,8,16,8,2,4,2,8249,8282,16
Task 8250,Job 0,5,5,2,10,0,7,15,8,2,1,2,8250,8284,15
Task 8250,Job 1,10,9,1,7,1,11,17,6,1,2,0,8250,8284,9
Task 8251,Job 0,8,6,4,9,0,12,17,5,4,4,1,8251,8285,14
Task 8251,Job 1,13,4,2,6,1,15,19,4,2,4,1,8251,8285,9
Task 8252,Job 0,6,8,2,10,1,8,16,8,2,1,0,8252,8286,2
Task 8252,Job 1,11,8,1,8,1,12,19,7,1,1,0,8252,8286,19
Task 8253,Job 0,3,8,1,9,0,4,12,8,1,1,1,8253,8287,13
Task 8253,Job 1,8,4,3,6,0,11,14,3,3,3,2,8253,8287,17
Task 8254,Job 0,8,9,3,6,1,11,14,3,3,2,2,8254,8287,16
Task 8254,Job 1,13,5,3,11,0,16,24,8,3,2,0,8254,8287,4
Task 8255,Job 0,2,5,1,7,0,3,9,6,1,1,2,8255,8289,19
Task 8255,Job 1,7,7,2,6,0,9,13,4,2,3,0,8255,8289,13
Task 8256,Job 0,10,8,2,7,1,12,17,5,2,1,2,8256,8290,13
Task 8256,Job 1,15,6,1,6,0,16,21,5,1,1,2,8256,8290,7
Task 8257,Job 0,2,10,1,11,1,3,13,10,1,2,2,8257,8291,14
Task 8257,Job 1,7,7,1,9,0,8,16,8,1,1,0,8257,8291,5
Task 8258,Job 0,7,5,2,9,1,9,16,7,2,4,1,8258,8291,12
Task 8258,Job 1,12,6,1,8,0,13,20,7,1,2,0,8258,8291,2
Task 8259,Job 0,4,8,3,6,0,7,10,3,3,4,1,8259,8293,18
Task 8259,Job 1,9,8,1,8,1,10,17,7,1,2,0,8259,8293,7
Task 8260,Job 0,5,7,4,9,1,9,14,5,4,3,1,8260,8293,14
Task 8260,Job 1,10,4,1,6,0,11,16,5,1,2,2,8260,8293,20
Task 8261,Job 0,7,10,3,9,1,10,16,6,3,3,1,8261,8294,6
Task 8261,Job 1,12,6,4,11,0,16,23,7,4,4,2,8261,8294,15
Task 8262,Job 0,10,8,3,7,0,13,17,4,3,2,1,8262,8296,4
Task 8262,Job 1,15,5,2,10,0,17,25,8,2,3,0,8262,8296,9
Task 8263,Job 0,6,4,2,12,0,8,18,10,2,4,1,8263,8296,18
Task 8263,Job 1,11,6,2,11,0,13,22,9,2,1,1,8263,8296,18
Task 8264,Job 0,4,9,3,9,0,7,13,6,3,1,1,8264,8298,14
Task 8264,Job 1,9,8,4,10,1,13,19,6,4,1,0,8264,8298,8
Task 8265,Job 0,9,6,3,6,0,12,15,3,3,4,1,8265,8298,3
Task 8265,Job 1,14,8,1,7,1,15,21,6,1,4,2,8265,8298,11
Task 8266,Job 0,9,5,1,6,0,10,15,5,1,3,0,8266,8299,7
Task 8266,Job 1,14,9,1,7,0,15,21,6,1,4,1,8266,8299,2
Task 8267,Job 0,1,4,4,9,1,5,10,5,4,2,0,8267,8300,15
Task 8267,Job 1,6,5,1,6,0,7,12,5,1,4,2,8267,8300,6
Task 8268,Job 0,8,10,4,7,0,12,15,3,4,1,2,8268,8302,17
Task 8268,Job 1,13,9,4,9,0,17,22,5,4,1,0,8268,8302,18
Task 8269,Job 0,2,7,4,8,0,6,10,4,4,2,0,8269,8302,13
Task 8269,Job 1,7,5,3,6,0,10,13,3,3,2,1,8269,8302,20
Task 8270,Job 0,6,4,3,9,0,9,15,6,3,2,1,8270,8303,10
Task 8270,Job 1,11,6,1,10,0,12,21,9,1,4,0,8270,8303,3
Task 8271,Job 0,6,9,1,9,0,7,15,8,1,1,0,8271,8305,14
Task 8271,Job 1,11,9,3,11,1,14,22,8,3,2,0,8271,8305,17
Task 8272,Job 0,9,10,1,12,0,10,21,11,1,2,0,8272,8305,2
Task 8272,Job 1,14,4,1,7,0,15,21,6,1,3,1,8272,8305,9
Task 8273,Job 0,8,8,1,12,0,9,20,11,1,4,0,8273,8306,4
Task 8273,Job 1,13,4,1,6,0,14,19,5,1,2,2,8273,8306,5
Task 8274,Job 0,3,6,4,10,0,7,13,6,4,3,0,8274,8307,19
Task 8274,Job 1,8,7,3,10,0,11,18,7,3,4,0,8274,8307,2
Task 8275,Job 0,5,7,3,6,0,8,11,3,3,1,2,8275,8309,14
Task 8275,Job 1,10,8,3,8,0,13,18,5,3,4,0,8275,8309,7
Task 8276,Job 0,6,8,4,9,1,10,15,5,4,1,2,8276,8310,18
Task 8276,Job 1,11,4,2,10,0,13,21,8,2,4,0,8276,8310,20
Task 8277,Job 0,4,9,1,10,0,5,14,9,1,2,1,8277,8311,3
Task 8277,Job 1,9,4,1,8,0,10,17,7,1,3,0,8277,8311,14
Task 8278,Job 0,2,9,4,9,0,6,11,5,4,2,0,8278,8312,14
Task 8278,Job 1,7,7,1,8,0,8,15,7,1,3,0,8278,8312,5
Task 8279,Job 0,6,10,2,12,0,8,18,10,2,4,0,8279,8312,16
Task 8279,Job 1,11,7,3,9,0,14,20,6,3,4,2,8279,8312,18
Task 8280,Job 0,6,7,2,11,0,8,17,9,2,4,2,8280,8314,14
Task 8280,Job 1,11,6,1,7,0,12,18,6,1,3,1,8280,8314,18
Task 8281,Job 0,4,5,2,6,1,6,10,4,2,3,1,8281,8315,13
Task 8281,Job 1,9,6,4,6,0,13,15,2,4,4,2,8281,8315,3
Task 8282,Job 0,4,7,1,12,0,5,16,11,1,2,0,8282,8316,8
Task 8282,Job 1,9,10,2,11,0,11,20,9,2,2,2,8282,8316,15
Task 8283,Job 0,2,10,4,12,0,6,14,8,4,3,2,8283,8316,16
Task 8283,Job 1,7,9,4,8,1,11,15,4,4,3,1,8283,8316,2
Task 8284,Job 0,10,7,4,6,0,14,16,2,4,3,0,8284,8317,12
Task 8284,Job 1,15,5,4,10,1,19,25,6,4,1,1,8284,8317,12
Task 8285,Job 0,5,9,1,12,1,6,17,11,1,4,1,8285,8318,2
Task 8285,Job 1,10,10,1,11,1,11,21,10,1,2,0,8285,8318,4
Task 8286,Job 0,1,9,1,10,1,2,11,9,1,4,1,8286,8320,10
Task 8286,Job 1,6,6,3,9,0,9,15,6,3,3,0,8286,8320,19
Task 8287,Job 0,9,5,1,6,0,10,15,5,1,3,2,8287,8321,8
Task 8287,Job 1,14,5,1,10,0,15,24,9,1,4,2,8287,8321,12
Task 8288,Job 0,2,8,3,9,0,5,11,6,3,2,0,8288,8322,19
Task 8288,Job 1,7,7,4,6,0,11,13,2,4,2,0,8288,8322,17
Task 8289,Job 0,5,10,1,9,1,6,14,8,1,2,0,8289,8322,3
Task 8289,Job 1,10,7,3,7,1,13,17,4,3,3,2,8289,8322,4
Task 8290,Job 0,2,9,1,9,0,3,11,8,1,1,2,8290,8323,2
Task 8290,Job 1,7,5,1,7,0,8,14,6,1,2,0,8290,8323,4
Task 8291,Job 0,1,6,3,6,0,4,7,3,3,1,0,8291,8325,8
Task 8291,Job 1,6,10,4,7,0,10,13,3,4,1,1,8291,8325,11
Task 8292,Job 0,8,5,1,6,1,9,14,5,1,4,2,8292,8325,18
Task 8292,Job 1,13,5,1,8,1,14,21,7,1,3,1,8292,8325,8
Task 8293,Job 0,3,7,3,9,0,6,12,6,3,4,2,8293,8326,14
Task 8293,Job 1,8,6,1,8,0,9,16,7,1,2,0,8293,8326,14
Task 8294,Job 0,9,7,3,12,0,12,21,9,3,2,0,8294,8327,4
Task 8294,Job 1,14,6,2,9,0,16,23,7,2,4,1,8294,8327,6
Task 8295,Job 0,6,10,4,7,1,10,13,3,4,1,2,8295,8328,3
Task 8295,Job 1,11,6,2,11,0,13,22,9,2,3,1,8295,8328,8
Task 8296,Job 0,6,7,3,6,1,9,12,3,3,2,0,8296,8330,15
Task 8296,Job 1,11,8,4,6,0,15,17,2,4,3,1,8296,8330,17
Task 8297,Job 0,5,6,2,6,0,7,11,4,2,2,2,8297,8330,10
Task 8297,Job 1,10,4,1,8,0,11,18,7,1,2,1,8297,8330,19
Task 8298,Job 0,6,5,1,12,0,7,18,11,1,4,0,8298,8331,15
Task 8298,Job 1,11,4,3,10,1,14,21,7,3,3,1,8298,8331,2
Task 8299,Job 0,9,10,2,8,0,11,17,6,2,2,0,8299,8332,19
Task 8299,Job 1,14,10,1,7,0,15,21,6,1,2,1,8299,8332,14
Task 8300,Job 0,6,4,2,8,0,8,14,6,2,2,2,8300,8333,12
Task 8300,Job 1,11,4,3,10,0,14,21,7,3,2,0,8300,8333,19
Task 8301,Job 0,7,6,3,10,1,10,17,7,3,2,1,8301,8335,19
Task 8301,Job 1,12,7,3,11,0,15,23,8,3,1,1,8301,8335,5
Task 8302,Job 0,4,10,4,12,0,8,16,8,4,3,2,8302,8335,18
Task 8302,Job 1,9,4,1,10,1,10,19,9,1,3,2,8302,8335,14
Task 8303,Job 0,4,5,3,8,1,7,12,5,3,3,2,8303,8337,13
Task 8303,Job 1,9,6,3,12,0,12,21,9,3,2,0,8303,8337,14
Task 8304,Job 0,9,5,4,12,0,13,21,8,4,3,1,8304,8337,2
Task 8304,Job 1,14,4,1,7,1,15,21,6,1,3,1,8304,8337,15
Task 8305,Job 0,9,8,3,8,0,12,17,5,3,3,0,8305,8338,6
Task 8305,Job 1,14,8,4,9,0,18,23,5,4,4,2,8305,8338,18
Task 8306,Job 0,9,7,4,9,0,13,18,5,4,4,1,8306,8340,16
Task 8306,Job 1,14,9,4,8,0,18,22,4,4,3,0,8306,8340,3
Task 8307,Job 0,9,7,2,10,0,11,19,8,2,3,0,8307,8340,18
Task 8307,Job 1,14,6,3,6,0,17,20,3,3,1,0,8307,8340,8
Task 8308,Job 0,7,9,1,8,0,8,15,7,1,2,1,8308,8341,15
Task 8308,Job 1,12,4,2,9,0,14,21,7,2,4,0,8308,8341,2
Task 8309,Job 0,5,10,1,12,0,6,17,11,1,4,1,8309,8343,20
Task 8309,Job 1,10,9,3,8,1,13,18,5,3,2,2,8309,8343,7
Task 8310,Job 0,10,10,3,12,0,13,22,9,3,4,2,8310,8344,14
Task 8310,Job 1,15,4,3,12,0,18,27,9,3,2,1,8310,8344,6
Task 8311,Job 0,9,5,4,6,0,13,15,2,4,3,0,8311,8345,11
Task 8311,Job 1,14,7,1,6,0,15,20,5,1,1,0,8311,8345,9
Task 8312,Job 0,4,9,3,11,1,7,15,8,3,4,1,8312,8345,2
Task 8312,Job 1,9,9,3,8,0,12,17,5,3,2,2,8312,8345,9
Task 8313,Job 0,3,5,2,10,0,5,13,8,2,2,2,8313,8347,15
Task 8313,Job 1,8,4,3,11,0,11,19,8,3,4,2,8313,8347,6
Task 8314,Job 0,2,4,2,9,0,4,11,7,2,2,1,8314,8347,13
Task 8314,Job 1,7,10,2,8,0,9,15,6,2,1,2,8314,8347,14
Task 8315,Job 0,9,8,4,12,0,13,21,8,4,3,0,8315,8348,18
Task 8315,Job 1,14,5,4,6,0,18,20,2,4,3,1,8315,8348,10
Task 8316,Job 0,9,10,3,12,0,12,21,9,3,4,1,8316,8350,4
Task 8316,Job 1,14,6,4,12,0,18,26,8,4,3,0,8316,8350,6
Task 8317,Job 0,10,5,3,7,1,13,17,4,3,1,0,8317,8350,12
Task 8317,Job 1,15,10,4,10,0,19,25,6,4,4,1,8317,8350,10
Task 8318,Job 0,10,10,3,11,0,13,21,8,3,2,2,8318,8352,18
Task 8318,Job 1,15,8,2,11,0,17,26,9,2,4,0,8318,8352,5
Task 8319,Job 0,10,4,3,7,0,13,17,4,3,1,2,8319,8352,3
Task 8319,Job 1,15,7,3,10,0,18,25,7,3,3,1,8319,8352,2
Task 8320,Job 0,5,8,1,6,0,6,11,5,1,1,2,8320,8354,12
Task 8320,Job 1,10,6,1,9,1,11,19,8,1,4,2,8320,8354,17
Task 8321,Job 0,1,4,3,11,0,4,12,8,3,3,1,8321,8354,4
Task 8321,Job 1,6,10,1,11,0,7,17,10,1,4,1,8321,8354,12
Task 8322,Job 0,4,9,3,7,0,7,11,4,3,1,0,8322,8356,4
Task 8322,Job 1,9,7,3,12,0,12,21,9,3,1,2,8322,8356,2
Task 8323,Job 0,8,7,1,6,0,9,14,5,1,3,1,8323,8357,20
Task 8323,Job 1,13,5,1,10,0,14,23,9,1,3,2,8323,8357,17
Task 8324,Job 0,6,10,3,11,0,9,17,8,3,3,1,8324,8357,10
Task 8324,Job 1,11,5,1,6,0,12,17,5,1,1,1,8324,8357,2
Task 8325,Job 0,5,5,4,6,0,9,11,2,4,2,1,8325,8358,14
Task 8325,Job 1,10,5,3,11,0,13,21,8,3,3,0,8325,8358,10
Task 8326,Job 0,8,4,2,11,0,10,19,9,2,3,1,8326,8360,5
Task 8326,Job 1,13,7,1,9,0,14,22,8,1,2,2,8326,8360,15
Task 8327,Job 0,6,4,1,6,0,7,12,5,1,1,0,8327,8360,11
Task 8327,Job 1,11,6,2,11,0,13,22,9,2,4,2,8327,8360,6
Task 8328,Job 0,8,10,1,11,0,9,19,10,1,1,2,8328,8361,2
Task 8328,Job 1,13,9,1,7,1,14,20,6,1,1,1,8328,8361,10
Task 8329,Job 0,9,6,1,12,0,10,21,11,1,1,2,8329,8363,16
Task 8329,Job 1,14,8,2,7,0,16,21,5,2,3,2,8329,8363,17
Task 8330,Job 0,9,5,2,12,0,11,21,10,2,1,0,8330,8363,13
Task 8330,Job 1,14,9,3,6,0,17,20,3,3,2,1,8330,8363,6
Task 8331,Job 0,7,10,2,6,1,9,13,4,2,1,1,8331,8364,2
Task 8331,Job 1,12,9,4,9,1,16,21,5,4,1,2,8331,8364,17
Task 8332,Job 0,9,8,3,7,1,12,16,4,3,3,0,8332,8365,6
Task 8332,Job 1,14,5,4,12,0,18,26,8,4,4,1,8332,8365,12
Task 8333,Job 0,8,4,2,12,1,10,20,10,2,4,2,8333,8366,17
Task 8333,Job 1,13,6,2,12,1,15,25,10,2,4,0,8333,8366,15
Task 8334,Job 0,10,8,3,9,0,13,19,6,3,1,0,8334,8367,7
Task 8334,Job 1,15,10,3,7,1,18,22,4,3,1,0,8334,8367,18
Task 8335,Job 0,8,4,1,12,0,9,20,11,1,4,0,8335,8369,18
Task 8335,Job 1,13,7,4,8,0,17,21,4,4,3,1,8335,8369,2
Task 8336,Job 0,3,10,3,9,0,6,12,6,3,2,1,8336,8370,15
Task 8336,Job 1,8,8,1,8,0,9,16,7,1,2,2,8336,8370,14
Task 8337,Job 0,8,7,1,7,0,9,15,6,1,4,0,8337,8371,16
Task 8337,Job 1,13,7,1,12,0,14,25,11,1,3,2,8337,8371,19
Task 8338,Job 0,10,8,2,10,1,12,20,8,2,4,0,8338,8371,17
Task 8338,Job 1,15,8,3,11,1,18,26,8,3,4,0,8338,8371,12
Task 8339,Job 0,9,7,4,9,1,13,18,5,4,2,1,8339,8372,4
Task 8339,Job 1,14,5,1,6,1,15,20,5,1,3,1,8339,8372,14
Task 8340,Job 0,7,7,3,7,1,10,14,4,3,3,0,8340,8373,19
Task 8340,Job 1,12,7,1,12,1,13,24,11,1,4,0,8340,8373,16
Task 8341,Job 0,5,7,4,10,0,9,15,6,4,1,1,8341,8374,14
Task 8341,Job 1,10,8,4,11,0,14,21,7,4,3,2,8341,8374,8
Task 8342,Job 0,8,8,4,7,0,12,15,3,4,1,0,8342,8376,6
Task 8342,Job 1,13,10,2,12,0,15,25,10,2,4,2,8342,8376,3
Task 8343,Job 0,5,9,3,12,0,8,17,9,3,3,1,8343,8376,6
Task 8343,Job 1,10,9,3,7,0,13,17,4,3,3,0,8343,8376,13
Task 8344,Job 0,10,6,2,6,1,12,16,4,2,1,1,8344,8378,5
Task 8344,Job 1,15,8,3,8,0,18,23,5,3,2,0,8344,8378,4
Task 8345,Job 0,8,4,4,10,0,12,18,6,4,4,1,8345,8379,20
Task 8345,Job 1,13,9,3,8,1,16,21,5,3,3,1,8345,8379,10
Task 8346,Job 0,3,4,3,12,1,6,15,9,3,4,2,8346,8380,20
Task 8346,Job 1,8,6,2,8,0,10,16,6,2,2,0,8346,8380,4
Task 8347,Job 0,1,6,4,9,0,5,10,5,4,1,2,8347,8381,3
Task 8347,Job 1,6,6,4,6,0,10,12,2,4,1,1,8347,8381,11
Task 8348,Job 0,10,7,3,9,0,13,19,6,3,2,2,8348,8381,9
Task 8348,Job 1,15,10,4,12,0,19,27,8,4,4,2,8348,8381,20
Task 8349,Job 0,3,6,1,9,0,4,12,8,1,2,1,8349,8383,16
Task 8349,Job 1,8,4,4,11,0,12,19,7,4,4,2,8349,8383,8
Task 8350,Job 0,10,7,1,9,1,11,19,8,1,4,2,8350,8383,14
Task 8350,Job 1,15,5,3,8,1,18,23,5,3,1,2,8350,8383,9
Task 8351,Job 0,5,7,4,10,0,9,15,6,4,3,1,8351,8384,12
Task 8351,Job 1,10,6,4,6,0,14,16,2,4,4,0,8351,8384,14
Task 8352,Job 0,9,5,4,7,0,13,16,3,4,2,2,8352,8385,20
Task 8352,Job 1,14,8,3,12,0,17,26,9,3,4,0,8352,8385,8
Task 8353,Job 0,3,9,1,6,0,4,9,5,1,4,1,8353,8386,4
Task 8353,Job 1,8,5,4,10,0,12,18,6,4,3,0,8353,8386,5
Task 8354,Job 0,9,7,1,9,0,10,18,8,1,4,2,8354,8387,2
Task 8354,Job 1,14,8,3,8,0,17,22,5,3,2,1,8354,8387,6
Task 8355,Job 0,1,9,1,9,1,2,10,8,1,2,0,8355,8389,7
Task 8355,Job 1,6,4,4,10,1,10,16,6,4,2,0,8355,8389,17
Task 8356,Job 0,5,5,4,7,0,9,12,3,4,4,2,8356,8389,6
Task 8356,Job 1,10,10,4,6,0,14,16,2,4,2,2,8356,8389,12
Task 8357,Job 0,4,6,1,7,0,5,11,6,1,2,0,8357,8390,3
Task 8357,Job 1,9,4,1,10,0,10,19,9,1,4,2,8357,8390,15
Task 8358,Job 0,3,4,1,8,0,4,11,7,1,1,2,8358,8392,15
Task 8358,Job 1,8,5,3,6,0,11,14,3,3,2,0,8358,8392,14
Task 8359,Job 0,9,5,2,6,1,11,15,4,2,3,0,8359,8393,2
Task 8359,Job 1,14,6,2,10,0,16,24,8,2,3,1,8359,8393,12
Task 8360,Job 0,3,7,3,7,0,6,10,4,3,2,0,8360,8393,16
Task 8360,Job 1,8,8,1,11,0,9,19,10,1,1,1,8360,8393,7
Task 8361,Job 0,3,10,2,7,0,5,10,5,2,3,1,8361,8394,13
Task 8361,Job 1,8,9,4,12,0,12,20,8,4,3,2,8361,8394,14
Task 8362,Job 0,1,4,1,9,1,2,10,8,1,4,0,8362,8395,3
Task 8362,Job 1,6,9,4,12,0,10,18,8,4,4,2,8362,8395,12
Task 8363,Job 0,10,4,3,7,1,13,17,4,3,3,2,8363,8397,13
Task 8363,Job 1,15,4,3,12,0,18,27,9,3,3,0,8363,8397,4
Task 8364,Job 0,7,10,3,7,1,10,14,4,3,4,2,8364,8398,2
Task 8364,Job 1,12,6,3,7,1,15,19,4,3,1,2,8364,8398,2
Task 8365,Job 0,1,9,2,10,0,3,11,8,2,3,0,8365,8399,14
Task 8365,Job 1,6,6,1,10,0,7,16,9,1,3,1,8365,8399,8
Task 8366,Job 0,2,10,2,7,1,4,9,5,2,3,2,8366,8399,7
Task 8366,Job 1,7,5,2,11,0,9,18,9,2,2,1,8366,8399,18
Task 8367,Job 0,8,5,3,11,1,11,19,8,3,4,0,8367,8401,9
Task 8367,Job 1,13,5,3,8,0,16,21,5,3,2,2,8367,8401,13
Task 8368,Job 0,5,5,3,8,0,8,13,5,3,1,1,8368,8401,5
Task 8368,Job 1,10,7,3,7,1,13,17,4,3,4,0,8368,8401,7
Task 8369,Job 0,7,6,2,10,0,9,17,8,2,2,2,8369,8402,15
Task 8369,Job 1,12,8,4,7,0,16,19,3,4,3,2,8369,8402,14
Task 8370,Job 0,8,6,3,8,0,11,16,5,3,4,0,8370,8403,20
Task 8370,Job 1,13,5,3,6,0,16,19,3,3,3,2,8370,8403,16
Task 8371,Job 0,5,5,1,11,1,6,16,10,1,2,1,8371,8404,15
Task 8371,Job 1,10,4,2,9,1,12,19,7,2,1,2,8371,8404,15
Task 8372,Job 0,5,5,2,6,0,7,11,4,2,4,0,8372,8405,14
Task 8372,Job 1,10,6,2,11,0,12,21,9,2,4,0,8372,8405,14
Task 8373,Job 0,7,7,4,10,1,11,17,6,4,4,2,8373,8406,5
Task 8373,Job 1,12,5,4,12,0,16,24,8,4,4,1,8373,8406,15
Task 8374,Job 0,9,7,3,6,1,12,15,3,3,3,0,8374,8408,13
Task 8374,Job 1,14,7,1,9,1,15,23,8,1,1,0,8374,8408,10
Task 8375,Job 0,8,4,2,12,0,10,20,10,2,2,1,8375,8409,12
Task 8375,Job 1,13,7,3,10,0,16,23,7,3,1,1,8375,8409,7
Task 8376,Job 0,5,8,2,9,0,7,14,7,2,4,0,8376,8409,19
Task 8376,Job 1,10,4,3,6,0,13,16,3,3,1,1,8376,8409,10
Task 8377,Job 0,6,9,1,7,0,7,13,6,1,4,1,8377,8410,17
Task 8377,Job 1,11,4,2,6,1,13,17,4,2,4,2,8377,8410,6
Task 8378,Job 0,7,6,2,9,1,9,16,7,2,2,0,8378,8412,9
Task 8378,Job 1,12,4,3,9,1,15,21,6,3,4,1,8378,8412,2
Task 8379,Job 0,9,9,3,8,0,12,17,5,3,4,2,8379,8412,13
Task 8379,Job 1,14,4,1,12,0,15,26,11,1,4,1,8379,8412,14
Task 8380,Job 0,7,8,4,10,0,11,17,6,4,2,1,8380,8413,19
Task 8380,Job 1,12,7,4,7,0,16,19,3,4,3,1,8380,8413,6
Task 8381,Job 0,4,5,1,10,1,5,14,9,1,4,0,8381,8415,14
Task 8381,Job 1,9,7,1,9,1,10,18,8,1,4,2,8381,8415,11
Task 8382,Job 0,8,8,4,12,0,12,20,8,4,1,1,8382,8415,14
Task 8382,Job 1,13,6,2,6,0,15,19,4,2,3,2,8382,8415,10
Task 8383,Job 0,2,5,3,11,0,5,13,8,3,4,0,8383,8417,8
Task 8383,Job 1,7,9,3,9,0,10,16,6,3,1,2,8383,8417,6
Task 8384,Job 0,8,9,1,11,1,9,19,10,1,4,0,8384,8418,5
Task 8384,Job 1,13,4,1,10,1,14,23,9,1,2,1,8384,8418,6
Task 8385,Job 0,8,7,4,6,0,12,14,2,4,1,1,8385,8418,2
Task 8385,Job 1,13,9,1,12,0,14,25,11,1,2,1,8385,8418,2
Task 8386,Job 0,10,8,1,6,0,11,16,5,1,1,1,8386,8419,4
Task 8386,Job 1,15,8,3,12,1,18,27,9,3,2,0,8386,8419,11
Task 8387,Job 0,10,5,2,11,0,12,21,9,2,3,2,8387,8420,14
Task 8387,Job 1,15,10,1,11,0,16,26,10,1,4,0,8387,8420,11
Task 8388,Job 0,5,5,3,6,0,8,11,3,3,2,1,8388,8422,9
Task 8388,Job 1,10,7,3,11,0,13,21,8,3,2,1,8388,8422,3
Task 8389,Job 0,3,8,1,10,1,4,13,9,1,3,2,8389,8422,17
Task 8389,Job 1,8,5,4,12,0,12,20,8,4,3,0,8389,8422,13
Task 8390,Job 0,5,4,3,9,0,8,14,6,3,3,0,8390,8424,12
Task 8390,Job 1,10,10,3,11,0,13,21,8,3,2,0,8390,8424,14
Task 8391,Job 0,10,7,1,7,0,11,17,6,1,4,1,8391,8425,4
Task 8391,Job 1,15,8,2,11,0,17,26,9,2,4,0,8391,8425,5
Task 8392,Job 0,7,7,2,6,0,9,13,4,2,3,1,8392,8426,2
Task 8392,Job 1,12,5,1,8,0,13,20,7,1,4,1,8392,8426,15
Task 8393,Job 0,8,6,4,8,0,12,16,4,4,4,2,8393,8427,4
Task 8393,Job 1,13,9,3,6,1,16,19,3,3,4,1,8393,8427,3
Task 8394,Job 0,3,9,4,11,0,7,14,7,4,1,2,8394,8427,20
Task 8394,Job 1,8,8,2,12,0,10,20,10,2,2,1,8394,8427,4
Task 8395,Job 0,2,6,4,7,0,6,9,3,4,2,1,8395,8428,15
Task 8395,Job 1,7,6,4,6,0,11,13,2,4,4,1,8395,8428,13
Task 8396,Job 0,7,10,4,9,0,11,16,5,4,2,0,8396,8430,2
Task 8396,Job 1,12,8,2,11,0,14,23,9,2,1,1,8396,8430,6
Task 8397,Job 0,6,7,4,6,1,10,12,2,4,3,2,8397,8430,2
Task 8397,Job 1,11,5,2,12,0,13,23,10,2,2,1,8397,8430,9
Task 8398,Job 0,10,9,2,12,1,12,22,10,2,1,2,8398,8432,13
Task 8398,Job 1,15,4,1,10,0,16,25,9,1,4,2,8398,8432,14
Task 8399,Job 0,6,5,2,6,0,8,12,4,2,2,0,8399,8433,11
Task 8399,Job 1,11,7,4,11,0,15,22,7,4,1,0,8399,8433,12
Task 8400,Job 0,4,9,3,9,0,7,13,6,3,3,2,8400,8434,9
Task 8400,Job 1,9,6,3,8,1,12,17,5,3,2,2,8400,8434,5
Task 8401,Job 0,5,9,1,6,0,6,11,5,1,3,2,8401,8434,20
Task 8401,Job 1,10,8,3,10,0,13,20,7,3,4,1,8401,8434,4
Task 8402,Job 0,3,5,4,6,0,7,9,2,4,4,2,8402,8436,7
Task 8402,Job 1,8,8,3,12,0,11,20,9,3,3,1,8402,8436,6
Task 8403,Job 0,6,5,1,9,0,7,15,8,1,1,2,8403,8436,17
Task 8403,Job 1,11,4,4,7,0,15,18,3,4,1,1,8403,8436,14
Task 8404,Job 0,4,10,1,6,0,5,10,5,1,3,1,8404,8437,9
Task 8404,Job 1,9,10,2,10,0,11,19,8,2,3,1,8404,8437,5
Task 8405,Job 0,6,9,2,6,0,8,12,4,2,1,1,8405,8439,4
Task 8405,Job 1,11,8,3,11,0,14,22,8,3,4,1,8405,8439,5
Task 8406,Job 0,4,10,1,6,0,5,10,5,1,3,1,8406,8439,9
Task 8406,Job 1,9,10,2,11,0,11,20,9,2,3,2,8406,8439,14
Task 8407,Job 0,1,5,3,11,0,4,12,8,3,4,2,8407,8441,7
Task 8407,Job 1,6,9,3,10,0,9,16,7,3,1,1,8407,8441,11
Task 8408,Job 0,8,6,4,7,0,12,15,3,4,3,0,8408,8441,6
Task 8408,Job 1,13,8,4,9,0,17,22,5,4,2,0,8408,8441,11
Task 8409,Job 0,5,4,3,12,0,8,17,9,3,2,2,8409,8442,17
Task 8409,Job 1,10,4,4,12,1,14,22,8,4,2,0,8409,8442,17
Task 8410,Job 0,2,4,4,10,1,6,12,6,4,2,0,8410,8444,14
Task 8410,Job 1,7,10,2,7,0,9,14,5,2,1,2,8410,8444,19
Task 8411,Job 0,2,9,1,7,0,3,9,6,1,3,2,8411,8444,20
Task 8411,Job 1,7,10,2,9,0,9,16,7,2,1,0,8411,8444,19
Task 8412,Job 0,10,9,4,7,0,14,17,3,4,4,2,8412,8445,2
Task 8412,Job 1,15,8,1,8,1,16,23,7,1,2,2,8412,8445,10
Task 8413,Job 0,10,10,4,8,0,14,18,4,4,1,1,8413,8446,13
Task 8413,Job 1,15,4,2,6,1,17,21,4,2,2,1,8413,8446,17
Task 8414,Job 0,6,8,2,6,0,8,12,4,2,2,1,8414,8448,3
Task 8414,Job 1,11,5,1,11,0,12,22,10,1,4,0,8414,8448,2
Task 8415,Job 0,3,4,1,10,0,4,13,9,1,2,0,8415,8449,14
Task 8415,Job 1,8,5,3,12,0,11,20,9,3,4,0,8415,8449,5
Task 8416,Job 0,2,4,1,7,0,3,9,6,1,4,1,8416,8450,5
Task 8416,Job 1,7,4,2,6,0,9,13,4,2,4,2,8416,8450,4
Task 8417,Job 0,6,9,4,7,0,10,13,3,4,4,1,8417,8450,14
Task 8417,Job 1,11,4,1,11,0,12,22,10,1,4,2,8417,8450,3
Task 8418,Job 0,2,6,2,9,0,4,11,7,2,4,1,8418,8451,14
Task 8418,Job 1,7,10,4,12,1,11,19,8,4,3,2,8418,8451,6
Task 8419,Job 0,5,6,2,9,1,7,14,7,2,1,2,8419,8453,14
Task 8419,Job 1,10,4,3,9,0,13,19,6,3,3,0,8419,8453,14
Task 8420,Job 0,2,8,2,8,0,4,10,6,2,2,2,8420,8454,6
Task 8420,Job 1,7,6,2,9,0,9,16,7,2,3,1,8420,8454,7
Task 8421,Job 0,4,10,4,11,0,8,15,7,4,3,2,8421,8455,9
Task 8421,Job 1,9,10,4,8,1,13,17,4,4,2,2,8421,8455,16
Task 8422,Job 0,4,9,2,8,1,6,12,6,2,3,0,8422,8456,5
Task 8422,Job 1,9,5,4,8,0,13,17,4,4,1,1,8422,8456,20
Task 8423,Job 0,4,8,2,8,0,6,12,6,2,4,0,8423,8456,15
Task 8423,Job 1,9,8,2,12,0,11,21,10,2,3,0,8423,8456,16
Task 8424,Job 0,8,5,4,9,0,12,17,5,4,1,2,8424,8458,3
Task 8424,Job 1,13,4,2,12,0,15,25,10,2,3,1,8424,8458,18
Task 8425,Job 0,9,4,3,7,0,12,16,4,3,4,0,8425,8459,3
Task 8425,Job 1,14,7,4,8,0,18,22,4,4,3,2,8425,8459,4
Task 8426,Job 0,7,5,1,9,0,8,16,8,1,3,2,8426,8460,7
Task 8426,Job 1,12,4,1,9,1,13,21,8,1,4,2,8426,8460,3
Task 8427,Job 0,4,6,1,7,0,5,11,6,1,1,1,8427,8461,14
Task 8427,Job 1,9,6,3,9,0,12,18,6,3,4,1,8427,8461,8
Task 8428,Job 0,6,7,3,9,0,9,15,6,3,4,2,8428,8461,15
Task 8428,Job 1,11,8,1,7,0,12,18,6,1,4,1,8428,8461,16
Task 8429,Job 0,3,7,2,12,0,5,15,10,2,1,2,8429,8462,12
Task 8429,Job 1,8,8,4,10,0,12,18,6,4,2,2,8429,8462,7
Task 8430,Job 0,10,9,4,11,0,14,21,7,4,1,2,8430,8463,16
Task 8430,Job 1,15,10,4,6,0,19,21,2,4,1,2,8430,8463,3
Task 8431,Job 0,6,4,3,8,1,9,14,5,3,3,2,8431,8465,10
Task 8431,Job 1,11,6,4,11,0,15,22,7,4,3,0,8431,8465,18
Task 8432,Job 0,4,8,4,10,0,8,14,6,4,2,2,8432,8465,9
Task 8432,Job 1,9,8,1,12,1,10,21,11,1,4,1,8432,8465,4
Task 8433,Job 0,7,10,2,6,1,9,13,4,2,3,2,8433,8467,17
Task 8433,Job 1,12,7,4,6,0,16,18,2,4,3,2,8433,8467,4
Task 8434,Job 0,10,10,3,6,1,13,16,3,3,3,1,8434,8467,15
Task 8434,Job 1,15,10,1,9,0,16,24,8,1,3,0,8434,8467,10
Task 8435,Job 0,7,6,1,12,1,8,19,11,1,2,0,8435,8468,16
Task 8435,Job 1,12,4,4,12,1,16,24,8,4,3,0,8435,8468,14
Task 8436,Job 0,1,7,1,8,0,2,9,7,1,1,0,8436,8469,7
Task 8436,Job 1,6,8,1,6,0,7,12,5,1,3,2,8436,8469,4
Task 8437,Job 0,1,10,3,6,0,4,7,3,3,2,0,8437,8470,17
Task 8437,Job 1,6,5,1,11,1,7,17,10,1,2,1,8437,8470,11
Task 8438,Job 0,2,6,4,11,0,6,13,7,4,2,0,8438,8471,3
Task 8438,Job 1,7,9,1,11,0,8,18,10,1,3,1,8438,8471,17
Task 8439,Job 0,7,6,4,10,0,11,17,6,4,3,1,8439,8472,11
Task 8439,Job 1,12,4,1,9,0,13,21,8,1,4,2,8439,8472,14
Task 8440,Job 0,2,4,4,12,0,6,14,8,4,2,2,8440,8473,6
Task 8440,Job 1,7,4,2,7,0,9,14,5,2,2,0,8440,8473,19
Task 8441,Job 0,3,7,1,12,0,4,15,11,1,1,2,8441,8475,12
Task 8441,Job 1,8,6,4,12,0,12,20,8,4,1,0,8441,8475,19
Task 8442,Job 0,10,6,4,8,0,14,18,4,4,4,2,8442,8475,5
Task 8442,Job 1,15,9,1,11,1,16,26,10,1,2,0,8442,8475,15
Task 8443,Job 0,5,4,2,6,1,7,11,4,2,3,2,8443,8476,2
Task 8443,Job 1,10,9,3,10,0,13,20,7,3,2,1,8443,8476,2
Task 8444,Job 0,5,10,1,12,0,6,17,11,1,1,1,8444,8477,5
Task 8444,Job 1,10,6,1,8,0,11,18,7,1,3,1,8444,8477,20
Task 8445,Job 0,9,10,3,6,0,12,15,3,3,1,1,8445,8479,4
Task 8445,Job 1,14,8,3,7,1,17,21,4,3,3,2,8445,8479,5
Task 8446,Job 0,5,8,4,11,0,9,16,7,4,4,1,8446,8479,8
Task 8446,Job 1,10,7,1,11,0,11,21,10,1,4,2,8446,8479,3
Task 8447,Job 0,5,5,2,6,0,7,11,4,2,4,0,8447,8480,17
Task 8447,Job 1,10,9,4,11,0,14,21,7,4,2,2,8447,8480,4
Task 8448,Job 0,1,6,3,9,0,4,10,6,3,4,1,8448,8481,17
Task 8448,Job 1,6,5,4,7,0,10,13,3,4,1,1,8448,8481,11
Task 8449,Job 0,4,6,3,6,0,7,10,3,3,3,2,8449,8482,6
Task 8449,Job 1,9,4,4,11,1,13,20,7,4,4,2,8449,8482,9
Task 8450,Job 0,1,9,1,8,0,2,9,7,1,4,0,8450,8483,17
Task 8450,Job 1,6,9,3,9,0,9,15,6,3,4,2,8450,8483,11
Task 8451,Job 0,5,5,4,8,0,9,13,4,4,1,0,8451,8485,20
Task 8451,Job 1,10,6,1,10,0,11,20,9,1,3,1,8451,8485,4
Task 8452,Job 0,9,4,1,6,0,10,15,5,1,3,2,8452,8486,15
Task 8452,Job 1,14,5,3,6,0,17,20,3,3,4,2,8452,8486,3
Task 8453,Job 0,7,7,4,11,0,11,18,7,4,2,2,8453,8487,14
Task 8453,Job 1,12,8,4,10,0,16,22,6,4,2,1,8453,8487,18
Task 8454,Job 0,5,9,2,8,0,7,13,6,2,3,1,8454,8488,19
Task 8454,Job 1,10,5,3,11,0,13,21,8,3,3,0,8454,8488,6
Task 8455,Job 0,3,6,2,9,1,5,12,7,2,1,0,8455,8488,7
Task 8455,Job 1,8,7,1,11,0,9,19,10,1,2,1,8455,8488,10
Task 8456,Job 0,6,5,4,12,1,10,18,8,4,3,1,8456,8490,4
Task 8456,Job 1,11,5,4,7,0,15,18,3,4,3,0,8456,8490,11
Task 8457,Job 0,7,9,2,8,0,9,15,6,2,4,2,8457,8490,4
Task 8457,Job 1,12,6,3,11,0,15,23,8,3,3,0,8457,8490,8
Task 8458,Job 0,7,7,4,11,0,11,18,7,4,4,2,8458,8492,20
Task 8458,Job 1,12,4,4,11,0,16,23,7,4,4,2,8458,8492,16
Task 8459,Job 0,6,8,3,9,0,9,15,6,3,2,2,8459,8493,6
Task 8459,Job 1,11,9,1,6,0,12,17,5,1,3,2,8459,8493,7
Task 8460,Job 0,6,10,1,8,1,7,14,7,1,4,1,8460,8493,8
Task 8460,Job 1,11,9,1,8,1,12,19,7,1,3,2,8460,8493,13
Task 8461,Job 0,2,7,3,8,1,5,10,5,3,2,1,8461,8495,17
Task 8461,Job 1,7,5,1,6,0,8,13,5,1,2,1,8461,8495,18
Task 8462,Job 0,6,8,2,8,1,8,14,6,2,1,0,8462,8496,15
Task 8462,Job 1,11,4,2,9,0,13,20,7,2,2,0,8462,8496,11
Task 8463,Job 0,3,4,1,11,0,4,14,10,1,1,0,8463,8497,11
Task 8463,Job 1,8,10,1,12,0,9,20,11,1,4,2,8463,8497,12
Task 8464,Job 0,7,4,1,11,0,8,18,10,1,1,2,8464,8498,6
Task 8464,Job 1,12,8,2,6,0,14,18,4,2,4,2,8464,8498,17
Task 8465,Job 0,8,9,4,10,0,12,18,6,4,1,2,8465,8499,10
Task 8465,Job 1,13,8,1,9,0,14,22,8,1,1,0,8465,8499,9
Task 8466,Job 0,6,8,1,11,1,7,17,10,1,1,2,8466,8499,4
Task 8466,Job 1,11,5,4,8,0,15,19,4,4,3,0,8466,8499,2
Task 8467,Job 0,8,5,2,10,0,10,18,8,2,2,0,8467,8500,9
Task 8467,Job 1,13,5,1,7,0,14,20,6,1,4,1,8467,8500,7
Task 8468,Job 0,10,7,3,11,0,13,21,8,3,4,1,8468,8501,17
Task 8468,Job 1,15,9,1,7,1,16,22,6,1,1,0,8468,8501,3
Task 8469,Job 0,7,7,1,9,0,8,16,8,1,1,1,8469,8503,4
Task 8469,Job 1,12,9,1,7,0,13,19,6,1,1,1,8469,8503,17
Task 8470,Job 0,9,7,3,6,1,12,15,3,3,3,1,8470,8504,15
Task 8470,Job 1,14,4,3,12,0,17,26,9,3,1,0,8470,8504,3
Task 8471,Job 0,8,4,4,9,0,12,17,5,4,3,1,8471,8505,19
Task 8471,Job 1,13,5,2,11,0,15,24,9,2,1,1,8471,8505,12
Task 8472,Job 0,4,10,4,10,0,8,14,6,4,3,0,8472,8505,8
Task 8472,Job 1,9,8,1,10,0,10,19,9,1,2,1,8472,8505,4
Task 8473,Job 0,1,8,1,10,0,2,11,9,1,2,0,8473,8507,14
Task 8473,Job 1,6,9,2,11,0,8,17,9,2,1,1,8473,8507,2
Task 8474,Job 0,4,10,2,11,0,6,15,9,2,1,1,8474,8508,7
Task 8474,Job 1,9,7,2,7,0,11,16,5,2,3,1,8474,8508,3
Task 8475,Job 0,9,9,3,8,0,12,17,5,3,1,0,8475,8509,6
Task 8475,Job 1,14,8,2,10,0,16,24,8,2,3,0,8475,8509,4
Task 8476,Job 0,10,4,2,7,0,12,17,5,2,1,0,8476,8510,11
Task 8476,Job 1,15,8,2,12,1,17,27,10,2,1,2,8476,8510,16
Task 8477,Job 0,9,8,3,9,0,12,18,6,3,4,2,8477,8511,11
Task 8477,Job 1,14,6,2,7,0,16,21,5,2,2,0,8477,8511,14
Task 8478,Job 0,5,8,4,7,0,9,12,3,4,3,0,8478,8511,19
Task 8478,Job 1,10,4,2,12,0,12,22,10,2,1,1,8478,8511,11
Task 8479,Job 0,5,8,4,12,0,9,17,8,4,1,0,8479,8513,9
Task 8479,Job 1,10,6,3,9,1,13,19,6,3,3,0,8479,8513,5
Task 8480,Job 0,9,5,1,7,0,10,16,6,1,3,1,8480,8514,13
Task 8480,Job 1,14,8,3,9,1,17,23,6,3,1,0,8480,8514,7
Task 8481,Job 0,6,8,1,11,0,7,17,10,1,2,2,8481,8514,18
Task 8481,Job 1,11,9,2,8,0,13,19,6,2,2,0,8481,8514,8
Task 8482,Job 0,8,6,4,7,0,12,15,3,4,3,0,8482,8516,7
Task 8482,Job 1,13,5,2,12,0,15,25,10,2,1,2,8482,8516,13
Task 8483,Job 0,8,8,4,12,0,12,20,8,4,2,0,8483,8516,16
Task 8483,Job 1,13,7,4,11,0,17,24,7,4,1,0,8483,8516,5
Task 8484,Job 0,2,6,3,8,0,5,10,5,3,2,1,8484,8518,20
Task 8484,Job 1,7,10,2,8,0,9,15,6,2,1,2,8484,8518,10
Task 8485,Job 0,2,6,1,10,1,3,12,9,1,4,0,8485,8518,13
Task 8485,Job 1,7,9,4,11,0,11,18,7,4,3,0,8485,8518,3
Task 8486,Job 0,5,7,3,12,0,8,17,9,3,4,0,8486,8519,6
Task 8486,Job 1,10,7,2,7,0,12,17,5,2,2,2,8486,8519,15
Task 8487,Job 0,2,6,4,11,1,6,13,7,4,2,0,8487,8520,13
Task 8487,Job 1,7,4,1,6,0,8,13,5,1,4,1,8487,8520,9
Task 8488,Job 0,4,10,1,12,0,5,16,11,1,4,1,8488,8522,16
Task 8488,Job 1,9,10,3,11,0,12,20,8,3,4,0,8488,8522,17
Task 8489,Job 0,8,4,2,9,1,10,17,7,2,3,2,8489,8523,9
Task 8489,Job 1,13,7,3,8,0,16,21,5,3,3,0,8489,8523,20
Task 8490,Job 0,5,8,1,10,1,6,15,9,1,3,0,8490,8524,3
Task 8490,Job 1,10,5,4,11,0,14,21,7,4,3,1,8490,8524,15
Task 8491,Job 0,2,7,3,8,0,5,10,5,3,3,1,8491,8525,6
Task 8491,Job 1,7,6,4,8,0,11,15,4,4,1,2,8491,8525,13
Task 8492,Job 0,3,5,2,7,1,5,10,5,2,1,0,8492,8526,11
Task 8492,Job 1,8,4,3,12,0,11,20,9,3,4,2,8492,8526,18
Task 8493,Job 0,5,10,1,11,0,6,16,10,1,4,0,8493,8527,3
Task 8493,Job 1,10,7,3,12,1,13,22,9,3,4,2,8493,8527,11
Task 8494,Job 0,4,7,3,11,1,7,15,8,3,4,2,8494,8528,12
Task 8494,Job 1,9,6,1,7,0,10,16,6,1,1,0,8494,8528,18
Task 8495,Job 0,1,5,2,8,0,3,9,6,2,1,1,8495,8528,18
Task 8495,Job 1,6,9,4,8,0,10,14,4,4,2,1,8495,8528,4
Task 8496,Job 0,6,5,4,12,0,10,18,8,4,2,1,8496,8529,16
Task 8496,Job 1,11,5,2,7,0,13,18,5,2,4,0,8496,8529,19
Task 8497,Job 0,8,5,4,11,0,12,19,7,4,2,2,8497,8531,6
Task 8497,Job 1,13,9,1,6,0,14,19,5,1,2,0,8497,8531,16
Task 8498,Job 0,6,10,4,11,0,10,17,7,4,3,2,8498,8532,4
Task 8498,Job 1,11,5,3,11,0,14,22,8,3,2,0,8498,8532,17
Task 8499,Job 0,6,5,1,12,0,7,18,11,1,4,1,8499,8533,18
Task 8499,Job 1,11,7,1,10,0,12,21,9,1,3,0,8499,8533,18
Task 8500,Job 0,1,8,2,10,0,3,11,8,2,2,1,8500,8534,15
Task 8500,Job 1,6,5,1,12,0,7,18,11,1,2,2,8500,8534,5
Task 8501,Job 0,10,5,2,6,1,12,16,4,2,4,0,8501,8535,15
Task 8501,Job 1,15,6,1,12,0,16,27,11,1,1,0,8501,8535,14
Task 8502,Job 0,1,4,4,8,1,5,9,4,4,4,2,8502,8536,3
Task 8502,Job 1,6,10,2,7,0,8,13,5,2,1,1,8502,8536,7
Task 8503,Job 0,6,9,4,10,0,10,16,6,4,4,2,8503,8537,12
Task 8503,Job 1,11,6,1,12,0,12,23,11,1,4,2,8503,8537,13
Task 8504,Job 0,4,8,1,9,0,5,13,8,1,4,1,8504,8538,3
Task 8504,Job 1,9,8,3,10,0,12,19,7,3,3,0,8504,8538,14
Task 8505,Job 0,4,7,3,10,0,7,14,7,3,3,0,8505,8539,6
Task 8505,Job 1,9,4,3,10,0,12,19,7,3,4,2,8505,8539,16
Task 8506,Job 0,7,9,1,12,0,8,19,11,1,1,2,8506,8540,6
Task 8506,Job 1,12,9,1,7,0,13,19,6,1,3,2,8506,8540,4
Task 8507,Job 0,10,7,1,11,0,11,21,10,1,2,1,8507,8540,20
Task 8507,Job 1,15,6,3,7,0,18,22,4,3,1,1,8507,8540,12
Task 8508,Job 0,10,7,2,10,1,12,20,8,2,4,2,8508,8541,5
Task 8508,Job 1,15,9,4,7,0,19,22,3,4,2,1,8508,8541,11
Task 8509,Job 0,1,7,3,10,1,4,11,7,3,1,0,8509,8542,4
Task 8509,Job 1,6,9,1,9,1,7,15,8,1,3,2,8509,8542,10
Task 8510,Job 0,6,8,2,12,0,8,18,10,2,1,0,8510,8543,10
Task 8510,Job 1,11,10,3,9,0,14,20,6,3,1,0,8510,8543,17
Task 8511,Job 0,9,10,4,9,0,13,18,5,4,1,2,8511,8544,12
Task 8511,Job 1,14,8,2,7,0,16,21,5,2,2,2,8511,8544,18
Task 8512,Job 0,6,5,1,9,0,7,15,8,1,2,0,8512,8545,3
Task 8512,Job 1,11,5,4,11,0,15,22,7,4,1,2,8512,8545,9
Task 8513,Job 0,1,4,4,6,0,5,7,2,4,4,1,8513,8546,9
Task 8513,Job 1,6,8,1,7,0,7,13,6,1,1,0,8513,8546,19
Task 8514,Job 0,7,7,1,10,1,8,17,9,1,2,0,8514,8547,8
Task 8514,Job 1,12,4,1,9,0,13,21,8,1,1,1,8514,8547,19
Task 8515,Job 0,8,8,3,7,0,11,15,4,3,4,2,8515,8549,8
Task 8515,Job 1,13,10,2,10,1,15,23,8,2,1,2,8515,8549,19
Task 8516,Job 0,1,9,3,10,0,4,11,7,3,2,2,8516,8550,11
Task 8516,Job 1,6,5,2,7,0,8,13,5,2,1,0,8516,8550,5
Task 8517,Job 0,8,8,1,12,0,9,20,11,1,2,0,8517,8550,3
Task 8517,Job 1,13,10,4,6,0,17,19,2,4,3,2,8517,8550,3
Task 8518,Job 0,10,10,1,11,0,11,21,10,1,3,2,8518,8552,13
Task 8518,Job 1,15,8,2,9,0,17,24,7,2,2,2,8518,8552,2
Task 8519,Job 0,7,6,2,9,0,9,16,7,2,3,1,8519,8553,7
Task 8519,Job 1,12,7,3,8,0,15,20,5,3,2,2,8519,8553,12
Task 8520,Job 0,2,8,2,10,0,4,12,8,2,3,0,8520,8553,18
Task 8520,Job 1,7,10,4,11,0,11,18,7,4,1,1,8520,8553,14
Task 8521,Job 0,7,10,2,12,0,9,19,10,2,3,1,8521,8555,6
Task 8521,Job 1,12,7,4,11,0,16,23,7,4,2,1,8521,8555,15
Task 8522,Job 0,4,4,2,10,0,6,14,8,2,3,1,8522,8555,19
Task 8522,Job 1,9,8,4,10,0,13,19,6,4,4,1,8522,8555,4
Task 8523,Job 0,10,8,3,6,1,13,16,3,3,3,1,8523,8556,11
Task 8523,Job 1,15,9,4,12,1,19,27,8,4,1,2,8523,8556,11
Task 8524,Job 0,8,4,4,12,0,12,20,8,4,1,2,8524,8557,11
Task 8524,Job 1,13,4,4,10,0,17,23,6,4,2,0,8524,8557,2
Task 8525,Job 0,4,7,2,9,0,6,13,7,2,4,2,8525,8559,12
Task 8525,Job 1,9,9,3,8,1,12,17,5,3,1,2,8525,8559,12
Task 8526,Job 0,1,5,2,8,0,3,9,6,2,2,2,8526,8559,16
Task 8526,Job 1,6,7,2,8,0,8,14,6,2,2,2,8526,8559,8
Task 8527,Job 0,9,4,4,10,0,13,19,6,4,1,2,8527,8560,14
Task 8527,Job 1,14,6,3,8,0,17,22,5,3,3,2,8527,8560,11
Task 8528,Job 0,2,9,2,10,1,4,12,8,2,4,0,8528,8562,14
Task 8528,Job 1,7,9,2,12,1,9,19,10,2,4,1,8528,8562,7
Task 8529,Job 0,5,4,2,9,0,7,14,7,2,4,2,8529,8562,9
Task 8529,Job 1,10,9,1,7,0,11,17,6,1,2,0,8529,8562,14
Task 8530,Job 0,7,9,2,9,0,9,16,7,2,2,2,8530,8564,15
Task 8530,Job 1,12,8,4,10,0,16,22,6,4,3,1,8530,8564,4
Task 8531,Job 0,1,7,1,12,0,2,13,11,1,2,0,8531,8564,3
Task 8531,Job 1,6,6,3,11,0,9,17,8,3,2,1,8531,8564,16
Task 8532,Job 0,2,9,3,9,0,5,11,6,3,3,2,8532,8565,7
Task 8532,Job 1,7,9,1,12,0,8,19,11,1,2,2,8532,8565,18
Task 8533,Job 0,2,10,2,7,0,4,9,5,2,2,2,8533,8566,15
Task 8533,Job 1,7,8,4,8,0,11,15,4,4,2,2,8533,8566,17
Task 8534,Job 0,6,4,2,10,1,8,16,8,2,2,0,8534,8568,12
Task 8534,Job 1,11,5,4,11,0,15,22,7,4,3,2,8534,8568,10
Task 8535,Job 0,1,4,1,9,0,2,10,8,1,4,0,8535,8568,14
Task 8535,Job 1,6,8,3,8,0,9,14,5,3,2,2,8535,8568,4
Task 8536,Job 0,3,5,3,12,1,6,15,9,3,4,1,8536,8570,4
Task 8536,Job 1,8,7,4,9,0,12,17,5,4,1,2,8536,8570,18
Task 8537,Job 0,8,7,2,10,0,10,18,8,2,1,1,8537,8570,18
Task 8537,Job 1,13,10,2,8,1,15,21,6,2,3,0,8537,8570,6
Task 8538,Job 0,4,4,4,12,0,8,16,8,4,4,1,8538,8571,12
Task 8538,Job 1,9,5,4,11,0,13,20,7,4,2,0,8538,8571,5
Task 8539,Job 0,8,8,4,8,1,12,16,4,4,3,1,8539,8572,17
Task 8539,Job 1,13,7,3,7,0,16,20,4,3,4,1,8539,8572,2
Task 8540,Job 0,4,6,3,7,0,7,11,4,3,4,2,8540,8574,6
Task 8540,Job 1,9,5,2,6,0,11,15,4,2,1,0,8540,8574,7
Task 8541,Job 0,3,6,3,8,0,6,11,5,3,4,2,8541,8574,8
Task 8541,Job 1,8,10,2,11,0,10,19,9,2,2,0,8541,8574,12
Task 8542,Job 0,6,10,3,12,0,9,18,9,3,1,1,8542,8575,5
Task 8542,Job 1,11,8,3,7,0,14,18,4,3,4,0,8542,8575,15
Task 8543,Job 0,2,9,1,6,0,3,8,5,1,4,2,8543,8577,4
Task 8543,Job 1,7,10,1,12,0,8,19,11,1,4,2,8543,8577,12
Task 8544,Job 0,1,8,4,9,0,5,10,5,4,2,2,8544,8578,8
Task 8544,Job 1,6,4,4,7,0,10,13,3,4,4,1,8544,8578,17
Task 8545,Job 0,6,10,2,9,0,8,15,7,2,1,2,8545,8578,20
Task 8545,Job 1,11,8,3,8,0,14,19,5,3,3,1,8545,8578,14
Task 8546,Job 0,5,7,1,11,0,6,16,10,1,2,0,8546,8579,10
Task 8546,Job 1,10,10,3,12,0,13,22,9,3,2,0,8546,8579,2
Task 8547,Job 0,3,10,1,7,1,4,10,6,1,1,0,8547,8580,17
Task 8547,Job 1,8,5,1,10,0,9,18,9,1,4,2,8547,8580,13
Task 8548,Job 0,5,8,4,12,0,9,17,8,4,4,1,8548,8582,20
Task 8548,Job 1,10,6,3,7,1,13,17,4,3,3,0,8548,8582,18
Task 8549,Job 0,2,5,2,12,0,4,14,10,2,4,1,8549,8582,15
Task 8549,Job 1,7,5,1,12,0,8,19,11,1,1,2,8549,8582,8
Task 8550,Job 0,5,10,2,10,0,7,15,8,2,3,2,8550,8583,20
Task 8550,Job 1,10,7,3,10,0,13,20,7,3,1,2,8550,8583,14
Task 8551,Job 0,9,6,2,12,0,11,21,10,2,4,2,8551,8585,19
Task 8551,Job 1,14,9,1,12,0,15,26,11,1,4,2,8551,8585,11
Task 8552,Job 0,7,10,2,12,0,9,19,10,2,3,2,8552,8585,2
Task 8552,Job 1,12,6,1,9,0,13,21,8,1,3,0,8552,8585,14
Task 8553,Job 0,6,10,1,10,0,7,16,9,1,3,0,8553,8587,13
Task 8553,Job 1,11,5,1,12,0,12,23,11,1,4,2,8553,8587,8
Task 8554,Job 0,9,6,2,6,0,11,15,4,2,3,2,8554,8588,18
Task 8554,Job 1,14,10,4,8,0,18,22,4,4,2,2,8554,8588,8
Task 8555,Job 0,7,10,3,8,0,10,15,5,3,2,0,8555,8589,7
Task 8555,Job 1,12,4,3,12,0,15,24,9,3,2,0,8555,8589,7
Task 8556,Job 0,9,8,2,11,0,11,20,9,2,3,0,8556,8589,20
Task 8556,Job 1,14,4,3,9,0,17,23,6,3,4,2,8556,8589,17
Task 8557,Job 0,7,9,4,12,0,11,19,8,4,4,0,8557,8590,4
Task 8557,Job 1,12,7,1,11,0,13,23,10,1,1,1,8557,8590,20
Task 8558,Job 0,5,10,4,12,0,9,17,8,4,1,0,8558,8591,18
Task 8558,Job 1,10,8,2,8,0,12,18,6,2,1,2,8558,8591,13
Task 8559,Job 0,9,10,4,7,0,13,16,3,4,4,1,8559,8593,15
Task 8559,Job 1,14,5,3,9,0,17,23,6,3,1,1,8559,8593,5
Task 8560,Job 0,2,9,2,10,0,4,12,8,2,2,1,8560,8593,13
Task 8560,Job 1,7,7,4,12,1,11,19,8,4,2,1,8560,8593,14
Task 8561,Job 0,2,5,4,8,0,6,10,4,4,2,0,8561,8595,3
Task 8561,Job 1,7,5,4,7,1,11,14,3,4,2,1,8561,8595,9
Task 8562,Job 0,6,6,4,9,0,10,15,5,4,3,0,8562,8596,11
Task 8562,Job 1,11,9,3,10,0,14,21,7,3,1,2,8562,8596,2
Task 8563,Job 0,2,9,3,6,1,5,8,3,3,3,1,8563,8596,5
Task 8563,Job 1,7,9,4,7,0,11,14,3,4,2,2,8563,8596,10
Task 8564,Job 0,6,7,2,10,0,8,16,8,2,2,0,8564,8598,14
Task 8564,Job 1,11,7,2,12,0,13,23,10,2,4,1,8564,8598,8
Task 8565,Job 0,5,5,4,9,0,9,14,5,4,1,0,8565,8599,3
Task 8565,Job 1,10,7,1,11,0,11,21,10,1,3,0,8565,8599,14
Task 8566,Job 0,2,4,3,10,0,5,12,7,3,4,0,8566,8600,6
Task 8566,Job 1,7,8,2,7,1,9,14,5,2,3,1,8566,8600,11
Task 8567,Job 0,3,4,3,11,1,6,14,8,3,3,2,8567,8600,9
Task 8567,Job 1,8,9,3,9,0,11,17,6,3,1,0,8567,8600,3
Task 8568,Job 0,2,6,1,10,0,3,12,9,1,4,2,8568,8602,3
Task 8568,Job 1,7,9,1,9,1,8,16,8,1,3,1,8568,8602,2
Task 8569,Job 0,3,10,1,10,0,4,13,9,1,1,1,8569,8603,7
Task 8569,Job 1,8,9,2,6,0,10,14,4,2,3,0,8569,8603,19
Task 8570,Job 0,10,6,3,10,0,13,20,7,3,1,2,8570,8604,16
Task 8570,Job 1,15,7,2,8,0,17,23,6,2,4,2,8570,8604,17
Task 8571,Job 0,4,7,3,8,0,7,12,5,3,2,1,8571,8605,2
Task 8571,Job 1,9,9,3,9,0,12,18,6,3,1,1,8571,8605,13
Task 8572,Job 0,2,4,2,11,1,4,13,9,2,4,0,8572,8606,10
Task 8572,Job 1,7,8,3,12,1,10,19,9,3,1,2,8572,8606,6
Task 8573,Job 0,3,9,4,12,1,7,15,8,4,3,0,8573,8606,7
Task 8573,Job 1,8,8,2,6,0,10,14,4,2,4,0,8573,8606,17
Task 8574,Job 0,1,6,3,11,0,4,12,8,3,1,2,8574,8608,10
Task 8574,Job 1,6,5,4,8,0,10,14,4,4,4,1,8574,8608,3
Task 8575,Job 0,10,9,3,7,1,13,17,4,3,3,1,8575,8608,11
Task 8575,Job 1,15,8,3,9,0,18,24,6,3,4,0,8575,8608,8
Task 8576,Job 0,9,10,1,11,0,10,20,10,1,2,2,8576,8610,10
Task 8576,Job 1,14,6,3,7,0,17,21,4,3,2,2,8576,8610,16
Task 8577,Job 0,9,9,4,8,0,13,17,4,4,4,1,8577,8610,16
Task 8577,Job 1,14,9,2,12,1,16,26,10,2,1,1,8577,8610,12
Task 8578,Job 0,4,5,1,6,1,5,10,5,1,3,1,8578,8612,20
Task 8578,Job 1,9,7,4,6,0,13,15,2,4,3,1,8578,8612,18
Task 8579,Job 0,5,10,1,12,0,6,17,11,1,4,0,8579,8613,10
Task 8579,Job 1,10,10,4,9,0,14,19,5,4,1,0,8579,8613,20
Task 8580,Job 0,9,7,3,8,0,12,17,5,3,1,1,8580,8614,10
Task 8580,Job 1,14,6,4,8,0,18,22,4,4,2,0,8580,8614,10
Task 8581,Job 0,5,7,2,10,0,7,15,8,2,4,0,8581,8614,18
Task 8581,Job 1,10,8,1,9,0,11,19,8,1,2,2,8581,8614,11
Task 8582,Job 0,2,6,3,8,0,5,10,5,3,3,1,8582,8615,10
Task 8582,Job 1,7,5,1,8,0,8,15,7,1,2,1,8582,8615,12
Task 8583,Job 0,2,9,3,11,1,5,13,8,3,4,0,8583,8616,8
Task 8583,Job 1,7,6,2,7,0,9,14,5,2,4,0,8583,8616,5
Task 8584,Job 0,3,7,1,12,0,4,15,11,1,2,2,8584,8618,12
Task 8584,Job 1,8,8,2,7,0,10,15,5,2,4,0,8584,8618,9
Task 8585,Job 0,3,6,2,9,1,5,12,7,2,1,0,8585,8618,8
Task 8585,Job 1,8,7,4,6,0,12,14,2,4,1,1,8585,8618,20
Task 8586,Job 0,6,4,4,7,0,10,13,3,4,3,0,8586,8619,14
Task 8586,Job 1,11,7,2,8,0,13,19,6,2,3,1,8586,8619,10
Task 8587,Job 0,6,6,4,11,1,10,17,7,4,3,1,8587,8621,10
Task 8587,Job 1,11,6,1,9,0,12,20,8,1,1,1,8587,8621,8
Task 8588,Job 0,6,8,4,9,1,10,15,5,4,3,0,8588,8621,7
Task 8588,Job 1,11,4,2,10,0,13,21,8,2,2,2,8588,8621,3
Task 8589,Job 0,4,8,4,8,0,8,12,4,4,4,0,8589,8623,3
Task 8589,Job 1,9,5,3,7,1,12,16,4,3,3,0,8589,8623,18
Task 8590,Job 0,3,4,4,8,0,7,11,4,4,4,2,8590,8624,18
Task 8590,Job 1,8,9,4,6,0,12,14,2,4,2,0,8590,8624,10
Task 8591,Job 0,3,7,1,10,0,4,13,9,1,2,1,8591,8625,18
Task 8591,Job 1,8,7,3,8,0,11,16,5,3,1,1,8591,8625,11
Task 8592,Job 0,6,5,2,9,0,8,15,7,2,2,2,8592,8626,11
Task 8592,Job 1,11,9,1,9,0,12,20,8,1,2,2,8592,8626,16
Task 8593,Job 0,1,10,2,10,1,3,11,8,2,1,0,8593,8626,10
Task 8593,Job 1,6,5,4,10,0,10,16,6,4,4,1,8593,8626,4
Task 8594,Job 0,5,8,4,12,1,9,17,8,4,1,2,8594,8628,8
Task 8594,Job 1,10,4,3,9,0,13,19,6,3,4,1,8594,8628,8
Task 8595,Job 0,4,7,2,9,0,6,13,7,2,2,2,8595,8628,6
Task 8595,Job 1,9,8,1,8,0,10,17,7,1,4,0,8595,8628,12
Task 8596,Job 0,1,10,2,12,1,3,13,10,2,3,2,8596,8630,14
Task 8596,Job 1,6,6,4,11,0,10,17,7,4,4,0,8596,8630,4
Task 8597,Job 0,5,9,2,10,1,7,15,8,2,3,0,8597,8630,7
Task 8597,Job 1,10,8,1,9,1,11,19,8,1,1,1,8597,8630,18
Task 8598,Job 0,5,4,2,12,0,7,17,10,2,4,0,8598,8632,8
Task 8598,Job 1,10,4,4,8,0,14,18,4,4,1,2,8598,8632,18
Task 8599,Job 0,4,8,1,9,0,5,13,8,1,4,2,8599,8633,4
Task 8599,Job 1,9,4,2,7,0,11,16,5,2,1,2,8599,8633,2
Task 8600,Job 0,4,9,2,7,0,6,11,5,2,3,0,8600,8633,19
Task 8600,Job 1,9,4,2,10,0,11,19,8,2,2,1,8600,8633,10
Task 8601,Job 0,8,5,4,12,1,12,20,8,4,4,2,8601,8634,13
Task 8601,Job 1,13,4,4,12,0,17,25,8,4,2,0,8601,8634,13
Task 8602,Job 0,10,6,2,6,0,12,16,4,2,4,1,8602,8635,3
Task 8602,Job 1,15,8,2,10,0,17,25,8,2,3,0,8602,8635,8
Task 8603,Job 0,10,4,2,12,1,12,22,10,2,3,2,8603,8637,2
Task 8603,Job 1,15,7,4,11,1,19,26,7,4,3,0,8603,8637,18
Task 8604,Job 0,7,5,4,6,0,11,13,2,4,1,1,8604,8638,5
Task 8604,Job 1,12,8,3,6,0,15,18,3,3,3,1,8604,8638,8
Task 8605,Job 0,8,5,3,8,0,11,16,5,3,3,2,8605,8639,20
Task 8605,Job 1,13,8,3,12,0,16,25,9,3,3,2,8605,8639,17
Task 8606,Job 0,7,7,2,12,1,9,19,10,2,2,1,8606,8639,19
Task 8606,Job 1,12,10,4,9,0,16,21,5,4,1,2,8606,8639,3
Task 8607,Job 0,6,5,3,6,0,9,12,3,3,4,2,8607,8641,16
Task 8607,Job 1,11,6,1,7,1,12,18,6,1,3,0,8607,8641,20
Task 8608,Job 0,1,7,4,12,1,5,13,8,4,1,2,8608,8641,11
Task 8608,Job 1,6,8,1,11,0,7,17,10,1,4,2,8608,8641,2
Task 8609,Job 0,7,9,2,7,0,9,14,5,2,4,2,8609,8642,7
Task 8609,Job 1,12,7,4,9,0,16,21,5,4,3,1,8609,8642,8
Task 8610,Job 0,7,6,2,9,0,9,16,7,2,4,1,8610,8643,8
Task 8610,Job 1,12,5,4,12,0,16,24,8,4,4,2,8610,8643,2
Task 8611,Job 0,3,5,1,9,1,4,12,8,1,4,1,8611,8644,12
Task 8611,Job 1,8,10,1,11,0,9,19,10,1,1,0,8611,8644,19
Task 8612,Job 0,1,7,4,10,0,5,11,6,4,2,1,8612,8645,2
Task 8612,Job 1,6,6,2,10,0,8,16,8,2,1,1,8612,8645,14
Task 8613,Job 0,3,7,1,8,1,4,11,7,1,3,1,8613,8646,12
Task 8613,Job 1,8,8,1,9,0,9,17,8,1,4,2,8613,8646,9
Task 8614,Job 0,6,7,4,8,0,10,14,4,4,1,0,8614,8648,15
Task 8614,Job 1,11,9,2,9,1,13,20,7,2,2,1,8614,8648,8
Task 8615,Job 0,10,9,3,6,0,13,16,3,3,2,2,8615,8649,17
Task 8615,Job 1,15,5,1,9,1,16,24,8,1,4,0,8615,8649,12
Task 8616,Job 0,10,9,1,8,1,11,18,7,1,1,2,8616,8650,6
Task 8616,Job 1,15,7,3,7,0,18,22,4,3,4,2,8616,8650,6
Task 8617,Job 0,4,4,1,8,0,5,12,7,1,4,0,8617,8651,15
Task 8617,Job 1,9,5,1,10,0,10,19,9,1,4,0,8617,8651,16
Task 8618,Job 0,3,9,3,11,0,6,14,8,3,2,2,8618,8652,19
Task 8618,Job 1,8,8,4,11,1,12,19,7,4,4,2,8618,8652,17
Task 8619,Job 0,5,10,3,11,0,8,16,8,3,3,1,8619,8652,19
Task 8619,Job 1,10,10,1,8,0,11,18,7,1,3,1,8619,8652,14
Task 8620,Job 0,7,9,4,12,0,11,19,8,4,4,1,8620,8654,2
Task 8620,Job 1,12,8,1,12,0,13,24,11,1,2,0,8620,8654,15
Task 8621,Job 0,6,10,3,7,0,9,13,4,3,2,2,8621,8655,17
Task 8621,Job 1,11,10,3,11,1,14,22,8,3,2,0,8621,8655,5
Task 8622,Job 0,3,7,2,7,0,5,10,5,2,4,0,8622,8655,7
Task 8622,Job 1,8,7,1,10,0,9,18,9,1,2,1,8622,8655,19
Task 8623,Job 0,6,10,3,6,0,9,12,3,3,3,2,8623,8657,20
Task 8623,Job 1,11,6,2,10,0,13,21,8,2,3,0,8623,8657,8
Task 8624,Job 0,1,7,2,6,0,3,7,4,2,2,1,8624,8657,3
Task 8624,Job 1,6,5,3,10,0,9,16,7,3,1,0,8624,8657,13
Task 8625,Job 0,4,5,1,7,0,5,11,6,1,2,1,8625,8659,20
Task 8625,Job 1,9,4,1,10,1,10,19,9,1,3,1,8625,8659,14
Task 8626,Job 0,1,4,4,10,0,5,11,6,4,4,1,8626,8660,16
Task 8626,Job 1,6,8,3,7,0,9,13,4,3,2,0,8626,8660,19
Task 8627,Job 0,3,10,3,10,0,6,13,7,3,3,2,8627,8660,9
Task 8627,Job 1,8,4,2,11,0,10,19,9,2,3,2,8627,8660,19
Task 8628,Job 0,4,10,2,7,0,6,11,5,2,1,1,8628,8662,15
Task 8628,Job 1,9,10,4,7,0,13,16,3,4,4,0,8628,8662,13
Task 8629,Job 0,2,9,2,8,0,4,10,6,2,2,1,8629,8663,11
Task 8629,Job 1,7,8,1,6,0,8,13,5,1,3,1,8629,8663,15
Task 8630,Job 0,7,6,1,11,1,8,18,10,1,3,0,8630,8664,17
Task 8630,Job 1,12,4,3,12,0,15,24,9,3,2,1,8630,8664,6
Task 8631,Job 0,5,8,1,9,1,6,14,8,1,3,2,8631,8664,2
Task 8631,Job 1,10,7,4,9,0,14,19,5,4,3,2,8631,8664,12
Task 8632,Job 0,3,9,3,8,0,6,11,5,3,2,1,8632,8666,19
Task 8632,Job 1,8,5,1,11,0,9,19,10,1,2,2,8632,8666,5
Task 8633,Job 0,8,8,1,8,1,9,16,7,1,4,2,8633,8667,13
Task 8633,Job 1,13,9,1,6,0,14,19,5,1,1,0,8633,8667,17
Task 8634,Job 0,9,10,1,12,1,10,21,11,1,1,0,8634,8667,2
Task 8634,Job 1,14,7,1,7,1,15,21,6,1,1,2,8634,8667,6
Task 8635,Job 0,1,9,2,7,1,3,8,5,2,4,0,8635,8668,12
Task 8635,Job 1,6,9,1,12,0,7,18,11,1,2,2,8635,8668,16
Task 8636,Job 0,4,6,4,7,0,8,11,3,4,3,1,8636,8669,18
Task 8636,Job 1,9,8,2,12,1,11,21,10,2,1,1,8636,8669,16
Task 8637,Job 0,5,6,4,8,1,9,13,4,4,1,2,8637,8671,12
Task 8637,Job 1,10,5,1,9,0,11,19,8,1,3,1,8637,8671,17
Task 8638,Job 0,4,8,4,6,0,8,10,2,4,2,2,8638,8671,7
Task 8638,Job 1,9,7,4,12,0,13,21,8,4,4,2,8638,8671,2
Task 8639,Job 0,7,5,3,6,0,10,13,3,3,2,1,8639,8672,10
Task 8639,Job 1,12,4,4,10,0,16,22,6,4,4,0,8639,8672,6
Task 8640,Job 0,10,10,2,12,1,12,22,10,2,3,2,8640,8673,9
Task 8640,Job 1,15,8,3,12,1,18,27,9,3,4,0,8640,8673,15
Task 8641,Job 0,7,8,2,9,1,9,16,7,2,4,1,8641,8674,19
Task 8641,Job 1,12,8,1,12,0,13,24,11,1,4,2,8641,8674,3
Task 8642,Job 0,7,4,1,6,1,8,13,5,1,3,2,8642,8675,7
Task 8642,Job 1,12,9,2,6,0,14,18,4,2,2,0,8642,8675,8
Task 8643,Job 0,10,7,4,6,0,14,16,2,4,1,0,8643,8676,19
Task 8643,Job 1,15,10,2,9,0,17,24,7,2,2,1,8643,8676,3
Task 8644,Job 0,9,7,2,10,0,11,19,8,2,3,0,8644,8677,19
Task 8644,Job 1,14,8,2,7,0,16,21,5,2,1,1,8644,8677,10
Task 8645,Job 0,9,5,3,10,0,12,19,7,3,1,0,8645,8679,10
Task 8645,Job 1,14,6,3,6,1,17,20,3,3,1,2,8645,8679,20
Task 8646,Job 0,5,9,2,7,1,7,12,5,2,4,2,8646,8680,10
Task 8646,Job 1,10,8,1,6,0,11,16,5,1,3,2,8646,8680,9
Task 8647,Job 0,9,6,3,9,0,12,18,6,3,3,2,8647,8680,10
Task 8647,Job 1,14,5,4,8,1,18,22,4,4,1,1,8647,8680,16
Task 8648,Job 0,7,6,4,6,1,11,13,2,4,3,0,8648,8682,10
Task 8648,Job 1,12,9,1,10,0,13,22,9,1,3,2,8648,8682,15
Task 8649,Job 0,8,7,1,10,1,9,18,9,1,2,2,8649,8682,11
Task 8649,Job 1,13,7,1,6,0,14,19,5,1,4,2,8649,8682,18
Task 8650,Job 0,8,7,2,12,0,10,20,10,2,3,0,8650,8683,2
Task 8650,Job 1,13,6,2,12,0,15,25,10,2,4,0,8650,8683,11
Task 8651,Job 0,10,8,1,12,1,11,22,11,1,4,1,8651,8684,20
Task 8651,Job 1,15,5,1,11,1,16,26,10,1,1,0,8651,8684,15
Task 8652,Job 0,2,9,3,12,0,5,14,9,3,3,2,8652,8685,14
Task 8652,Job 1,7,4,1,11,0,8,18,10,1,4,2,8652,8685,5
Task 8653,Job 0,6,4,3,11,0,9,17,8,3,2,0,8653,8687,11
Task 8653,Job 1,11,9,4,10,0,15,21,6,4,1,0,8653,8687,15
Task 8654,Job 0,7,9,2,12,0,9,19,10,2,4,0,8654,8688,18
Task 8654,Job 1,12,10,4,7,0,16,19,3,4,1,1,8654,8688,17
Task 8655,Job 0,5,9,1,12,0,6,17,11,1,4,1,8655,8688,17
Task 8655,Job 1,10,7,3,9,0,13,19,6,3,3,1,8655,8688,13
Task 8656,Job 0,6,9,1,7,0,7,13,6,1,1,2,8656,8689,8
Task 8656,Job 1,11,7,3,9,0,14,20,6,3,2,0,8656,8689,2
Task 8657,Job 0,8,7,1,9,0,9,17,8,1,2,1,8657,8690,16
Task 8657,Job 1,13,7,3,10,0,16,23,7,3,4,2,8657,8690,8
Task 8658,Job 0,3,6,2,7,0,5,10,5,2,3,0,8658,8692,8
Task 8658,Job 1,8,7,1,12,0,9,20,11,1,2,2,8658,8692,11
Task 8659,Job 0,10,5,1,6,0,11,16,5,1,3,2,8659,8693,12
Task 8659,Job 1,15,6,2,7,1,17,22,5,2,1,1,8659,8693,6
Task 8660,Job 0,5,9,2,9,1,7,14,7,2,3,1,8660,8693,15
Task 8660,Job 1,10,5,4,7,0,14,17,3,4,2,2,8660,8693,13
Task 8661,Job 0,3,4,4,9,0,7,12,5,4,1,2,8661,8694,5
Task 8661,Job 1,8,10,1,12,0,9,20,11,1,3,1,8661,8694,16
Task 8662,Job 0,9,10,3,11,0,12,20,8,3,3,2,8662,8695,11
Task 8662,Job 1,14,8,2,10,0,16,24,8,2,2,1,8662,8695,13
Task 8663,Job 0,2,6,2,8,0,4,10,6,2,2,1,8663,8696,2
Task 8663,Job 1,7,10,1,12,0,8,19,11,1,3,0,8663,8696,5
Task 8664,Job 0,9,9,2,6,0,11,15,4,2,1,0,8664,8698,3
Task 8664,Job 1,14,6,1,7,0,15,21,6,1,3,1,8664,8698,20
Task 8665,Job 0,5,5,4,11,1,9,16,7,4,4,0,8665,8699,3
Task 8665,Job 1,10,6,4,12,0,14,22,8,4,2,0,8665,8699,9
Task 8666,Job 0,8,10,4,10,0,12,18,6,4,1,1,8666,8700,13
Task 8666,Job 1,13,10,4,11,0,17,24,7,4,3,1,8666,8700,4
Task 8667,Job 0,6,6,2,10,0,8,16,8,2,1,2,8667,8701,13
Task 8667,Job 1,11,9,1,8,1,12,19,7,1,4,1,8667,8701,6
Task 8668,Job 0,3,7,1,7,0,4,10,6,1,2,2,8668,8702,6
Task 8668,Job 1,8,7,2,6,0,10,14,4,2,1,0,8668,8702,7
Task 8669,Job 0,7,8,1,10,1,8,17,9,1,1,1,8669,8702,16
Task 8669,Job 1,12,9,3,8,1,15,20,5,3,1,2,8669,8702,17
Task 8670,Job 0,4,10,1,8,0,5,12,7,1,2,1,8670,8704,8
Task 8670,Job 1,9,9,4,12,0,13,21,8,4,1,2,8670,8704,15
Task 8671,Job 0,3,5,2,10,0,5,13,8,2,1,2,8671,8704,6
Task 8671,Job 1,8,8,2,9,0,10,17,7,2,3,0,8671,8704,14
Task 8672,Job 0,6,7,1,10,0,7,16,9,1,2,1,8672,8706,10
Task 8672,Job 1,11,8,1,11,0,12,22,10,1,2,0,8672,8706,2
Task 8673,Job 0,2,4,3,6,0,5,8,3,3,3,2,8673,8706,14
Task 8673,Job 1,7,5,4,11,0,11,18,7,4,3,2,8673,8706,9
Task 8674,Job 0,3,8,3,7,1,6,10,4,3,4,0,8674,8708,20
Task 8674,Job 1,8,5,2,10,0,10,18,8,2,3,1,8674,8708,16
Task 8675,Job 0,3,6,2,7,0,5,10,5,2,3,0,8675,8708,12
Task 8675,Job 1,8,8,4,7,0,12,15,3,4,3,0,8675,8708,11
Task 8676,Job 0,3,4,1,10,1,4,13,9,1,4,1,8676,8710,14
Task 8676,Job 1,8,6,2,7,0,10,15,5,2,3,1,8676,8710,3
Task 8677,Job 0,2,10,4,6,0,6,8,2,4,1,1,8677,8711,14
Task 8677,Job 1,7,8,1,8,0,8,15,7,1,3,0,8677,8711,8
Task 8678,Job 0,8,4,2,11,1,10,19,9,2,4,2,8678,8711,8
Task 8678,Job 1,13,5,2,10,0,15,23,8,2,1,1,8678,8711,12
Task 8679,Job 0,4,4,2,7,0,6,11,5,2,4,0,8679,8713,19
Task 8679,Job 1,9,9,4,9,0,13,18,5,4,3,0,8679,8713,7
Task 8680,Job 0,2,10,3,8,1,5,10,5,3,4,0,8680,8713,4
Task 8680,Job 1,7,6,1,9,0,8,16,8,1,2,1,8680,8713,17
Task 8681,Job 0,8,6,2,7,0,10,15,5,2,3,0,8681,8714,3
Task 8681,Job 1,13,4,4,6,0,17,19,2,4,2,2,8681,8714,7
Task 8682,Job 0,3,5,1,11,1,4,14,10,1,1,2,8682,8715,11
Task 8682,Job 1,8,8,3,12,1,11,20,9,3,2,2,8682,8715,14
Task 8683,Job 0,10,5,4,9,0,14,19,5,4,3,1,8683,8716,10
Task 8683,Job 1,15,7,2,6,0,17,21,4,2,3,0,8683,8716,2
Task 8684,Job 0,6,7,1,8,1,7,14,7,1,2,2,8684,8717,20
Task 8684,Job 1,11,8,1,12,0,12,23,11,1,2,0,8684,8717,14
Task 8685,Job 0,10,10,3,12,0,13,22,9,3,3,0,8685,8719,3
Task 8685,Job 1,15,9,4,8,1,19,23,4,4,2,0,8685,8719,8
Task 8686,Job 0,9,8,2,10,0,11,19,8,2,2,2,8686,8720,10
Task 8686,Job 1,14,9,4,11,0,18,25,7,4,3,0,8686,8720,7
Task 8687,Job 0,10,10,3,6,0,13,16,3,3,2,2,8687,8720,8
Task 8687,Job 1,15,8,1,11,0,16,26,10,1,3,1,8687,8720,18
Task 8688,Job 0,10,5,1,10,1,11,20,9,1,1,0,8688,8721,10
Task 8688,Job 1,15,7,2,6,1,17,21,4,2,2,0,8688,8721,7
Task 8689,Job 0,10,8,1,11,0,11,21,10,1,2,2,8689,8722,10
Task 8689,Job 1,15,7,2,6,0,17,21,4,2,3,1,8689,8722,13
Task 8690,Job 0,8,10,1,6,0,9,14,5,1,2,0,8690,8723,11
Task 8690,Job 1,13,7,2,9,0,15,22,7,2,4,1,8690,8723,18
Task 8691,Job 0,4,10,1,6,0,5,10,5,1,1,2,8691,8725,7
Task 8691,Job 1,9,8,2,10,0,11,19,8,2,3,1,8691,8725,19
Task 8692,Job 0,7,5,4,9,0,11,16,5,4,1,1,8692,8725,20
Task 8692,Job 1,12,10,1,11,0,13,23,10,1,4,1,8692,8725,19
Task 8693,Job 0,3,6,4,10,0,7,13,6,4,3,1,8693,8727,11
Task 8693,Job 1,8,8,2,11,0,10,19,9,2,3,0,8693,8727,11
Task 8694,Job 0,6,7,2,7,1,8,13,5,2,4,0,8694,8727,5
Task 8694,Job 1,11,4,1,9,0,12,20,8,1,3,2,8694,8727,7
Task 8695,Job 0,5,7,1,11,0,6,16,10,1,3,0,8695,8729,13
Task 8695,Job 1,10,10,4,9,1,14,19,5,4,4,2,8695,8729,4
Task 8696,Job 0,6,8,1,8,0,7,14,7,1,4,2,8696,8729,7
Task 8696,Job 1,11,10,2,12,0,13,23,10,2,2,2,8696,8729,8
Task 8697,Job 0,4,5,2,6,0,6,10,4,2,2,2,8697,8730,14
Task 8697,Job 1,9,4,1,10,0,10,19,9,1,4,1,8697,8730,15
Task 8698,Job 0,3,6,1,6,0,4,9,5,1,4,1,8698,8731,4
Task 8698,Job 1,8,6,3,6,0,11,14,3,3,4,0,8698,8731,9
Task 8699,Job 0,8,9,3,6,1,11,14,3,3,4,1,8699,8733,2
Task 8699,Job 1,13,10,4,10,1,17,23,6,4,2,2,8699,8733,16
Task 8700,Job 0,5,4,3,11,0,8,16,8,3,2,1,8700,8734,6
Task 8700,Job 1,10,10,4,6,1,14,16,2,4,3,2,8700,8734,12
Task 8701,Job 0,5,10,2,6,0,7,11,4,2,3,2,8701,8735,9
Task 8701,Job 1,10,7,4,11,1,14,21,7,4,3,1,8701,8735,10
Task 8702,Job 0,1,10,4,8,0,5,9,4,4,1,1,8702,8735,14
Task 8702,Job 1,6,5,4,9,0,10,15,5,4,2,1,8702,8735,19
Task 8703,Job 0,4,7,1,12,1,5,16,11,1,1,2,8703,8736,9
Task 8703,Job 1,9,9,4,12,1,13,21,8,4,4,1,8703,8736,6
Task 8704,Job 0,4,4,1,9,0,5,13,8,1,2,1,8704,8738,6
Task 8704,Job 1,9,5,1,11,0,10,20,10,1,4,1,8704,8738,11
Task 8705,Job 0,4,4,4,7,0,8,11,3,4,3,1,8705,8738,15
Task 8705,Job 1,9,10,4,9,1,13,18,5,4,4,0,8705,8738,17
Task 8706,Job 0,2,8,1,6,0,3,8,5,1,1,0,8706,8739,13
Task 8706,Job 1,7,7,2,7,0,9,14,5,2,4,2,8706,8739,2
Task 8707,Job 0,9,4,4,12,0,13,21,8,4,2,1,8707,8740,8
Task 8707,Job 1,14,4,1,6,0,15,20,5,1,2,1,8707,8740,9
Task 8708,Job 0,6,8,3,9,0,9,15,6,3,4,2,8708,8741,10
Task 8708,Job 1,11,7,3,8,0,14,19,5,3,2,1,8708,8741,20
Task 8709,Job 0,9,5,3,7,0,12,16,4,3,2,2,8709,8742,20
Task 8709,Job 1,14,9,4,7,0,18,21,3,4,2,0,8709,8742,19
Task 8710,Job 0,2,7,3,12,0,5,14,9,3,4,2,8710,8744,7
Task 8710,Job 1,7,5,3,7,0,10,14,4,3,1,0,8710,8744,18
Task 8711,Job 0,9,5,4,9,0,13,18,5,4,2,2,8711,8745,13
Task 8711,Job 1,14,4,3,12,1,17,26,9,3,2,2,8711,8745,3
Task 8712,Job 0,4,10,3,8,1,7,12,5,3,3,1,8712,8745,18
Task 8712,Job 1,9,8,2,10,0,11,19,8,2,4,0,8712,8745,5
Task 8713,Job 0,6,9,1,10,0,7,16,9,1,1,0,8713,8747,17
Task 8713,Job 1,11,4,4,9,0,15,20,5,4,1,0,8713,8747,5
Task 8714,Job 0,5,6,2,6,1,7,11,4,2,1,2,8714,8747,2
Task 8714,Job 1,10,8,1,10,0,11,20,9,1,3,0,8714,8747,11
Task 8715,Job 0,7,7,1,9,0,8,16,8,1,4,0,8715,8748,7
Task 8715,Job 1,12,9,3,7,0,15,19,4,3,2,2,8715,8748,19
Task 8716,Job 0,6,4,1,12,1,7,18,11,1,3,2,8716,8750,5
Task 8716,Job 1,11,7,3,6,0,14,17,3,3,3,1,8716,8750,5
Task 8717,Job 0,1,10,1,8,0,2,9,7,1,1,2,8717,8750,15
Task 8717,Job 1,6,8,2,12,0,8,18,10,2,4,1,8717,8750,5
Task 8718,Job 0,8,5,3,7,0,11,15,4,3,4,1,8718,8751,17
Task 8718,Job 1,13,4,4,8,0,17,21,4,4,2,0,8718,8751,16
Task 8719,Job 0,10,10,3,6,0,13,16,3,3,2,2,8719,8753,19
Task 8719,Job 1,15,8,1,7,0,16,22,6,1,1,2,8719,8753,19
Task 8720,Job 0,8,9,3,10,0,11,18,7,3,3,2,8720,8753,20
Task 8720,Job 1,13,4,3,12,0,16,25,9,3,1,2,8720,8753,10
Task 8721,Job 0,7,4,3,9,1,10,16,6,3,2,2,8721,8754,13
Task 8721,Job 1,12,7,2,11,1,14,23,9,2,3,1,8721,8754,11
Task 8722,Job 0,3,9,4,9,0,7,12,5,4,4,0,8722,8756,12
Task 8722,Job 1,8,10,1,11,0,9,19,10,1,3,2,8722,8756,2
Task 8723,Job 0,6,6,4,12,0,10,18,8,4,2,2,8723,8756,6
Task 8723,Job 1,11,10,1,8,0,12,19,7,1,4,1,8723,8756,9
Task 8724,Job 0,1,9,2,10,0,3,11,8,2,4,0,8724,8758,15
Task 8724,Job 1,6,5,1,8,0,7,14,7,1,4,1,8724,8758,19
Task 8725,Job 0,2,6,2,6,1,4,8,4,2,3,2,8725,8759,8
Task 8725,Job 1,7,8,1,9,0,8,16,8,1,3,0,8725,8759,10
Task 8726,Job 0,2,4,2,12,0,4,14,10,2,1,0,8726,8760,18
Task 8726,Job 1,7,4,3,9,1,10,16,6,3,2,2,8726,8760,18
Task 8727,Job 0,9,4,2,12,0,11,21,10,2,4,1,8727,8760,14
Task 8727,Job 1,14,9,1,11,0,15,25,10,1,3,0,8727,8760,20
Task 8728,Job 0,9,7,3,11,0,12,20,8,3,3,1,8728,8762,6
Task 8728,Job 1,14,4,1,6,0,15,20,5,1,4,2,8728,8762,17
Task 8729,Job 0,1,7,1,7,0,2,8,6,1,4,0,8729,8763,11
Task 8729,Job 1,6,9,4,10,0,10,16,6,4,1,1,8729,8763,12
Task 8730,Job 0,4,9,2,12,0,6,16,10,2,1,0,8730,8764,14
Task 8730,Job 1,9,8,4,8,0,13,17,4,4,3,0,8730,8764,7
Task 8731,Job 0,5,5,3,7,0,8,12,4,3,2,0,8731,8764,8
Task 8731,Job 1,10,7,4,10,0,14,20,6,4,3,1,8731,8764,20
Task 8732,Job 0,9,6,3,10,0,12,19,7,3,4,2,8732,8765,13
Task 8732,Job 1,14,5,4,11,0,18,25,7,4,4,0,8732,8765,13
Task 8733,Job 0,7,7,3,12,0,10,19,9,3,1,2,8733,8766,10
Task 8733,Job 1,12,9,3,11,1,15,23,8,3,4,1,8733,8766,16
Task 8734,Job 0,9,5,1,11,0,10,20,10,1,1,1,8734,8768,7
Task 8734,Job 1,14,10,1,12,1,15,26,11,1,4,1,8734,8768,20
Task 8735,Job 0,4,7,3,9,0,7,13,6,3,3,1,8735,8769,12
Task 8735,Job 1,9,10,1,6,1,10,15,5,1,2,1,8735,8769,2
Task 8736,Job 0,3,6,2,12,0,5,15,10,2,3,2,8736,8770,9
Task 8736,Job 1,8,9,3,6,0,11,14,3,3,1,0,8736,8770,17
Task 8737,Job 0,1,8,4,11,0,5,12,7,4,2,0,8737,8770,19
Task 8737,Job 1,6,8,4,12,0,10,18,8,4,3,2,8737,8770,6
Task 8738,Job 0,5,4,4,11,1,9,16,7,4,2,0,8738,8772,5
Task 8738,Job 1,10,5,2,8,0,12,18,6,2,2,2,8738,8772,6
Task 8739,Job 0,3,10,4,10,1,7,13,6,4,1,2,8739,8772,13
Task 8739,Job 1,8,8,2,11,0,10,19,9,2,1,2,8739,8772,18
Task 8740,Job 0,6,4,1,9,0,7,15,8,1,1,2,8740,8774,19
Task 8740,Job 1,11,7,3,8,0,14,19,5,3,4,2,8740,8774,5
Task 8741,Job 0,7,10,3,7,0,10,14,4,3,2,2,8741,8775,6
Task 8741,Job 1,12,4,3,6,0,15,18,3,3,3,1,8741,8775,15
Task 8742,Job 0,10,10,3,10,0,13,20,7,3,1,1,8742,8775,3
Task 8742,Job 1,15,6,4,6,0,19,21,2,4,1,2,8742,8775,2
Task 8743,Job 0,10,4,1,8,1,11,18,7,1,2,2,8743,8776,12
Task 8743,Job 1,15,5,3,11,0,18,26,8,3,3,0,8743,8776,2
Task 8744,Job 0,3,9,2,6,0,5,9,4,2,1,1,8744,8777,7
Task 8744,Job 1,8,10,2,8,1,10,16,6,2,1,2,8744,8777,18
Task 8745,Job 0,8,9,3,10,0,11,18,7,3,2,2,8745,8778,19
Task 8745,Job 1,13,6,2,8,1,15,21,6,2,4,1,8745,8778,9
Task 8746,Job 0,6,7,1,7,0,7,13,6,1,4,1,8746,8779,16
Task 8746,Job 1,11,6,2,12,0,13,23,10,2,2,1,8746,8779,4
Task 8747,Job 0,9,6,4,11,0,13,20,7,4,1,1,8747,8780,19
Task 8747,Job 1,14,4,4,12,0,18,26,8,4,4,2,8747,8780,18
Task 8748,Job 0,7,10,2,12,0,9,19,10,2,2,1,8748,8781,10
Task 8748,Job 1,12,5,1,9,0,13,21,8,1,1,0,8748,8781,12
Task 8749,Job 0,10,6,2,7,0,12,17,5,2,4,2,8749,8783,19
Task 8749,Job 1,15,5,3,10,0,18,25,7,3,3,0,8749,8783,2
Task 8750,Job 0,3,6,2,10,1,5,13,8,2,3,0,8750,8784,8
Task 8750,Job 1,8,9,2,8,0,10,16,6,2,2,2,8750,8784,7
Task 8751,Job 0,9,4,1,8,0,10,17,7,1,1,0,8751,8785,13
Task 8751,Job 1,14,7,2,10,0,16,24,8,2,3,1,8751,8785,6
Task 8752,Job 0,2,5,1,11,0,3,13,10,1,3,2,8752,8786,10
Task 8752,Job 1,7,5,2,10,0,9,17,8,2,2,0,8752,8786,18
Task 8753,Job 0,4,10,4,12,1,8,16,8,4,4,2,8753,8786,2
Task 8753,Job 1,9,8,2,12,1,11,21,10,2,2,0,8753,8786,8
Task 8754,Job 0,4,9,3,8,1,7,12,5,3,3,0,8754,8787,18
Task 8754,Job 1,9,6,3,10,0,12,19,7,3,1,1,8754,8787,5
Task 8755,Job 0,7,9,4,6,1,11,13,2,4,2,0,8755,8788,3
Task 8755,Job 1,12,8,1,9,1,13,21,8,1,1,0,8755,8788,10
Task 8756,Job 0,5,10,2,11,1,7,16,9,2,3,2,8756,8790,3
Task 8756,Job 1,10,9,3,10,0,13,20,7,3,3,1,8756,8790,13
Task 8757,Job 0,10,8,2,6,1,12,16,4,2,1,2,8757,8791,12
Task 8757,Job 1,15,7,3,12,0,18,27,9,3,2,0,8757,8791,4
Task 8758,Job 0,9,10,1,7,0,10,16,6,1,4,2,8758,8792,8
Task 8758,Job 1,14,9,2,10,0,16,24,8,2,4,1,8758,8792,5
Task 8759,Job 0,9,10,2,12,0,11,21,10,2,1,2,8759,8792,17
Task 8759,Job 1,14,7,2,6,0,16,20,4,2,2,1,8759,8792,4
Task 8760,Job 0,6,4,2,11,0,8,17,9,2,3,0,8760,8794,18
Task 8760,Job 1,11,4,4,11,1,15,22,7,4,4,1,8760,8794,19
Task 8761,Job 0,3,6,1,9,0,4,12,8,1,1,2,8761,8795,19
Task 8761,Job 1,8,8,1,6,0,9,14,5,1,1,0,8761,8795,20
Task 8762,Job 0,9,6,1,6,0,10,15,5,1,2,1,8762,8796,18
Task 8762,Job 1,14,8,1,9,0,15,23,8,1,2,2,8762,8796,6
Task 8763,Job 0,3,4,3,12,1,6,15,9,3,3,1,8763,8797,2
Task 8763,Job 1,8,10,2,11,0,10,19,9,2,3,2,8763,8797,7
Task 8764,Job 0,5,6,4,10,0,9,15,6,4,2,1,8764,8797,20
Task 8764,Job 1,10,7,3,9,0,13,19,6,3,3,0,8764,8797,6
Task 8765,Job 0,1,5,3,9,0,4,10,6,3,4,2,8765,8798,17
Task 8765,Job 1,6,5,4,8,0,10,14,4,4,2,0,8765,8798,13
Task 8766,Job 0,7,4,3,8,0,10,15,5,3,3,2,8766,8800,12
Task 8766,Job 1,12,7,4,12,0,16,24,8,4,1,1,8766,8800,19
Task 8767,Job 0,1,5,4,9,0,5,10,5,4,4,2,8767,8800,16
Task 8767,Job 1,6,10,3,6,0,9,12,3,3,3,1,8767,8800,2
Task 8768,Job 0,3,4,1,6,0,4,9,5,1,1,2,8768,8801,19
Task 8768,Job 1,8,9,3,6,0,11,14,3,3,2,2,8768,8801,12
Task 8769,Job 0,8,8,1,9,0,9,17,8,1,1,2,8769,8803,2
Task 8769,Job 1,13,8,3,12,0,16,25,9,3,4,2,8769,8803,10
Task 8770,Job 0,4,6,1,10,1,5,14,9,1,2,2,8770,8803,10
Task 8770,Job 1,9,10,3,12,1,12,21,9,3,2,2,8770,8803,20
Task 8771,Job 0,2,4,3,7,0,5,9,4,3,4,0,8771,8804,6
Task 8771,Job 1,7,10,1,11,1,8,18,10,1,2,2,8771,8804,16
Task 8772,Job 0,1,8,3,12,0,4,13,9,3,4,2,8772,8806,19
Task 8772,Job 1,6,6,1,7,0,7,13,6,1,3,1,8772,8806,13
Task 8773,Job 0,10,4,4,8,0,14,18,4,4,2,1,8773,8807,4
Task 8773,Job 1,15,4,4,12,0,19,27,8,4,2,1,8773,8807,16
Task 8774,Job 0,10,9,3,8,0,13,18,5,3,4,0,8774,8808,13
Task 8774,Job 1,15,8,2,11,0,17,26,9,2,3,2,8774,8808,16
Task 8775,Job 0,2,10,4,8,1,6,10,4,4,2,1,8775,8808,12
Task 8775,Job 1,7,5,3,7,0,10,14,4,3,1,0,8775,8808,16
Task 8776,Job 0,10,10,4,6,1,14,16,2,4,2,1,8776,8810,20
Task 8776,Job 1,15,5,1,9,0,16,24,8,1,1,0,8776,8810,11
Task 8777,Job 0,8,6,3,11,0,11,19,8,3,2,1,8777,8810,13
Task 8777,Job 1,13,6,4,12,0,17,25,8,4,3,1,8777,8810,9
Task 8778,Job 0,10,8,2,10,0,12,20,8,2,1,2,8778,8811,20
Task 8778,Job 1,15,9,4,6,0,19,21,2,4,3,2,8778,8811,7
Task 8779,Job 0,2,6,2,6,0,4,8,4,2,2,0,8779,8812,7
Task 8779,Job 1,7,4,1,12,0,8,19,11,1,4,2,8779,8812,20
Task 8780,Job 0,4,8,4,8,1,8,12,4,4,3,2,8780,8814,11
Task 8780,Job 1,9,10,3,8,1,12,17,5,3,1,2,8780,8814,14
Task 8781,Job 0,3,4,3,9,0,6,12,6,3,1,2,8781,8814,4
Task 8781,Job 1,8,5,1,8,1,9,16,7,1,1,0,8781,8814,14
Task 8782,Job 0,1,6,3,10,1,4,11,7,3,2,2,8782,8816,5
Task 8782,Job 1,6,9,3,11,1,9,17,8,3,3,0,8782,8816,13
Task 8783,Job 0,10,5,1,6,0,11,16,5,1,2,1,8783,8816,6
Task 8783,Job 1,15,8,1,11,0,16,26,10,1,4,2,8783,8816,10
Task 8784,Job 0,1,9,4,7,0,5,8,3,4,3,0,8784,8817,19
Task 8784,Job 1,6,6,1,7,0,7,13,6,1,4,1,8784,8817,18
Task 8785,Job 0,1,9,2,9,0,3,10,7,2,2,2,8785,8818,18
Task 8785,Job 1,6,7,2,8,0,8,14,6,2,2,2,8785,8818,12
Task 8786,Job 0,8,9,2,10,0,10,18,8,2,2,0,8786,8820,17
Task 8786,Job 1,13,5,1,6,1,14,19,5,1,1,2,8786,8820,18
Task 8787,Job 0,7,6,3,9,0,10,16,6,3,3,2,8787,8820,14
Task 8787,Job 1,12,4,3,11,0,15,23,8,3,2,0,8787,8820,18
Task 8788,Job 0,3,10,1,10,0,4,13,9,1,3,0,8788,8821,15
Task 8788,Job 1,8,10,4,6,0,12,14,2,4,3,0,8788,8821,2
Task 8789,Job 0,7,10,2,11,0,9,18,9,2,4,2,8789,8822,2
Task 8789,Job 1,12,10,3,11,0,15,23,8,3,3,2,8789,8822,8
Task 8790,Job 0,6,5,3,12,1,9,18,9,3,3,2,8790,8824,13
Task 8790,Job 1,11,10,2,12,0,13,23,10,2,2,0,8790,8824,9
Task 8791,Job 0,7,5,3,12,0,10,19,9,3,3,0,8791,8824,6
Task 8791,Job 1,12,7,4,7,1,16,19,3,4,1,2,8791,8824,19
Task 8792,Job 0,4,9,1,9,1,5,13,8,1,3,0,8792,8825,19
Task 8792,Job 1,9,8,2,12,0,11,21,10,2,4,2,8792,8825,17
Task 8793,Job 0,1,5,4,8,0,5,9,4,4,2,2,8793,8827,17
Task 8793,Job 1,6,9,3,12,0,9,18,9,3,2,2,8793,8827,4
Task 8794,Job 0,6,8,1,11,0,7,17,10,1,3,2,8794,8827,20
Task 8794,Job 1,11,10,2,9,1,13,20,7,2,3,1,8794,8827,6
Task 8795,Job 0,4,9,2,9,0,6,13,7,2,1,2,8795,8829,13
Task 8795,Job 1,9,10,4,8,1,13,17,4,4,3,2,8795,8829,11
Task 8796,Job 0,4,5,2,12,0,6,16,10,2,1,0,8796,8829,6
Task 8796,Job 1,9,5,4,12,0,13,21,8,4,2,1,8796,8829,4
Task 8797,Job 0,10,4,4,6,0,14,16,2,4,4,1,8797,8830,5
Task 8797,Job 1,15,6,2,9,1,17,24,7,2,1,2,8797,8830,2
Task 8798,Job 0,4,6,4,12,0,8,16,8,4,2,2,8798,8831,13
Task 8798,Job 1,9,4,2,7,1,11,16,5,2,1,1,8798,8831,2
Task 8799,Job 0,2,10,3,10,0,5,12,7,3,3,0,8799,8832,10
Task 8799,Job 1,7,7,1,7,0,8,14,6,1,1,1,8799,8832,17
Task 8800,Job 0,9,5,3,12,0,12,21,9,3,4,0,8800,8834,15
Task 8800,Job 1,14,10,1,8,0,15,22,7,1,1,2,8800,8834,14
Task 8801,Job 0,2,10,2,6,0,4,8,4,2,2,1,8801,8834,11
Task 8801,Job 1,7,5,3,12,0,10,19,9,3,2,1,8801,8834,16
Task 8802,Job 0,4,4,2,7,1,6,11,5,2,3,0,8802,8836,7
Task 8802,Job 1,9,8,1,9,0,10,18,8,1,2,1,8802,8836,3
Task 8803,Job 0,2,5,4,12,0,6,14,8,4,1,0,8803,8836,17
Task 8803,Job 1,7,6,4,7,0,11,14,3,4,4,2,8803,8836,4
Task 8804,Job 0,5,10,3,9,0,8,14,6,3,1,0,8804,8838,13
Task 8804,Job 1,10,7,1,6,0,11,16,5,1,2,1,8804,8838,5
Task 8805,Job 0,6,4,2,10,0,8,16,8,2,1,0,8805,8838,14
Task 8805,Job 1,11,8,3,7,0,14,18,4,3,3,1,8805,8838,6
Task 8806,Job 0,5,6,3,9,0,8,14,6,3,4,1,8806,8839,8
Task 8806,Job 1,10,8,1,9,0,11,19,8,1,3,1,8806,8839,6
Task 8807,Job 0,9,5,3,10,1,12,19,7,3,4,0,8807,8840,3
Task 8807,Job 1,14,7,1,7,0,15,21,6,1,2,2,8807,8840,7
Task 8808,Job 0,4,9,1,6,0,5,10,5,1,4,0,8808,8841,9
Task 8808,Job 1,9,7,2,7,0,11,16,5,2,2,2,8808,8841,12
Task 8809,Job 0,9,5,3,6,0,12,15,3,3,4,1,8809,8843,12
Task 8809,Job 1,14,9,1,7,1,15,21,6,1,4,0,8809,8843,9
Task 8810,Job 0,5,10,4,7,0,9,12,3,4,4,0,8810,8843,12
Task 8810,Job 1,10,8,3,8,0,13,18,5,3,4,2,8810,8843,3
Task 8811,Job 0,10,10,2,7,0,12,17,5,2,4,0,8811,8845,2
Task 8811,Job 1,15,8,1,6,1,16,21,5,1,3,0,8811,8845,11
Task 8812,Job 0,2,10,3,12,0,5,14,9,3,3,0,8812,8845,8
Task 8812,Job 1,7,5,2,9,0,9,16,7,2,1,2,8812,8845,20
Task 8813,Job 0,4,10,3,11,0,7,15,8,3,4,1,8813,8846,2
Task 8813,Job 1,9,4,3,9,0,12,18,6,3,4,2,8813,8846,17
Task 8814,Job 0,7,6,3,9,0,10,16,6,3,1,1,8814,8847,3
Task 8814,Job 1,12,4,4,10,0,16,22,6,4,4,2,8814,8847,14
Task 8815,Job 0,8,7,1,9,0,9,17,8,1,3,0,8815,8849,16
Task 8815,Job 1,13,6,4,8,1,17,21,4,4,1,2,8815,8849,12
Task 8816,Job 0,5,7,3,11,1,8,16,8,3,4,0,8816,8850,9
Task 8816,Job 1,10,7,4,7,0,14,17,3,4,4,2,8816,8850,3
Task 8817,Job 0,7,7,3,9,1,10,16,6,3,3,0,8817,8850,4
Task 8817,Job 1,12,6,3,10,1,15,22,7,3,2,2,8817,8850,2
Task 8818,Job 0,6,9,1,6,0,7,12,5,1,1,2,8818,8851,17
Task 8818,Job 1,11,4,4,9,0,15,20,5,4,1,2,8818,8851,12
Task 8819,Job 0,10,6,1,12,0,11,22,11,1,4,2,8819,8853,17
Task 8819,Job 1,15,7,3,6,0,18,21,3,3,4,2,8819,8853,18
Task 8820,Job 0,4,8,1,6,1,5,10,5,1,2,0,8820,8854,5
Task 8820,Job 1,9,5,2,10,0,11,19,8,2,2,1,8820,8854,19
Task 8821,Job 0,8,9,2,12,1,10,20,10,2,3,1,8821,8854,10
Task 8821,Job 1,13,5,3,10,0,16,23,7,3,3,1,8821,8854,15
Task 8822,Job 0,1,7,2,10,0,3,11,8,2,4,1,8822,8855,10
Task 8822,Job 1,6,10,4,11,0,10,17,7,4,4,2,8822,8855,7
Task 8823,Job 0,4,7,1,8,0,5,12,7,1,2,2,8823,8857,15
Task 8823,Job 1,9,4,3,12,0,12,21,9,3,4,2,8823,8857,10
Task 8824,Job 0,4,10,2,12,0,6,16,10,2,3,1,8824,8858,11
Task 8824,Job 1,9,7,4,12,0,13,21,8,4,2,0,8824,8858,14
Task 8825,Job 0,7,4,2,6,0,9,13,4,2,1,1,8825,8859,10
Task 8825,Job 1,12,4,3,11,1,15,23,8,3,4,2,8825,8859,17
Task 8826,Job 0,6,10,4,11,0,10,17,7,4,1,2,8826,8860,12
Task 8826,Job 1,11,7,2,9,1,13,20,7,2,4,1,8826,8860,5
Task 8827,Job 0,5,9,3,7,0,8,12,4,3,1,1,8827,8860,18
Task 8827,Job 1,10,4,2,6,1,12,16,4,2,3,2,8827,8860,3
Task 8828,Job 0,10,4,3,7,1,13,17,4,3,1,1,8828,8862,9
Task 8828,Job 1,15,8,2,7,0,17,22,5,2,4,0,8828,8862,4
Task 8829,Job 0,1,7,1,10,1,2,11,9,1,3,1,8829,8863,19
Task 8829,Job 1,6,5,3,10,1,9,16,7,3,2,2,8829,8863,9
Task 8830,Job 0,4,6,1,7,1,5,11,6,1,2,0,8830,8863,18
Task 8830,Job 1,9,9,3,6,1,12,15,3,3,2,2,8830,8863,18
Task 8831,Job 0,9,5,3,9,0,12,18,6,3,4,2,8831,8864,5
Task 8831,Job 1,14,8,3,9,0,17,23,6,3,4,0,8831,8864,14
Task 8832,Job 0,7,10,2,12,0,9,19,10,2,4,2,8832,8866,7
Task 8832,Job 1,12,5,2,6,1,14,18,4,2,4,2,8832,8866,8
Task 8833,Job 0,6,10,3,9,0,9,15,6,3,1,2,8833,8866,15
Task 8833,Job 1,11,7,3,6,0,14,17,3,3,1,2,8833,8866,7
Task 8834,Job 0,7,4,1,12,0,8,19,11,1,4,2,8834,8867,5
Task 8834,Job 1,12,4,4,6,0,16,18,2,4,1,0,8834,8867,15
Task 8835,Job 0,3,8,1,11,0,4,14,10,1,4,1,8835,8869,2
Task 8835,Job 1,8,5,4,8,1,12,16,4,4,4,1,8835,8869,6
Task 8836,Job 0,6,10,4,7,1,10,13,3,4,3,2,8836,8870,4
Task 8836,Job 1,11,10,1,10,1,12,21,9,1,2,2,8836,8870,5
Task 8837,Job 0,10,9,1,6,0,11,16,5,1,1,2,8837,8870,5
Task 8837,Job 1,15,5,1,12,0,16,27,11,1,4,1,8837,8870,18
Task 8838,Job 0,5,10,2,10,0,7,15,8,2,4,0,8838,8872,18
Task 8838,Job 1,10,4,1,12,0,11,22,11,1,3,1,8838,8872,12
Task 8839,Job 0,5,6,3,6,0,8,11,3,3,2,0,8839,8872,8
Task 8839,Job 1,10,4,2,9,0,12,19,7,2,4,0,8839,8872,18
Task 8840,Job 0,5,7,1,7,0,6,12,6,1,3,1,8840,8873,10
Task 8840,Job 1,10,8,1,11,0,11,21,10,1,1,0,8840,8873,20
Task 8841,Job 0,10,8,1,8,0,11,18,7,1,4,0,8841,8875,6
Task 8841,Job 1,15,9,3,6,0,18,21,3,3,2,2,8841,8875,19
Task 8842,Job 0,5,9,4,7,1,9,12,3,4,3,2,8842,8876,11
Task 8842,Job 1,10,10,3,7,0,13,17,4,3,3,0,8842,8876,14
Task 8843,Job 0,1,7,3,10,0,4,11,7,3,1,2,8843,8877,10
Task 8843,Job 1,6,6,3,10,0,9,16,7,3,2,1,8843,8877,16
Task 8844,Job 0,10,7,2,6,0,12,16,4,2,4,2,8844,8877,9
Task 8844,Job 1,15,9,2,11,0,17,26,9,2,3,0,8844,8877,3
Task 8845,Job 0,8,7,1,7,0,9,15,6,1,1,2,8845,8879,4
Task 8845,Job 1,13,5,2,11,1,15,24,9,2,2,0,8845,8879,18
Task 8846,Job 0,1,9,1,11,1,2,12,10,1,2,0,8846,8880,18
Task 8846,Job 1,6,8,4,10,0,10,16,6,4,2,2,8846,8880,12
Task 8847,Job 0,3,9,1,9,0,4,12,8,1,2,1,8847,8880,10
Task 8847,Job 1,8,8,3,11,0,11,19,8,3,2,2,8847,8880,5
Task 8848,Job 0,4,7,3,11,0,7,15,8,3,3,2,8848,8882,12
Task 8848,Job 1,9,10,1,7,0,10,16,6,1,1,1,8848,8882,8
Task 8849,Job 0,10,4,4,10,1,14,20,6,4,1,2,8849,8883,16
Task 8849,Job 1,15,7,3,8,0,18,23,5,3,3,2,8849,8883,10
Task 8850,Job 0,5,6,2,11,0,7,16,9,2,4,2,8850,8884,16
Task 8850,Job 1,10,7,4,6,1,14,16,2,4,3,2,8850,8884,19
Task 8851,Job 0,10,7,3,8,0,13,18,5,3,1,1,8851,8885,12
Task 8851,Job 1,15,10,3,7,0,18,22,4,3,1,0,8851,8885,6
Task 8852,Job 0,9,4,4,9,1,13,18,5,4,2,0,8852,8886,10
Task 8852,Job 1,14,5,2,12,0,16,26,10,2,1,0,8852,8886,4
Task 8853,Job 0,7,5,2,10,0,9,17,8,2,3,2,8853,8887,11
Task 8853,Job 1,12,8,4,10,0,16,22,6,4,1,0,8853,8887,14
Task 8854,Job 0,4,6,4,12,1,8,16,8,4,3,0,8854,8888,18
Task 8854,Job 1,9,9,1,10,0,10,19,9,1,4,1,8854,8888,16
Task 8855,Job 0,10,9,2,6,0,12,16,4,2,4,0,8855,8888,9
Task 8855,Job 1,15,9,1,12,0,16,27,11,1,4,2,8855,8888,19
Task 8856,Job 0,3,4,2,12,0,5,15,10,2,2,1,8856,8890,10
Task 8856,Job 1,8,9,4,12,1,12,20,8,4,3,2,8856,8890,9
Task 8857,Job 0,1,5,4,10,0,5,11,6,4,2,1,8857,8891,14
Task 8857,Job 1,6,5,2,8,0,8,14,6,2,2,1,8857,8891,15
Task 8858,Job 0,6,10,4,10,0,10,16,6,4,1,2,8858,8892,13
Task 8858,Job 1,11,10,3,12,0,14,23,9,3,3,2,8858,8892,6
Task 8859,Job 0,10,6,3,7,1,13,17,4,3,3,0,8859,8892,20
Task 8859,Job 1,15,6,4,12,0,19,27,8,4,2,2,8859,8892,14
Task 8860,Job 0,6,4,2,11,1,8,17,9,2,4,2,8860,8894,4
Task 8860,Job 1,11,10,3,10,0,14,21,7,3,3,0,8860,8894,16
Task 8861,Job 0,2,6,4,11,0,6,13,7,4,3,0,8861,8895,18
Task 8861,Job 1,7,10,1,10,0,8,17,9,1,2,2,8861,8895,3
Task 8862,Job 0,5,6,3,7,0,8,12,4,3,4,2,8862,8895,12
Task 8862,Job 1,10,5,2,7,0,12,17,5,2,1,1,8862,8895,8
Task 8863,Job 0,9,9,4,9,0,13,18,5,4,2,1,8863,8896,11
Task 8863,Job 1,14,5,4,10,0,18,24,6,4,1,2,8863,8896,2
Task 8864,Job 0,2,5,3,10,0,5,12,7,3,4,2,8864,8897,10
Task 8864,Job 1,7,7,1,10,0,8,17,9,1,3,1,8864,8897,10
Task 8865,Job 0,10,10,2,6,0,12,16,4,2,2,1,8865,8899,14
Task 8865,Job 1,15,6,3,12,1,18,27,9,3,1,0,8865,8899,14
Task 8866,Job 0,7,9,2,11,0,9,18,9,2,4,1,8866,8900,16
Task 8866,Job 1,12,6,1,10,0,13,22,9,1,4,1,8866,8900,13
Task 8867,Job 0,4,6,4,11,0,8,15,7,4,2,1,8867,8901,17
Task 8867,Job 1,9,6,2,7,0,11,16,5,2,2,0,8867,8901,18
Task 8868,Job 0,2,10,4,9,0,6,11,5,4,2,0,8868,8902,12
Task 8868,Job 1,7,5,4,12,1,11,19,8,4,3,0,8868,8902,4
Task 8869,Job 0,8,5,2,9,0,10,17,7,2,2,2,8869,8903,20
Task 8869,Job 1,13,8,1,8,0,14,21,7,1,4,2,8869,8903,13
Task 8870,Job 0,1,7,2,9,1,3,10,7,2,2,2,8870,8903,3
Task 8870,Job 1,6,8,4,10,0,10,16,6,4,4,1,8870,8903,4
Task 8871,Job 0,9,5,3,8,0,12,17,5,3,4,1,8871,8905,10
Task 8871,Job 1,14,7,4,12,1,18,26,8,4,2,1,8871,8905,11
Task 8872,Job 0,2,10,4,9,0,6,11,5,4,2,0,8872,8905,9
Task 8872,Job 1,7,7,2,10,0,9,17,8,2,3,1,8872,8905,11
Task 8873,Job 0,8,8,4,11,1,12,19,7,4,3,2,8873,8906,14
Task 8873,Job 1,13,7,3,9,0,16,22,6,3,4,0,8873,8906,14
Task 8874,Job 0,1,5,4,6,0,5,7,2,4,3,1,8874,8908,12
Task 8874,Job 1,6,9,3,8,0,9,14,5,3,3,1,8874,8908,4
Task 8875,Job 0,1,10,3,8,0,4,9,5,3,3,0,8875,8908,11
Task 8875,Job 1,6,7,1,10,1,7,16,9,1,1,0,8875,8908,10
Task 8876,Job 0,7,6,4,10,0,11,17,6,4,1,1,8876,8910,18
Task 8876,Job 1,12,4,4,10,0,16,22,6,4,1,2,8876,8910,19
Task 8877,Job 0,3,6,1,12,1,4,15,11,1,3,1,8877,8911,16
Task 8877,Job 1,8,4,1,7,1,9,15,6,1,4,2,8877,8911,4
Task 8878,Job 0,6,7,4,12,0,10,18,8,4,3,2,8878,8911,7
Task 8878,Job 1,11,8,1,12,0,12,23,11,1,4,2,8878,8911,4
Task 8879,Job 0,6,10,1,8,0,7,14,7,1,3,2,8879,8913,12
Task 8879,Job 1,11,5,2,11,0,13,22,9,2,3,0,8879,8913,6
Task 8880,Job 0,10,5,1,12,0,11,22,11,1,4,2,8880,8914,11
Task 8880,Job 1,15,5,4,7,0,19,22,3,4,3,1,8880,8914,10
Task 8881,Job 0,9,4,4,11,0,13,20,7,4,1,0,8881,8915,9
Task 8881,Job 1,14,6,1,10,0,15,24,9,1,3,1,8881,8915,13
Task 8882,Job 0,3,10,2,10,0,5,13,8,2,4,2,8882,8915,17
Task 8882,Job 1,8,9,1,6,1,9,14,5,1,4,1,8882,8915,13
Task 8883,Job 0,9,4,2,11,1,11,20,9,2,3,1,8883,8917,12
Task 8883,Job 1,14,9,3,10,0,17,24,7,3,4,0,8883,8917,7
Task 8884,Job 0,3,4,1,12,0,4,15,11,1,2,2,8884,8917,9
Task 8884,Job 1,8,5,2,8,0,10,16,6,2,2,0,8884,8917,19
Task 8885,Job 0,2,6,1,10,0,3,12,9,1,3,0,8885,8918,9
Task 8885,Job 1,7,4,1,6,0,8,13,5,1,3,2,8885,8918,17
Task 8886,Job 0,8,5,2,8,0,10,16,6,2,1,1,8886,8920,3
Task 8886,Job 1,13,7,1,7,0,14,20,6,1,4,2,8886,8920,5
Task 8887,Job 0,4,5,4,6,0,8,10,2,4,2,1,8887,8920,20
Task 8887,Job 1,9,7,3,10,0,12,19,7,3,3,2,8887,8920,18
Task 8888,Job 0,1,4,2,8,1,3,9,6,2,2,0,8888,8922,16
Task 8888,Job 1,6,5,2,10,0,8,16,8,2,4,0,8888,8922,2
Task 8889,Job 0,3,7,1,12,0,4,15,11,1,2,0,8889,8923,16
Task 8889,Job 1,8,8,2,11,0,10,19,9,2,3,2,8889,8923,16
Task 8890,Job 0,5,6,1,12,0,6,17,11,1,2,0,8890,8924,12
Task 8890,Job 1,10,6,2,12,0,12,22,10,2,3,1,8890,8924,20
Task 8891,Job 0,10,9,1,10,0,11,20,9,1,4,1,8891,8924,5
Task 8891,Job 1,15,10,2,11,0,17,26,9,2,4,2,8891,8924,5
Task 8892,Job 0,10,10,1,8,0,11,18,7,1,1,0,8892,8926,16
Task 8892,Job 1,15,6,1,6,0,16,21,5,1,4,2,8892,8926,10
Task 8893,Job 0,1,9,3,10,1,4,11,7,3,3,0,8893,8926,15
Task 8893,Job 1,6,4,4,9,0,10,15,5,4,4,2,8893,8926,15
Task 8894,Job 0,7,10,2,10,1,9,17,8,2,4,0,8894,8927,12
Task 8894,Job 1,12,8,1,9,0,13,21,8,1,4,0,8894,8927,3
Task 8895,Job 0,7,8,4,8,1,11,15,4,4,4,2,8895,8928,9
Task 8895,Job 1,12,6,2,12,0,14,24,10,2,2,2,8895,8928,9
Task 8896,Job 0,4,10,1,11,1,5,15,10,1,2,1,8896,8929,7
Task 8896,Job 1,9,10,2,6,0,11,15,4,2,2,0,8896,8929,5
Task 8897,Job 0,5,10,2,8,0,7,13,6,2,4,0,8897,8931,5
Task 8897,Job 1,10,8,3,12,0,13,22,9,3,3,0,8897,8931,18
Task 8898,Job 0,6,9,1,12,0,7,18,11,1,3,0,8898,8931,7
Task 8898,Job 1,11,4,4,6,0,15,17,2,4,4,2,8898,8931,4
Task 8899,Job 0,7,6,2,6,0,9,13,4,2,2,1,8899,8932,18
Task 8899,Job 1,12,5,3,12,0,15,24,9,3,2,0,8899,8932,6
Task 8900,Job 0,10,6,1,8,0,11,18,7,1,2,1,8900,8934,14
Task 8900,Job 1,15,10,4,6,0,19,21,2,4,3,2,8900,8934,7
Task 8901,Job 0,4,4,1,6,0,5,10,5,1,3,2,8901,8935,13
Task 8901,Job 1,9,5,3,8,0,12,17,5,3,1,1,8901,8935,7
Task 8902,Job 0,10,7,2,11,0,12,21,9,2,3,0,8902,8935,18
Task 8902,Job 1,15,6,1,10,0,16,25,9,1,3,0,8902,8935,10
Task 8903,Job 0,7,6,2,11,1,9,18,9,2,4,1,8903,8936,14
Task 8903,Job 1,12,4,1,7,0,13,19,6,1,3,0,8903,8936,6
Task 8904,Job 0,9,6,2,9,0,11,18,7,2,3,1,8904,8938,10
Task 8904,Job 1,14,6,1,10,0,15,24,9,1,3,0,8904,8938,19
Task 8905,Job 0,4,10,1,10,0,5,14,9,1,3,0,8905,8938,17
Task 8905,Job 1,9,10,2,7,0,11,16,5,2,1,2,8905,8938,14
Task 8906,Job 0,5,7,3,11,1,8,16,8,3,3,1,8906,8939,15
Task 8906,Job 1,10,7,2,11,0,12,21,9,2,1,2,8906,8939,20
Task 8907,Job 0,6,4,3,11,0,9,17,8,3,1,1,8907,8941,15
Task 8907,Job 1,11,9,1,9,0,12,20,8,1,1,2,8907,8941,17
Task 8908,Job 0,7,5,4,10,0,11,17,6,4,3,2,8908,8941,17
Task 8908,Job 1,12,7,3,8,0,15,20,5,3,3,1,8908,8941,3
Task 8909,Job 0,4,7,4,9,1,8,13,5,4,3,0,8909,8943,18
Task 8909,Job 1,9,10,2,12,0,11,21,10,2,2,1,8909,8943,11
Task 8910,Job 0,4,10,4,8,0,8,12,4,4,3,1,8910,8944,6
Task 8910,Job 1,9,5,2,10,1,11,19,8,2,1,1,8910,8944,8
Task 8911,Job 0,10,5,1,11,0,11,21,10,1,1,1,8911,8945,13
Task 8911,Job 1,15,5,1,7,1,16,22,6,1,3,0,8911,8945,18
Task 8912,Job 0,9,5,1,7,1,10,16,6,1,1,1,8912,8946,17
Task 8912,Job 1,14,9,4,6,0,18,20,2,4,1,0,8912,8946,18
Task 8913,Job 0,9,10,1,12,0,10,21,11,1,2,0,8913,8947,7
Task 8913,Job 1,14,8,3,10,0,17,24,7,3,2,1,8913,8947,6
Task 8914,Job 0,3,10,3,9,0,6,12,6,3,4,0,8914,8947,13
Task 8914,Job 1,8,8,4,8,1,12,16,4,4,4,0,8914,8947,14
Task 8915,Job 0,10,7,3,11,0,13,21,8,3,4,2,8915,8949,3
Task 8915,Job 1,15,9,4,9,0,19,24,5,4,3,1,8915,8949,19
Task 8916,Job 0,4,6,2,9,0,6,13,7,2,3,2,8916,8950,14
Task 8916,Job 1,9,6,3,8,1,12,17,5,3,1,1,8916,8950,6
Task 8917,Job 0,2,10,1,7,0,3,9,6,1,1,1,8917,8951,4
Task 8917,Job 1,7,6,4,9,0,11,16,5,4,2,0,8917,8951,10
Task 8918,Job 0,8,7,3,8,0,11,16,5,3,1,0,8918,8952,16
Task 8918,Job 1,13,6,4,11,1,17,24,7,4,1,2,8918,8952,4
Task 8919,Job 0,4,5,3,11,0,7,15,8,3,1,1,8919,8953,3
Task 8919,Job 1,9,6,3,7,0,12,16,4,3,3,1,8919,8953,7
Task 8920,Job 0,8,7,1,12,0,9,20,11,1,3,0,8920,8953,16
Task 8920,Job 1,13,6,1,8,0,14,21,7,1,2,0,8920,8953,6
Task 8921,Job 0,10,4,2,9,0,12,19,7,2,2,1,8921,8955,20
Task 8921,Job 1,15,9,1,7,1,16,22,6,1,2,1,8921,8955,15
Task 8922,Job 0,3,5,2,12,0,5,15,10,2,1,2,8922,8956,5
Task 8922,Job 1,8,7,3,9,0,11,17,6,3,1,0,8922,8956,8
Task 8923,Job 0,2,6,3,10,0,5,12,7,3,2,2,8923,8957,20
Task 8923,Job 1,7,5,4,6,1,11,13,2,4,3,0,8923,8957,10
Task 8924,Job 0,6,6,1,9,1,7,15,8,1,3,0,8924,8957,3
Task 8924,Job 1,11,10,1,8,1,12,19,7,1,2,2,8924,8957,8
Task 8925,Job 0,8,4,4,12,0,12,20,8,4,3,2,8925,8959,12
Task 8925,Job 1,13,4,1,10,0,14,23,9,1,4,2,8925,8959,16
Task 8926,Job 0,7,10,4,8,0,11,15,4,4,1,0,8926,8959,10
Task 8926,Job 1,12,4,1,10,0,13,22,9,1,1,0,8926,8959,19
Task 8927,Job 0,4,7,1,10,0,5,14,9,1,4,1,8927,8961,6
Task 8927,Job 1,9,8,4,7,0,13,16,3,4,4,2,8927,8961,14
Task 8928,Job 0,10,7,3,10,0,13,20,7,3,3,1,8928,8961,3
Task 8928,Job 1,15,6,3,11,0,18,26,8,3,1,0,8928,8961,2
Task 8929,Job 0,5,9,3,7,0,8,12,4,3,2,1,8929,8963,19
Task 8929,Job 1,10,7,1,8,0,11,18,7,1,3,0,8929,8963,13
Task 8930,Job 0,7,6,4,10,0,11,17,6,4,4,2,8930,8964,19
Task 8930,Job 1,12,8,2,10,0,14,22,8,2,1,2,8930,8964,14
Task 8931,Job 0,7,4,4,12,0,11,19,8,4,3,1,8931,8965,13
Task 8931,Job 1,12,6,1,12,0,13,24,11,1,4,0,8931,8965,15
Task 8932,Job 0,5,5,2,7,1,7,12,5,2,3,2,8932,8965,7
Task 8932,Job 1,10,4,4,12,1,14,22,8,4,1,2,8932,8965,2
Task 8933,Job 0,10,8,2,10,1,12,20,8,2,2,1,8933,8967,4
Task 8933,Job 1,15,8,3,9,1,18,24,6,3,3,0,8933,8967,9
Task 8934,Job 0,10,8,2,7,0,12,17,5,2,4,0,8934,8967,3
Task 8934,Job 1,15,9,1,10,1,16,25,9,1,4,1,8934,8967,15
Task 8935,Job 0,8,10,3,8,0,11,16,5,3,3,0,8935,8968,20
Task 8935,Job 1,13,8,4,9,0,17,22,5,4,3,0,8935,8968,15
Task 8936,Job 0,3,6,1,6,0,4,9,5,1,4,1,8936,8970,2
Task 8936,Job 1,8,8,4,6,0,12,14,2,4,2,0,8936,8970,19
Task 8937,Job 0,10,4,3,9,0,13,19,6,3,1,1,8937,8971,2
Task 8937,Job 1,15,5,2,6,0,17,21,4,2,2,2,8937,8971,7
Task 8938,Job 0,2,9,3,10,0,5,12,7,3,2,1,8938,8971,16
Task 8938,Job 1,7,6,3,8,0,10,15,5,3,3,2,8938,8971,20
Task 8939,Job 0,1,5,4,12,0,5,13,8,4,4,1,8939,8972,5
Task 8939,Job 1,6,10,1,12,1,7,18,11,1,3,0,8939,8972,8
Task 8940,Job 0,1,7,3,8,0,4,9,5,3,4,0,8940,8974,11
Task 8940,Job 1,6,7,1,9,1,7,15,8,1,1,0,8940,8974,4
Task 8941,Job 0,8,7,3,8,0,11,16,5,3,4,0,8941,8975,6
Task 8941,Job 1,13,8,4,6,0,17,19,2,4,1,0,8941,8975,7
Task 8942,Job 0,7,9,2,7,0,9,14,5,2,4,2,8942,8976,13
Task 8942,Job 1,12,5,2,9,0,14,21,7,2,2,0,8942,8976,12
Task 8943,Job 0,4,8,2,9,0,6,13,7,2,1,0,8943,8977,19
Task 8943,Job 1,9,6,1,6,0,10,15,5,1,4,2,8943,8977,17
Task 8944,Job 0,3,7,3,11,1,6,14,8,3,3,1,8944,8978,3
Task 8944,Job 1,8,5,1,12,0,9,20,11,1,4,2,8944,8978,17
Task 8945,Job 0,7,7,2,12,1,9,19,10,2,4,1,8945,8979,2
Task 8945,Job 1,12,10,3,7,0,15,19,4,3,2,1,8945,8979,8
Task 8946,Job 0,1,8,4,6,1,5,7,2,4,2,0,8946,8979,18
Task 8946,Job 1,6,6,1,9,0,7,15,8,1,3,1,8946,8979,14
Task 8947,Job 0,2,5,1,6,0,3,8,5,1,1,0,8947,8981,20
Task 8947,Job 1,7,7,3,9,0,10,16,6,3,3,1,8947,8981,8
Task 8948,Job 0,6,7,3,10,0,9,16,7,3,4,0,8948,8982,9
Task 8948,Job 1,11,4,4,7,0,15,18,3,4,1,1,8948,8982,8
Task 8949,Job 0,10,4,3,7,1,13,17,4,3,1,2,8949,8982,7
Task 8949,Job 1,15,10,4,6,1,19,21,2,4,2,0,8949,8982,5
Task 8950,Job 0,7,5,1,6,0,8,13,5,1,3,2,8950,8984,10
Task 8950,Job 1,12,5,2,12,1,14,24,10,2,3,1,8950,8984,15
Task 8951,Job 0,4,10,4,11,0,8,15,7,4,2,1,8951,8985,20
Task 8951,Job 1,9,9,3,6,0,12,15,3,3,1,0,8951,8985,16
Task 8952,Job 0,5,6,3,8,0,8,13,5,3,4,1,8952,8986,13
Task 8952,Job 1,10,8,2,6,0,12,16,4,2,1,1,8952,8986,7
Task 8953,Job 0,6,10,3,11,1,9,17,8,3,2,2,8953,8987,4
Task 8953,Job 1,11,4,3,11,0,14,22,8,3,3,1,8953,8987,6
Task 8954,Job 0,1,4,3,11,0,4,12,8,3,4,2,8954,8987,5
Task 8954,Job 1,6,10,4,8,0,10,14,4,4,2,2,8954,8987,4
Task 8955,Job 0,4,9,4,11,1,8,15,7,4,4,0,8955,8988,11
Task 8955,Job 1,9,7,3,12,1,12,21,9,3,4,1,8955,8988,13
Task 8956,Job 0,3,10,1,6,0,4,9,5,1,1,1,8956,8990,18
Task 8956,Job 1,8,8,2,9,0,10,17,7,2,2,0,8956,8990,4
Task 8957,Job 0,3,7,2,12,1,5,15,10,2,1,0,8957,8990,4
Task 8957,Job 1,8,7,4,10,0,12,18,6,4,2,1,8957,8990,13
Task 8958,Job 0,10,5,2,9,0,12,19,7,2,1,2,8958,8992,4
Task 8958,Job 1,15,5,3,12,0,18,27,9,3,1,0,8958,8992,2
Task 8959,Job 0,1,5,3,7,0,4,8,4,3,1,1,8959,8993,4
Task 8959,Job 1,6,6,1,6,0,7,12,5,1,4,2,8959,8993,3
Task 8960,Job 0,4,7,3,12,0,7,16,9,3,1,2,8960,8993,11
Task 8960,Job 1,9,4,4,12,0,13,21,8,4,4,1,8960,8993,12
Task 8961,Job 0,3,5,3,9,0,6,12,6,3,4,0,8961,8994,5
Task 8961,Job 1,8,5,4,6,1,12,14,2,4,4,1,8961,8994,8
Task 8962,Job 0,3,8,4,8,1,7,11,4,4,1,0,8962,8995,10
Task 8962,Job 1,8,6,1,6,0,9,14,5,1,4,2,8962,8995,5
Task 8963,Job 0,1,6,4,11,0,5,12,7,4,2,1,8963,8996,16
Task 8963,Job 1,6,10,1,8,1,7,14,7,1,1,0,8963,8996,12
Task 8964,Job 0,4,10,1,11,1,5,15,10,1,2,1,8964,8998,2
Task 8964,Job 1,9,8,4,8,0,13,17,4,4,2,0,8964,8998,11
Task 8965,Job 0,3,7,3,9,0,6,12,6,3,4,0,8965,8999,9
Task 8965,Job 1,8,6,1,8,0,9,16,7,1,1,2,8965,8999,20
Task 8966,Job 0,9,4,3,6,0,12,15,3,3,1,2,8966,8999,15
Task 8966,Job 1,14,8,2,12,0,16,26,10,2,3,2,8966,8999,10
Task 8967,Job 0,7,7,2,12,1,9,19,10,2,3,2,8967,9000,4
Task 8967,Job 1,12,5,2,9,0,14,21,7,2,1,1,8967,9000,8
Task 8968,Job 0,4,10,4,10,1,8,14,6,4,1,0,8968,9002,4
Task 8968,Job 1,9,9,2,7,1,11,16,5,2,1,2,8968,9002,3
Task 8969,Job 0,7,4,1,7,1,8,14,6,1,1,2,8969,9002,4
Task 8969,Job 1,12,4,2,6,0,14,18,4,2,4,2,8969,9002,2
Task 8970,Job 0,1,9,4,7,1,5,8,3,4,2,2,8970,9003,8
Task 8970,Job 1,6,6,1,8,0,7,14,7,1,2,2,8970,9003,18
Task 8971,Job 0,6,9,1,6,0,7,12,5,1,4,1,8971,9004,20
Task 8971,Job 1,11,6,2,8,0,13,19,6,2,2,0,8971,9004,6
Task 8972,Job 0,5,8,3,11,1,8,16,8,3,2,2,8972,9006,18
Task 8972,Job 1,10,10,3,6,0,13,16,3,3,1,2,8972,9006,17
Task 8973,Job 0,5,5,3,11,0,8,16,8,3,4,2,8973,9006,3
Task 8973,Job 1,10,7,2,11,0,12,21,9,2,4,1,8973,9006,10
Task 8974,Job 0,10,9,3,12,1,13,22,9,3,2,0,8974,9007,9
Task 8974,Job 1,15,7,1,7,0,16,22,6,1,1,2,8974,9007,11
Task 8975,Job 0,7,10,2,10,0,9,17,8,2,4,0,8975,9008,8
Task 8975,Job 1,12,8,4,9,0,16,21,5,4,4,2,8975,9008,4
Task 8976,Job 0,6,5,3,6,0,9,12,3,3,3,0,8976,9010,2
Task 8976,Job 1,11,5,3,12,0,14,23,9,3,4,1,8976,9010,19
Task 8977,Job 0,8,9,3,10,0,11,18,7,3,4,2,8977,9011,15
Task 8977,Job 1,13,5,1,10,0,14,23,9,1,4,1,8977,9011,3
Task 8978,Job 0,2,6,3,11,0,5,13,8,3,4,0,8978,9012,20
Task 8978,Job 1,7,7,1,6,0,8,13,5,1,4,1,8978,9012,18
Task 8979,Job 0,4,9,3,10,0,7,14,7,3,3,0,8979,9013,13
Task 8979,Job 1,9,7,2,7,0,11,16,5,2,3,0,8979,9013,5
Task 8980,Job 0,2,4,1,6,0,3,8,5,1,4,1,8980,9014,17
Task 8980,Job 1,7,10,1,10,1,8,17,9,1,2,2,8980,9014,16
Task 8981,Job 0,4,8,3,8,0,7,12,5,3,2,1,8981,9014,19
Task 8981,Job 1,9,5,4,9,0,13,18,5,4,3,0,8981,9014,19
Task 8982,Job 0,6,5,1,7,0,7,13,6,1,3,1,8982,9015,2
Task 8982,Job 1,11,5,3,6,0,14,17,3,3,1,2,8982,9015,16
Task 8983,Job 0,2,4,3,12,0,5,14,9,3,1,0,8983,9017,17
Task 8983,Job 1,7,8,1,8,1,8,15,7,1,2,0,8983,9017,12
Task 8984,Job 0,3,7,4,10,0,7,13,6,4,4,0,8984,9018,2
Task 8984,Job 1,8,10,1,11,0,9,19,10,1,4,2,8984,9018,15
Task 8985,Job 0,1,10,4,7,0,5,8,3,4,3,0,8985,9019,16
Task 8985,Job 1,6,9,3,9,0,9,15,6,3,1,2,8985,9019,3
Task 8986,Job 0,2,8,4,11,0,6,13,7,4,4,2,8986,9020,2
Task 8986,Job 1,7,8,4,11,0,11,18,7,4,4,2,8986,9020,3
Task 8987,Job 0,9,4,1,12,0,10,21,11,1,2,2,8987,9021,11
Task 8987,Job 1,14,7,4,11,0,18,25,7,4,2,2,8987,9021,11
Task 8988,Job 0,5,10,2,8,0,7,13,6,2,4,1,8988,9022,10
Task 8988,Job 1,10,8,2,9,0,12,19,7,2,1,1,8988,9022,17
Task 8989,Job 0,1,8,3,6,1,4,7,3,3,1,0,8989,9022,9
Task 8989,Job 1,6,4,2,6,0,8,12,4,2,4,0,8989,9022,18
Task 8990,Job 0,5,8,3,7,0,8,12,4,3,2,2,8990,9024,13
Task 8990,Job 1,10,10,1,6,0,11,16,5,1,2,0,8990,9024,3
Task 8991,Job 0,6,9,4,12,1,10,18,8,4,3,1,8991,9025,6
Task 8991,Job 1,11,10,4,6,0,15,17,2,4,3,2,8991,9025,13
Task 8992,Job 0,6,10,1,9,0,7,15,8,1,3,0,8992,9025,15
Task 8992,Job 1,11,4,1,6,0,12,17,5,1,4,2,8992,9025,5
Task 8993,Job 0,2,8,2,6,0,4,8,4,2,2,1,8993,9027,20
Task 8993,Job 1,7,7,1,8,0,8,15,7,1,4,2,8993,9027,2
Task 8994,Job 0,5,9,3,6,0,8,11,3,3,1,2,8994,9028,12
Task 8994,Job 1,10,6,2,9,0,12,19,7,2,2,2,8994,9028,12
Task 8995,Job 0,9,7,2,7,0,11,16,5,2,1,2,8995,9029,14
Task 8995,Job 1,14,8,2,6,1,16,20,4,2,4,0,8995,9029,2
Task 8996,Job 0,7,8,2,12,0,9,19,10,2,2,0,8996,9029,16
Task 8996,Job 1,12,5,3,6,0,15,18,3,3,2,2,8996,9029,17
Task 8997,Job 0,7,4,2,9,0,9,16,7,2,1,1,8997,9030,6
Task 8997,Job 1,12,4,2,11,0,14,23,9,2,1,1,8997,9030,14
Task 8998,Job 0,9,9,3,12,0,12,21,9,3,1,2,8998,9031,20
Task 8998,Job 1,14,10,4,11,0,18,25,7,4,1,1,8998,9031,8
Task 8999,Job 0,7,9,2,12,0,9,19,10,2,1,0,8999,9032,4
Task 8999,Job 1,12,4,4,6,0,16,18,2,4,1,2,8999,9032,3
Task 9000,Job 0,3,8,3,11,0,6,14,8,3,4,0,9000,9033,4
Task 9000,Job 1,8,6,4,9,1,12,17,5,4,3,2,9000,9033,8
Task 9001,Job 0,7,9,4,10,0,11,17,6,4,4,1,9001,9035,3
Task 9001,Job 1,12,9,2,12,0,14,24,10,2,2,1,9001,9035,19
Task 9002,Job 0,5,9,1,8,0,6,13,7,1,3,0,9002,9035,9
Task 9002,Job 1,10,10,3,6,1,13,16,3,3,1,2,9002,9035,8
Task 9003,Job 0,5,5,1,12,1,6,17,11,1,2,0,9003,9036,6
Task 9003,Job 1,10,8,2,9,0,12,19,7,2,1,0,9003,9036,20
Task 9004,Job 0,6,10,1,11,0,7,17,10,1,3,0,9004,9038,8
Task 9004,Job 1,11,10,2,12,0,13,23,10,2,3,2,9004,9038,19
Task 9005,Job 0,4,7,1,12,1,5,16,11,1,4,0,9005,9039,3
Task 9005,Job 1,9,4,3,11,0,12,20,8,3,2,0,9005,9039,9
Task 9006,Job 0,2,6,4,11,0,6,13,7,4,2,1,9006,9039,15
Task 9006,Job 1,7,10,1,7,0,8,14,6,1,4,1,9006,9039,4
Task 9007,Job 0,10,6,1,11,0,11,21,10,1,3,0,9007,9040,16
Task 9007,Job 1,15,7,1,10,1,16,25,9,1,4,2,9007,9040,7
Task 9008,Job 0,2,7,3,6,0,5,8,3,3,4,2,9008,9041,9
Task 9008,Job 1,7,10,2,8,0,9,15,6,2,2,1,9008,9041,3
Task 9009,Job 0,6,8,1,10,0,7,16,9,1,1,1,9009,9042,17
Task 9009,Job 1,11,9,3,9,0,14,20,6,3,4,1,9009,9042,15
Task 9010,Job 0,2,6,2,6,1,4,8,4,2,4,0,9010,9044,13
Task 9010,Job 1,7,6,2,11,0,9,18,9,2,1,1,9010,9044,11
Task 9011,Job 0,3,8,3,11,0,6,14,8,3,3,1,9011,9044,14
Task 9011,Job 1,8,7,1,12,0,9,20,11,1,1,0,9011,9044,18
Task 9012,Job 0,6,9,1,6,0,7,12,5,1,4,2,9012,9045,20
Task 9012,Job 1,11,4,4,8,1,15,19,4,4,2,1,9012,9045,7
Task 9013,Job 0,3,6,1,6,0,4,9,5,1,4,2,9013,9047,16
Task 9013,Job 1,8,9,2,8,0,10,16,6,2,4,0,9013,9047,8
Task 9014,Job 0,2,10,3,12,1,5,14,9,3,3,0,9014,9048,11
Task 9014,Job 1,7,5,1,7,0,8,14,6,1,1,2,9014,9048,4
Task 9015,Job 0,4,4,1,9,0,5,13,8,1,4,0,9015,9048,10
Task 9015,Job 1,9,8,4,12,1,13,21,8,4,2,0,9015,9048,14
Task 9016,Job 0,7,5,4,6,1,11,13,2,4,2,2,9016,9050,11
Task 9016,Job 1,12,7,4,7,0,16,19,3,4,3,0,9016,9050,19
Task 9017,Job 0,5,9,1,10,0,6,15,9,1,1,0,9017,9050,15
Task 9017,Job 1,10,6,1,10,0,11,20,9,1,2,2,9017,9050,9
Task 9018,Job 0,7,5,3,10,0,10,17,7,3,2,1,9018,9051,5
Task 9018,Job 1,12,10,2,7,0,14,19,5,2,4,2,9018,9051,17
Task 9019,Job 0,4,4,2,9,0,6,13,7,2,1,1,9019,9053,12
Task 9019,Job 1,9,10,1,8,0,10,17,7,1,1,1,9019,9053,17
Task 9020,Job 0,5,7,1,10,0,6,15,9,1,1,0,9020,9054,10
Task 9020,Job 1,10,7,1,12,0,11,22,11,1,2,0,9020,9054,15
Task 9021,Job 0,6,5,1,7,0,7,13,6,1,3,2,9021,9055,17
Task 9021,Job 1,11,6,1,9,1,12,20,8,1,1,2,9021,9055,13
Task 9022,Job 0,3,4,4,9,0,7,12,5,4,4,1,9022,9056,13
Task 9022,Job 1,8,10,1,12,0,9,20,11,1,2,2,9022,9056,14
Task 9023,Job 0,5,7,1,7,1,6,12,6,1,2,2,9023,9057,5
Task 9023,Job 1,10,10,4,11,0,14,21,7,4,1,2,9023,9057,10
Task 9024,Job 0,2,9,2,8,0,4,10,6,2,1,1,9024,9058,9
Task 9024,Job 1,7,6,1,11,1,8,18,10,1,4,2,9024,9058,4
Task 9025,Job 0,9,6,1,11,0,10,20,10,1,1,2,9025,9059,3
Task 9025,Job 1,14,5,2,9,1,16,23,7,2,3,2,9025,9059,12
Task 9026,Job 0,8,10,4,10,0,12,18,6,4,2,2,9026,9060,3
Task 9026,Job 1,13,9,1,10,1,14,23,9,1,4,0,9026,9060,9
Task 9027,Job 0,10,8,2,12,1,12,22,10,2,3,2,9027,9061,7
Task 9027,Job 1,15,8,3,7,0,18,22,4,3,2,2,9027,9061,9
Task 9028,Job 0,6,8,3,6,0,9,12,3,3,3,2,9028,9061,3
Task 9028,Job 1,11,5,4,9,0,15,20,5,4,4,0,9028,9061,12
Task 9029,Job 0,9,8,4,6,0,13,15,2,4,1,1,9029,9062,3
Task 9029,Job 1,14,10,3,7,1,17,21,4,3,3,2,9029,9062,18
Task 9030,Job 0,8,8,1,6,0,9,14,5,1,1,2,9030,9063,2
Task 9030,Job 1,13,10,4,12,0,17,25,8,4,4,2,9030,9063,18
Task 9031,Job 0,5,5,2,8,0,7,13,6,2,1,0,9031,9065,11
Task 9031,Job 1,10,6,4,9,0,14,19,5,4,3,2,9031,9065,4
Task 9032,Job 0,1,8,4,9,0,5,10,5,4,1,2,9032,9066,11
Task 9032,Job 1,6,4,1,11,1,7,17,10,1,4,2,9032,9066,19
Task 9033,Job 0,3,7,4,8,0,7,11,4,4,1,0,9033,9066,12
Task 9033,Job 1,8,10,2,12,0,10,20,10,2,2,0,9033,9066,15
Task 9034,Job 0,6,5,3,6,1,9,12,3,3,4,1,9034,9068,3
Task 9034,Job 1,11,8,3,11,0,14,22,8,3,1,0,9034,9068,19
Task 9035,Job 0,9,10,1,6,0,10,15,5,1,4,0,9035,9068,17
Task 9035,Job 1,14,5,1,11,0,15,25,10,1,1,1,9035,9068,7
Task 9036,Job 0,7,6,3,6,0,10,13,3,3,2,0,9036,9069,17
Task 9036,Job 1,12,10,3,8,0,15,20,5,3,2,2,9036,9069,19
Task 9037,Job 0,7,10,4,9,1,11,16,5,4,3,2,9037,9070,13
Task 9037,Job 1,12,8,3,7,0,15,19,4,3,3,0,9037,9070,10
Task 9038,Job 0,7,4,2,10,0,9,17,8,2,1,1,9038,9071,19
Task 9038,Job 1,12,8,3,7,0,15,19,4,3,4,1,9038,9071,4
Task 9039,Job 0,1,7,4,10,0,5,11,6,4,2,2,9039,9073,14
Task 9039,Job 1,6,7,4,11,0,10,17,7,4,2,2,9039,9073,10
Task 9040,Job 0,4,6,1,8,0,5,12,7,1,4,2,9040,9074,9
Task 9040,Job 1,9,7,1,10,0,10,19,9,1,1,0,9040,9074,19
Task 9041,Job 0,4,9,1,7,0,5,11,6,1,3,1,9041,9074,19
Task 9041,Job 1,9,8,3,11,0,12,20,8,3,2,1,9041,9074,20
Task 9042,Job 0,5,8,1,10,0,6,15,9,1,1,1,9042,9076,17
Task 9042,Job 1,10,5,3,7,0,13,17,4,3,1,1,9042,9076,13
Task 9043,Job 0,6,9,1,10,0,7,16,9,1,1,1,9043,9077,17
Task 9043,Job 1,11,10,3,6,0,14,17,3,3,4,0,9043,9077,8
Task 9044,Job 0,3,10,3,12,0,6,15,9,3,4,1,9044,9078,5
Task 9044,Job 1,8,10,3,8,1,11,16,5,3,2,2,9044,9078,6
Task 9045,Job 0,2,8,4,12,0,6,14,8,4,4,2,9045,9078,4
Task 9045,Job 1,7,5,2,11,0,9,18,9,2,4,0,9045,9078,11
Task 9046,Job 0,6,7,2,11,0,8,17,9,2,3,0,9046,9079,12
Task 9046,Job 1,11,9,2,10,0,13,21,8,2,4,0,9046,9079,3
Task 9047,Job 0,2,6,4,8,0,6,10,4,4,4,2,9047,9080,11
Task 9047,Job 1,7,8,1,11,0,8,18,10,1,2,1,9047,9080,20
Task 9048,Job 0,9,8,3,10,0,12,19,7,3,4,1,9048,9081,8
Task 9048,Job 1,14,10,3,6,1,17,20,3,3,3,0,9048,9081,3
Task 9049,Job 0,7,9,2,10,0,9,17,8,2,1,0,9049,9083,17
Task 9049,Job 1,12,7,3,6,0,15,18,3,3,4,2,9049,9083,9
Task 9050,Job 0,9,7,3,7,0,12,16,4,3,1,2,9050,9084,8
Task 9050,Job 1,14,9,4,6,0,18,20,2,4,2,1,9050,9084,10
Task 9051,Job 0,3,4,1,9,0,4,12,8,1,2,0,9051,9084,14
Task 9051,Job 1,8,4,4,12,0,12,20,8,4,1,0,9051,9084,19
Task 9052,Job 0,8,7,3,11,0,11,19,8,3,3,2,9052,9085,3
Task 9052,Job 1,13,10,2,7,1,15,20,5,2,1,1,9052,9085,15
Task 9053,Job 0,8,7,2,6,1,10,14,4,2,1,1,9053,9087,12
Task 9053,Job 1,13,7,1,9,0,14,22,8,1,3,1,9053,9087,14
Task 9054,Job 0,2,6,2,8,0,4,10,6,2,4,0,9054,9087,13
Task 9054,Job 1,7,5,2,6,0,9,13,4,2,1,0,9054,9087,19
Task 9055,Job 0,2,9,4,10,0,6,12,6,4,2,0,9055,9089,20
Task 9055,Job 1,7,4,4,9,0,11,16,5,4,1,2,9055,9089,7
Task 9056,Job 0,3,8,4,8,0,7,11,4,4,3,1,9056,9089,13
Task 9056,Job 1,8,6,4,9,0,12,17,5,4,3,1,9056,9089,9
Task 9057,Job 0,4,9,3,12,0,7,16,9,3,1,0,9057,9091,7
Task 9057,Job 1,9,9,3,6,0,12,15,3,3,4,1,9057,9091,11
Task 9058,Job 0,6,4,3,9,1,9,15,6,3,2,1,9058,9092,14
Task 9058,Job 1,11,7,4,10,0,15,21,6,4,4,0,9058,9092,18
Task 9059,Job 0,6,8,2,11,0,8,17,9,2,2,0,9059,9093,15
Task 9059,Job 1,11,9,4,9,0,15,20,5,4,4,0,9059,9093,19
Task 9060,Job 0,8,8,3,11,0,11,19,8,3,4,0,9060,9093,13
Task 9060,Job 1,13,8,4,7,0,17,20,3,4,4,0,9060,9093,19
Task 9061,Job 0,7,7,4,8,0,11,15,4,4,2,1,9061,9095,12
Task 9061,Job 1,12,8,4,9,0,16,21,5,4,4,1,9061,9095,12
Task 9062,Job 0,2,9,2,11,1,4,13,9,2,2,1,9062,9095,16
Task 9062,Job 1,7,8,2,6,0,9,13,4,2,3,1,9062,9095,18
Task 9063,Job 0,5,5,4,6,0,9,11,2,4,2,0,9063,9096,14
Task 9063,Job 1,10,6,1,6,0,11,16,5,1,1,2,9063,9096,4
Task 9064,Job 0,7,7,3,9,0,10,16,6,3,4,0,9064,9098,7
Task 9064,Job 1,12,6,1,6,0,13,18,5,1,2,2,9064,9098,7
Task 9065,Job 0,9,4,1,10,0,10,19,9,1,1,0,9065,9099,14
Task 9065,Job 1,14,6,1,10,1,15,24,9,1,3,2,9065,9099,15
Task 9066,Job 0,10,4,4,7,0,14,17,3,4,3,0,9066,9099,5
Task 9066,Job 1,15,8,4,10,0,19,25,6,4,3,1,9066,9099,15
Task 9067,Job 0,6,4,4,7,0,10,13,3,4,3,0,9067,9100,20
Task 9067,Job 1,11,6,1,6,0,12,17,5,1,4,1,9067,9100,9
Task 9068,Job 0,9,8,3,12,1,12,21,9,3,3,1,9068,9102,17
Task 9068,Job 1,14,6,2,10,1,16,24,8,2,3,0,9068,9102,4
Task 9069,Job 0,1,10,4,10,0,5,11,6,4,2,0,9069,9102,17
Task 9069,Job 1,6,7,1,9,0,7,15,8,1,1,2,9069,9102,20
Task 9070,Job 0,5,9,1,8,0,6,13,7,1,4,1,9070,9104,8
Task 9070,Job 1,10,8,2,7,0,12,17,5,2,2,2,9070,9104,16
Task 9071,Job 0,2,10,4,12,0,6,14,8,4,3,1,9071,9104,3
Task 9071,Job 1,7,6,4,6,1,11,13,2,4,3,2,9071,9104,16
Task 9072,Job 0,6,8,2,10,0,8,16,8,2,3,0,9072,9106,10
Task 9072,Job 1,11,7,2,7,0,13,18,5,2,3,2,9072,9106,17
Task 9073,Job 0,7,9,4,9,0,11,16,5,4,1,1,9073,9106,8
Task 9073,Job 1,12,7,2,9,0,14,21,7,2,1,2,9073,9106,8
Task 9074,Job 0,10,10,1,12,0,11,22,11,1,1,1,9074,9108,9
Task 9074,Job 1,15,9,4,8,0,19,23,4,4,2,1,9074,9108,14
Task 9075,Job 0,9,6,3,10,0,12,19,7,3,4,2,9075,9109,11
Task 9075,Job 1,14,9,2,11,0,16,25,9,2,1,0,9075,9109,18
Task 9076,Job 0,4,10,3,11,0,7,15,8,3,3,1,9076,9110,12
Task 9076,Job 1,9,6,2,7,0,11,16,5,2,4,0,9076,9110,9
Task 9077,Job 0,7,10,1,7,0,8,14,6,1,2,2,9077,9111,4
Task 9077,Job 1,12,7,4,11,0,16,23,7,4,3,0,9077,9111,6
Task 9078,Job 0,10,5,4,12,1,14,22,8,4,2,1,9078,9112,9
Task 9078,Job 1,15,7,1,7,0,16,22,6,1,1,2,9078,9112,13
Task 9079,Job 0,10,9,2,9,0,12,19,7,2,4,1,9079,9112,14
Task 9079,Job 1,15,5,2,12,0,17,27,10,2,2,2,9079,9112,15
Task 9080,Job 0,1,7,3,11,0,4,12,8,3,4,2,9080,9114,19
Task 9080,Job 1,6,6,1,7,1,7,13,6,1,2,1,9080,9114,15
Task 9081,Job 0,6,5,4,11,0,10,17,7,4,1,1,9081,9114,2
Task 9081,Job 1,11,4,1,8,1,12,19,7,1,4,1,9081,9114,4
Task 9082,Job 0,8,8,3,12,0,11,20,9,3,1,1,9082,9116,4
Task 9082,Job 1,13,10,2,12,1,15,25,10,2,4,1,9082,9116,9
Task 9083,Job 0,5,10,2,6,0,7,11,4,2,4,1,9083,9117,7
Task 9083,Job 1,10,6,3,12,0,13,22,9,3,1,2,9083,9117,11
Task 9084,Job 0,2,8,4,7,0,6,9,3,4,4,2,9084,9118,11
Task 9084,Job 1,7,5,3,10,0,10,17,7,3,4,2,9084,9118,18
Task 9085,Job 0,8,10,3,11,0,11,19,8,3,1,2,9085,9118,4
Task 9085,Job 1,13,4,3,6,0,16,19,3,3,1,2,9085,9118,5
Task 9086,Job 0,2,9,2,11,1,4,13,9,2,1,2,9086,9119,17
Task 9086,Job 1,7,10,4,7,0,11,14,3,4,1,2,9086,9119,15
Task 9087,Job 0,8,9,4,11,0,12,19,7,4,3,0,9087,9121,10
Task 9087,Job 1,13,7,2,12,0,15,25,10,2,3,2,9087,9121,8
Task 9088,Job 0,10,9,1,8,0,11,18,7,1,3,1,9088,9122,20
Task 9088,Job 1,15,6,4,11,1,19,26,7,4,3,0,9088,9122,19
Task 9089,Job 0,2,8,2,12,0,4,14,10,2,1,1,9089,9122,12
Task 9089,Job 1,7,4,2,9,0,9,16,7,2,3,1,9089,9122,18
Task 9090,Job 0,4,8,4,7,0,8,11,3,4,2,2,9090,9124,10
Task 9090,Job 1,9,9,1,12,0,10,21,11,1,3,1,9090,9124,10
Task 9091,Job 0,3,10,3,10,0,6,13,7,3,1,1,9091,9125,2
Task 9091,Job 1,8,8,3,7,0,11,15,4,3,4,1,9091,9125,20
Task 9092,Job 0,7,9,1,12,0,8,19,11,1,4,0,9092,9126,13
Task 9092,Job 1,12,6,2,9,0,14,21,7,2,2,1,9092,9126,3
Task 9093,Job 0,7,8,3,7,0,10,14,4,3,3,0,9093,9126,17
Task 9093,Job 1,12,4,4,11,0,16,23,7,4,1,1,9093,9126,16
Task 9094,Job 0,3,6,3,9,0,6,12,6,3,1,1,9094,9128,9
Task 9094,Job 1,8,10,3,12,0,11,20,9,3,1,2,9094,9128,18
Task 9095,Job 0,2,9,4,10,0,6,12,6,4,3,2,9095,9128,15
Task 9095,Job 1,7,7,1,10,0,8,17,9,1,2,1,9095,9128,15
Task 9096,Job 0,6,8,3,9,0,9,15,6,3,4,1,9096,9129,2
Task 9096,Job 1,11,6,1,10,0,12,21,9,1,1,1,9096,9129,5
Task 9097,Job 0,7,9,3,6,0,10,13,3,3,2,2,9097,9130,16
Task 9097,Job 1,12,8,3,11,0,15,23,8,3,4,0,9097,9130,19
Task 9098,Job 0,10,7,1,9,0,11,19,8,1,2,1,9098,9132,8
Task 9098,Job 1,15,8,3,11,1,18,26,8,3,2,1,9098,9132,4
Task 9099,Job 0,7,5,3,12,0,10,19,9,3,3,2,9099,9133,17
Task 9099,Job 1,12,6,3,6,1,15,18,3,3,3,1,9099,9133,6
Task 9100,Job 0,4,5,2,8,1,6,12,6,2,1,0,9100,9133,2
Task 9100,Job 1,9,5,3,6,0,12,15,3,3,2,0,9100,9133,5
Task 9101,Job 0,3,8,3,6,0,6,9,3,3,3,0,9101,9135,6
Task 9101,Job 1,8,10,4,8,0,12,16,4,4,2,2,9101,9135,20
Task 9102,Job 0,10,9,4,10,0,14,20,6,4,2,2,9102,9135,4
Task 9102,Job 1,15,4,4,11,1,19,26,7,4,1,2,9102,9135,4
Task 9103,Job 0,1,6,1,12,0,2,13,11,1,4,1,9103,9136,8
Task 9103,Job 1,6,4,1,6,0,7,12,5,1,1,2,9103,9136,4
Task 9104,Job 0,2,6,4,11,0,6,13,7,4,4,1,9104,9138,7
Task 9104,Job 1,7,4,4,7,1,11,14,3,4,2,0,9104,9138,8
Task 9105,Job 0,9,4,1,6,0,10,15,5,1,2,1,9105,9139,14
Task 9105,Job 1,14,7,4,6,0,18,20,2,4,1,0,9105,9139,16
Task 9106,Job 0,7,4,3,9,1,10,16,6,3,3,0,9106,9139,18
Task 9106,Job 1,12,8,2,10,1,14,22,8,2,2,1,9106,9139,19
Task 9107,Job 0,1,8,3,12,1,4,13,9,3,3,1,9107,9141,9
Task 9107,Job 1,6,7,3,12,1,9,18,9,3,2,1,9107,9141,4
Task 9108,Job 0,2,7,4,9,0,6,11,5,4,1,1,9108,9141,15
Task 9108,Job 1,7,9,4,7,0,11,14,3,4,1,0,9108,9141,12
Task 9109,Job 0,7,6,1,11,0,8,18,10,1,3,1,9109,9142,16
Task 9109,Job 1,12,7,3,6,0,15,18,3,3,2,2,9109,9142,8
Task 9110,Job 0,10,5,3,12,0,13,22,9,3,3,0,9110,9144,6
Task 9110,Job 1,15,6,1,6,0,16,21,5,1,4,1,9110,9144,5
Task 9111,Job 0,1,5,4,6,0,5,7,2,4,1,2,9111,9144,16
Task 9111,Job 1,6,8,3,6,0,9,12,3,3,2,1,9111,9144,17
Task 9112,Job 0,6,8,2,10,0,8,16,8,2,4,0,9112,9146,6
Task 9112,Job 1,11,8,2,7,0,13,18,5,2,1,0,9112,9146,9
Task 9113,Job 0,3,5,4,9,0,7,12,5,4,1,2,9113,9146,10
Task 9113,Job 1,8,7,2,8,0,10,16,6,2,4,0,9113,9146,10
Task 9114,Job 0,7,9,4,8,0,11,15,4,4,3,2,9114,9148,7
Task 9114,Job 1,12,8,1,6,0,13,18,5,1,3,1,9114,9148,2
Task 9115,Job 0,2,4,3,11,1,5,13,8,3,1,0,9115,9148,19
Task 9115,Job 1,7,9,3,6,0,10,13,3,3,2,1,9115,9148,15
Task 9116,Job 0,8,8,4,9,1,12,17,5,4,2,0,9116,9149,19
Task 9116,Job 1,13,10,1,8,0,14,21,7,1,4,0,9116,9149,14
Task 9117,Job 0,8,8,1,12,0,9,20,11,1,3,0,9117,9150,19
Task 9117,Job 1,13,5,3,8,0,16,21,5,3,1,2,9117,9150,16
Task 9118,Job 0,6,5,4,7,0,10,13,3,4,2,1,9118,9152,2
Task 9118,Job 1,11,6,2,7,0,13,18,5,2,2,2,9118,9152,7
Task 9119,Job 0,9,5,3,7,1,12,16,4,3,3,0,9119,9152,10
Task 9119,Job 1,14,7,3,11,1,17,25,8,3,3,2,9119,9152,17
Task 9120,Job 0,7,10,1,11,0,8,18,10,1,3,0,9120,9154,3
Task 9120,Job 1,12,8,4,10,0,16,22,6,4,2,0,9120,9154,8
Task 9121,Job 0,2,5,3,8,1,5,10,5,3,3,2,9121,9154,15
Task 9121,Job 1,7,6,1,11,0,8,18,10,1,2,2,9121,9154,4
Task 9122,Job 0,8,7,2,6,1,10,14,4,2,1,0,9122,9156,3
Task 9122,Job 1,13,10,3,7,0,16,20,4,3,1,2,9122,9156,12
Task 9123,Job 0,5,9,3,10,0,8,15,7,3,3,2,9123,9156,17
Task 9123,Job 1,10,8,4,8,0,14,18,4,4,4,2,9123,9156,18
Task 9124,Job 0,10,9,3,6,1,13,16,3,3,2,2,9124,9157,8
Task 9124,Job 1,15,6,1,7,0,16,22,6,1,2,0,9124,9157,2
Task 9125,Job 0,4,10,3,11,1,7,15,8,3,2,2,9125,9159,12
Task 9125,Job 1,9,4,3,6,0,12,15,3,3,1,0,9125,9159,2
Task 9126,Job 0,7,6,2,8,1,9,15,6,2,2,2,9126,9160,6
Task 9126,Job 1,12,9,1,10,0,13,22,9,1,3,1,9126,9160,10
Task 9127,Job 0,9,6,2,9,0,11,18,7,2,3,2,9127,9160,15
Task 9127,Job 1,14,5,1,11,0,15,25,10,1,1,1,9127,9160,20
Task 9128,Job 0,5,5,1,6,1,6,11,5,1,2,2,9128,9162,14
Task 9128,Job 1,10,7,4,8,1,14,18,4,4,3,0,9128,9162,5
Task 9129,Job 0,2,5,1,6,0,3,8,5,1,2,2,9129,9163,10
Task 9129,Job 1,7,5,3,10,0,10,17,7,3,4,1,9129,9163,16
Task 9130,Job 0,7,5,1,11,0,8,18,10,1,3,1,9130,9164,16
Task 9130,Job 1,12,7,3,8,1,15,20,5,3,2,0,9130,9164,3
Task 9131,Job 0,1,4,2,11,0,3,12,9,2,4,0,9131,9164,8
Task 9131,Job 1,6,10,4,8,1,10,14,4,4,3,2,9131,9164,3
Task 9132,Job 0,2,5,1,7,0,3,9,6,1,1,1,9132,9165,8
Task 9132,Job 1,7,9,3,12,0,10,19,9,3,2,2,9132,9165,8
Task 9133,Job 0,9,6,2,8,0,11,17,6,2,2,2,9133,9167,18
Task 9133,Job 1,14,10,2,7,0,16,21,5,2,4,2,9133,9167,4
Task 9134,Job 0,1,9,2,11,1,3,12,9,2,2,2,9134,9167,18
Task 9134,Job 1,6,4,3,10,0,9,16,7,3,1,1,9134,9167,14
Task 9135,Job 0,6,5,3,8,1,9,14,5,3,1,0,9135,9169,16
Task 9135,Job 1,11,6,3,8,0,14,19,5,3,4,0,9135,9169,14
Task 9136,Job 0,7,8,1,8,0,8,15,7,1,2,2,9136,9169,4
Task 9136,Job 1,12,10,3,7,1,15,19,4,3,3,2,9136,9169,10
Task 9137,Job 0,10,9,4,6,1,14,16,2,4,1,2,9137,9171,10
Task 9137,Job 1,15,8,3,9,1,18,24,6,3,1,2,9137,9171,14
Task 9138,Job 0,4,4,1,11,0,5,15,10,1,3,0,9138,9172,13
Task 9138,Job 1,9,6,1,12,1,10,21,11,1,4,0,9138,9172,4
Task 9139,Job 0,9,4,2,9,0,11,18,7,2,2,1,9139,9172,6
Task 9139,Job 1,14,9,2,6,1,16,20,4,2,2,0,9139,9172,20
Task 9140,Job 0,6,6,2,9,0,8,15,7,2,4,0,9140,9173,4
Task 9140,Job 1,11,9,3,9,1,14,20,6,3,3,1,9140,9173,12
Task 9141,Job 0,7,10,4,6,0,11,13,2,4,1,1,9141,9175,11
Task 9141,Job 1,12,8,4,12,0,16,24,8,4,3,0,9141,9175,15
Task 9142,Job 0,4,4,4,7,1,8,11,3,4,1,0,9142,9176,5
Task 9142,Job 1,9,7,1,8,0,10,17,7,1,2,2,9142,9176,15
Task 9143,Job 0,1,6,1,7,0,2,8,6,1,1,0,9143,9177,4
Task 9143,Job 1,6,7,2,10,1,8,16,8,2,3,2,9143,9177,18
Task 9144,Job 0,5,4,3,6,1,8,11,3,3,3,0,9144,9178,11
Task 9144,Job 1,10,6,4,12,0,14,22,8,4,2,2,9144,9178,5
Task 9145,Job 0,5,9,2,6,0,7,11,4,2,4,0,9145,9178,9
Task 9145,Job 1,10,5,2,6,0,12,16,4,2,1,1,9145,9178,20
Task 9146,Job 0,6,10,1,7,0,7,13,6,1,1,0,9146,9180,10
Task 9146,Job 1,11,7,4,10,0,15,21,6,4,2,0,9146,9180,11
Task 9147,Job 0,10,6,2,10,1,12,20,8,2,2,0,9147,9180,5
Task 9147,Job 1,15,7,4,12,0,19,27,8,4,2,0,9147,9180,14
Task 9148,Job 0,8,7,2,7,1,10,15,5,2,3,0,9148,9182,3
Task 9148,Job 1,13,10,4,11,0,17,24,7,4,4,2,9148,9182,11
Task 9149,Job 0,1,6,1,9,0,2,10,8,1,3,2,9149,9182,7
Task 9149,Job 1,6,6,1,6,0,7,12,5,1,2,2,9149,9182,13
Task 9150,Job 0,2,9,3,10,1,5,12,7,3,2,2,9150,9184,9
Task 9150,Job 1,7,9,3,6,1,10,13,3,3,4,2,9150,9184,13
Task 9151,Job 0,4,5,3,8,0,7,12,5,3,2,1,9151,9185,15
Task 9151,Job 1,9,4,4,6,0,13,15,2,4,4,2,9151,9185,13
Task 9152,Job 0,1,10,4,11,0,5,12,7,4,4,0,9152,9185,19
Task 9152,Job 1,6,6,2,11,0,8,17,9,2,2,1,9152,9185,7
Task 9153,Job 0,4,8,3,11,1,7,15,8,3,1,0,9153,9186,15
Task 9153,Job 1,9,8,1,8,0,10,17,7,1,4,1,9153,9186,16
Task 9154,Job 0,1,7,4,6,1,5,7,2,4,1,0,9154,9187,12
Task 9154,Job 1,6,10,3,11,1,9,17,8,3,2,0,9154,9187,5
Task 9155,Job 0,10,4,3,7,0,13,17,4,3,3,1,9155,9189,7
Task 9155,Job 1,15,10,3,8,0,18,23,5,3,2,0,9155,9189,9
Task 9156,Job 0,4,10,3,9,0,7,13,6,3,4,2,9156,9189,4
Task 9156,Job 1,9,8,3,7,0,12,16,4,3,1,2,9156,9189,2
Task 9157,Job 0,9,5,1,8,0,10,17,7,1,2,1,9157,9191,16
Task 9157,Job 1,14,4,1,11,0,15,25,10,1,1,0,9157,9191,5
Task 9158,Job 0,4,5,2,8,0,6,12,6,2,4,1,9158,9192,17
Task 9158,Job 1,9,8,4,6,0,13,15,2,4,3,2,9158,9192,14
Task 9159,Job 0,2,4,2,11,0,4,13,9,2,3,1,9159,9192,4
Task 9159,Job 1,7,8,1,7,0,8,14,6,1,3,2,9159,9192,14
Task 9160,Job 0,6,4,4,10,0,10,16,6,4,4,2,9160,9194,4
Task 9160,Job 1,11,10,2,6,0,13,17,4,2,2,0,9160,9194,10
Task 9161,Job 0,10,9,1,6,0,11,16,5,1,4,0,9161,9194,14
Task 9161,Job 1,15,8,4,10,0,19,25,6,4,3,2,9161,9194,7
Task 9162,Job 0,1,8,1,11,0,2,12,10,1,4,2,9162,9196,3
Task 9162,Job 1,6,5,3,9,0,9,15,6,3,1,2,9162,9196,2
Task 9163,Job 0,5,8,3,8,1,8,13,5,3,1,0,9163,9196,17
Task 9163,Job 1,10,7,3,9,1,13,19,6,3,1,2,9163,9196,12
Task 9164,Job 0,8,5,4,6,0,12,14,2,4,3,2,9164,9198,10
Task 9164,Job 1,13,6,3,6,0,16,19,3,3,2,0,9164,9198,15
Task 9165,Job 0,5,5,4,6,0,9,11,2,4,3,2,9165,9198,16
Task 9165,Job 1,10,10,2,9,0,12,19,7,2,1,1,9165,9198,12
Task 9166,Job 0,5,10,3,9,0,8,14,6,3,3,1,9166,9199,19
Task 9166,Job 1,10,6,3,12,1,13,22,9,3,3,1,9166,9199,19
Task 9167,Job 0,10,6,3,6,0,13,16,3,3,4,0,9167,9201,10
Task 9167,Job 1,15,6,2,9,0,17,24,7,2,2,1,9167,9201,6
Task 9168,Job 0,3,10,1,10,0,4,13,9,1,2,1,9168,9202,2
Task 9168,Job 1,8,5,1,8,0,9,16,7,1,1,2,9168,9202,2
Task 9169,Job 0,4,10,2,10,0,6,14,8,2,2,0,9169,9203,19
Task 9169,Job 1,9,10,4,10,0,13,19,6,4,3,2,9169,9203,14
Task 9170,Job 0,8,10,1,10,1,9,18,9,1,1,2,9170,9204,8
Task 9170,Job 1,13,9,4,8,0,17,21,4,4,2,0,9170,9204,3
Task 9171,Job 0,3,9,4,10,0,7,13,6,4,3,0,9171,9204,8
Task 9171,Job 1,8,5,1,8,0,9,16,7,1,2,2,9171,9204,15
Task 9172,Job 0,9,5,3,9,1,12,18,6,3,2,1,9172,9206,8
Task 9172,Job 1,14,4,4,9,0,18,23,5,4,2,0,9172,9206,20
Task 9173,Job 0,10,9,3,10,0,13,20,7,3,4,1,9173,9206,5
Task 9173,Job 1,15,6,4,11,0,19,26,7,4,3,1,9173,9206,5
Task 9174,Job 0,8,6,2,10,1,10,18,8,2,1,0,9174,9208,5
Task 9174,Job 1,13,6,3,10,0,16,23,7,3,1,1,9174,9208,20
Task 9175,Job 0,3,4,1,8,0,4,11,7,1,4,0,9175,9208,7
Task 9175,Job 1,8,8,2,10,0,10,18,8,2,2,0,9175,9208,16
Task 9176,Job 0,8,8,3,10,0,11,18,7,3,2,2,9176,9210,8
Task 9176,Job 1,13,7,4,8,1,17,21,4,4,4,0,9176,9210,16
Task 9177,Job 0,2,9,2,7,0,4,9,5,2,3,1,9177,9210,3
Task 9177,Job 1,7,5,3,7,1,10,14,4,3,1,1,9177,9210,6
Task 9178,Job 0,4,4,2,9,0,6,13,7,2,1,1,9178,9211,12
Task 9178,Job 1,9,8,4,11,1,13,20,7,4,2,1,9178,9211,3
Task 9179,Job 0,6,9,2,7,0,8,13,5,2,3,2,9179,9212,17
Task 9179,Job 1,11,9,2,10,0,13,21,8,2,3,0,9179,9212,4
Task 9180,Job 0,1,10,1,10,1,2,11,9,1,3,2,9180,9213,2
Task 9180,Job 1,6,6,4,6,0,10,12,2,4,2,0,9180,9213,8
Task 9181,Job 0,4,4,2,9,0,6,13,7,2,4,2,9181,9214,15
Task 9181,Job 1,9,8,2,10,0,11,19,8,2,3,2,9181,9214,15
Task 9182,Job 0,7,7,2,7,0,9,14,5,2,1,0,9182,9216,7
Task 9182,Job 1,12,9,1,10,0,13,22,9,1,2,2,9182,9216,17
Task 9183,Job 0,10,6,1,9,0,11,19,8,1,2,2,9183,9216,17
Task 9183,Job 1,15,4,3,11,0,18,26,8,3,1,0,9183,9216,11
Task 9184,Job 0,3,5,3,6,0,6,9,3,3,4,0,9184,9218,15
Task 9184,Job 1,8,10,4,9,1,12,17,5,4,4,0,9184,9218,2
Task 9185,Job 0,8,8,1,9,0,9,17,8,1,4,2,9185,9219,5
Task 9185,Job 1,13,4,1,12,0,14,25,11,1,2,1,9185,9219,19
Task 9186,Job 0,9,7,1,6,0,10,15,5,1,4,1,9186,9220,11
Task 9186,Job 1,14,8,4,9,1,18,23,5,4,4,1,9186,9220,5
Task 9187,Job 0,4,10,1,11,1,5,15,10,1,1,0,9187,9221,8
Task 9187,Job 1,9,6,2,9,1,11,18,7,2,3,2,9187,9221,2
Task 9188,Job 0,4,8,1,6,0,5,10,5,1,1,0,9188,9221,7
Task 9188,Job 1,9,7,3,9,0,12,18,6,3,1,0,9188,9221,10
Task 9189,Job 0,8,8,4,7,0,12,15,3,4,2,2,9189,9223,2
Task 9189,Job 1,13,7,4,8,0,17,21,4,4,4,1,9189,9223,18
Task 9190,Job 0,2,8,1,6,0,3,8,5,1,3,0,9190,9223,13
Task 9190,Job 1,7,10,1,10,1,8,17,9,1,4,1,9190,9223,6
Task 9191,Job 0,10,10,4,12,0,14,22,8,4,1,0,9191,9224,9
Task 9191,Job 1,15,9,3,12,1,18,27,9,3,3,0,9191,9224,2
Task 9192,Job 0,9,4,2,11,0,11,20,9,2,1,1,9192,9226,19
Task 9192,Job 1,14,9,3,11,1,17,25,8,3,1,0,9192,9226,17
Task 9193,Job 0,4,9,1,11,0,5,15,10,1,3,1,9193,9227,2
Task 9193,Job 1,9,6,1,9,0,10,18,8,1,3,2,9193,9227,13
Task 9194,Job 0,5,6,4,9,0,9,14,5,4,1,1,9194,9228,17
Task 9194,Job 1,10,7,3,6,1,13,16,3,3,3,2,9194,9228,14
Task 9195,Job 0,9,10,1,6,0,10,15,5,1,4,2,9195,9228,6
Task 9195,Job 1,14,4,4,6,0,18,20,2,4,2,2,9195,9228,2
Task 9196,Job 0,6,4,2,8,0,8,14,6,2,2,2,9196,9229,7
Task 9196,Job 1,11,6,1,10,1,12,21,9,1,1,2,9196,9229,12
Task 9197,Job 0,9,9,1,7,1,10,16,6,1,1,2,9197,9230,20
Task 9197,Job 1,14,6,1,11,0,15,25,10,1,4,1,9197,9230,16
Task 9198,Job 0,6,9,4,8,1,10,14,4,4,4,2,9198,9231,2
Task 9198,Job 1,11,8,1,11,0,12,22,10,1,4,2,9198,9231,3
Task 9199,Job 0,4,5,2,6,0,6,10,4,2,1,2,9199,9233,9
Task 9199,Job 1,9,7,1,12,0,10,21,11,1,1,2,9199,9233,12
Task 9200,Job 0,3,7,1,6,0,4,9,5,1,3,0,9200,9234,13
Task 9200,Job 1,8,6,4,7,0,12,15,3,4,1,2,9200,9234,15
Task 9201,Job 0,6,5,2,8,1,8,14,6,2,4,0,9201,9234,20
Task 9201,Job 1,11,6,2,10,0,13,21,8,2,2,2,9201,9234,17
Task 9202,Job 0,7,9,3,8,0,10,15,5,3,4,2,9202,9236,7
Task 9202,Job 1,12,4,2,7,1,14,19,5,2,2,1,9202,9236,15
Task 9203,Job 0,10,9,1,11,0,11,21,10,1,2,0,9203,9237,9
Task 9203,Job 1,15,8,4,6,0,19,21,2,4,1,1,9203,9237,12
Task 9204,Job 0,1,9,4,8,0,5,9,4,4,2,2,9204,9237,11
Task 9204,Job 1,6,10,3,12,0,9,18,9,3,2,2,9204,9237,12
Task 9205,Job 0,10,8,2,7,0,12,17,5,2,4,0,9205,9239,9
Task 9205,Job 1,15,5,1,9,0,16,24,8,1,4,2,9205,9239,13
Task 9206,Job 0,7,6,4,11,0,11,18,7,4,2,2,9206,9240,14
Task 9206,Job 1,12,8,2,8,0,14,20,6,2,4,2,9206,9240,3
Task 9207,Job 0,5,6,4,8,0,9,13,4,4,4,1,9207,9241,12
Task 9207,Job 1,10,8,2,11,0,12,21,9,2,3,0,9207,9241,18
Task 9208,Job 0,4,10,4,10,0,8,14,6,4,1,0,9208,9242,13
Task 9208,Job 1,9,5,3,8,0,12,17,5,3,2,1,9208,9242,4
Task 9209,Job 0,10,10,2,12,0,12,22,10,2,1,0,9209,9242,15
Task 9209,Job 1,15,9,2,7,0,17,22,5,2,1,2,9209,9242,2
Task 9210,Job 0,5,6,1,12,0,6,17,11,1,2,0,9210,9244,7
Task 9210,Job 1,10,8,2,12,1,12,22,10,2,2,0,9210,9244,7
Task 9211,Job 0,6,7,4,9,0,10,15,5,4,3,2,9211,9244,3
Task 9211,Job 1,11,4,4,10,1,15,21,6,4,3,1,9211,9244,15
Task 9212,Job 0,6,8,2,8,0,8,14,6,2,1,1,9212,9246,19
Task 9212,Job 1,11,4,1,12,0,12,23,11,1,2,1,9212,9246,13
Task 9213,Job 0,10,8,1,10,0,11,20,9,1,1,2,9213,9247,5
Task 9213,Job 1,15,8,2,8,0,17,23,6,2,3,2,9213,9247,20
Task 9214,Job 0,7,10,1,8,1,8,15,7,1,1,1,9214,9247,17
Task 9214,Job 1,12,9,3,10,1,15,22,7,3,1,0,9214,9247,7
Task 9215,Job 0,7,5,1,12,0,8,19,11,1,3,2,9215,9249,13
Task 9215,Job 1,12,10,2,9,0,14,21,7,2,2,2,9215,9249,19
Task 9216,Job 0,7,4,4,6,0,11,13,2,4,3,1,9216,9250,10
Task 9216,Job 1,12,7,1,11,1,13,23,10,1,1,0,9216,9250,7
Task 9217,Job 0,3,10,3,8,1,6,11,5,3,2,1,9217,9251,11
Task 9217,Job 1,8,9,2,8,0,10,16,6,2,2,2,9217,9251,15
Task 9218,Job 0,2,5,1,10,0,3,12,9,1,4,2,9218,9251,12
Task 9218,Job 1,7,8,3,7,1,10,14,4,3,4,0,9218,9251,9
Task 9219,Job 0,8,6,2,6,0,10,14,4,2,2,0,9219,9253,3
Task 9219,Job 1,13,7,1,7,0,14,20,6,1,4,2,9219,9253,17
Task 9220,Job 0,1,7,4,11,1,5,12,7,4,4,0,9220,9254,10
Task 9220,Job 1,6,9,1,9,0,7,15,8,1,1,0,9220,9254,15
Task 9221,Job 0,1,4,4,7,0,5,8,3,4,2,0,9221,9255,12
Task 9221,Job 1,6,8,3,7,0,9,13,4,3,3,1,9221,9255,15
Task 9222,Job 0,5,8,1,9,1,6,14,8,1,2,2,9222,9256,3
Task 9222,Job 1,10,6,1,7,0,11,17,6,1,2,0,9222,9256,16
Task 9223,Job 0,6,7,2,7,0,8,13,5,2,1,0,9223,9257,16
Task 9223,Job 1,11,10,4,10,1,15,21,6,4,2,0,9223,9257,15
Task 9224,Job 0,5,4,1,7,0,6,12,6,1,3,1,9224,9257,9
Task 9224,Job 1,10,4,4,11,1,14,21,7,4,4,1,9224,9257,20
Task 9225,Job 0,5,8,2,11,0,7,16,9,2,3,0,9225,9259,20
Task 9225,Job 1,10,4,3,6,0,13,16,3,3,3,2,9225,9259,10
Task 9226,Job 0,3,5,4,12,0,7,15,8,4,3,2,9226,9260,15
Task 9226,Job 1,8,4,2,8,0,10,16,6,2,1,0,9226,9260,5
Task 9227,Job 0,7,4,3,9,0,10,16,6,3,3,2,9227,9261,4
Task 9227,Job 1,12,9,2,9,0,14,21,7,2,2,2,9227,9261,14
Task 9228,Job 0,3,5,2,6,1,5,9,4,2,4,2,9228,9262,5
Task 9228,Job 1,8,5,3,9,0,11,17,6,3,2,2,9228,9262,18
Task 9229,Job 0,9,5,3,6,0,12,15,3,3,2,1,9229,9263,2
Task 9229,Job 1,14,8,2,7,0,16,21,5,2,1,0,9229,9263,5
Task 9230,Job 0,10,10,3,7,1,13,17,4,3,2,1,9230,9264,8
Task 9230,Job 1,15,9,4,12,0,19,27,8,4,1,2,9230,9264,6
Task 9231,Job 0,10,4,1,8,0,11,18,7,1,1,2,9231,9264,17
Task 9231,Job 1,15,6,4,6,1,19,21,2,4,1,2,9231,9264,16
Task 9232,Job 0,7,10,1,11,0,8,18,10,1,1,2,9232,9265,13
Task 9232,Job 1,12,8,4,7,1,16,19,3,4,4,0,9232,9265,15
Task 9233,Job 0,6,5,4,10,0,10,16,6,4,2,2,9233,9267,4
Task 9233,Job 1,11,7,2,8,1,13,19,6,2,3,0,9233,9267,9
Task 9234,Job 0,2,9,3,10,1,5,12,7,3,4,1,9234,9268,2
Task 9234,Job 1,7,6,1,6,0,8,13,5,1,3,1,9234,9268,4
Task 9235,Job 0,6,9,1,12,1,7,18,11,1,2,2,9235,9268,16
Task 9235,Job 1,11,4,2,8,0,13,19,6,2,2,2,9235,9268,13
Task 9236,Job 0,10,4,1,6,1,11,16,5,1,4,2,9236,9270,16
Task 9236,Job 1,15,8,2,6,0,17,21,4,2,3,2,9236,9270,14
Task 9237,Job 0,7,7,4,7,0,11,14,3,4,4,2,9237,9270,12
Task 9237,Job 1,12,9,4,6,0,16,18,2,4,2,0,9237,9270,18
Task 9238,Job 0,10,5,3,10,0,13,20,7,3,2,1,9238,9271,15
Task 9238,Job 1,15,8,3,7,1,18,22,4,3,2,0,9238,9271,11
Task 9239,Job 0,2,8,4,6,0,6,8,2,4,1,0,9239,9273,20
Task 9239,Job 1,7,4,2,8,0,9,15,6,2,3,1,9239,9273,3
Task 9240,Job 0,10,10,1,7,0,11,17,6,1,2,2,9240,9274,2
Task 9240,Job 1,15,8,3,7,0,18,22,4,3,1,1,9240,9274,6
Task 9241,Job 0,4,9,3,8,0,7,12,5,3,4,2,9241,9274,14
Task 9241,Job 1,9,6,1,8,0,10,17,7,1,3,1,9241,9274,4
Task 9242,Job 0,5,4,4,6,0,9,11,2,4,2,1,9242,9275,16
Task 9242,Job 1,10,9,3,11,0,13,21,8,3,3,2,9242,9275,16
Task 9243,Job 0,10,5,4,12,1,14,22,8,4,2,2,9243,9276,7
Task 9243,Job 1,15,4,1,12,1,16,27,11,1,1,2,9243,9276,8
Task 9244,Job 0,1,8,4,7,1,5,8,3,4,3,0,9244,9278,7
Task 9244,Job 1,6,4,2,6,0,8,12,4,2,3,1,9244,9278,7
Task 9245,Job 0,7,7,1,8,1,8,15,7,1,2,1,9245,9279,9
Task 9245,Job 1,12,10,2,9,0,14,21,7,2,3,0,9245,9279,2
Task 9246,Job 0,5,10,3,11,0,8,16,8,3,3,1,9246,9280,5
Task 9246,Job 1,10,9,3,8,0,13,18,5,3,2,2,9246,9280,9
Task 9247,Job 0,3,5,3,10,0,6,13,7,3,1,1,9247,9280,11
Task 9247,Job 1,8,8,1,8,1,9,16,7,1,3,2,9247,9280,3
Task 9248,Job 0,10,5,3,8,0,13,18,5,3,1,2,9248,9281,2
Task 9248,Job 1,15,4,3,12,0,18,27,9,3,2,2,9248,9281,9
Task 9249,Job 0,5,5,1,12,0,6,17,11,1,3,2,9249,9282,6
Task 9249,Job 1,10,10,1,12,0,11,22,11,1,2,2,9249,9282,15
Task 9250,Job 0,2,6,1,11,1,3,13,10,1,1,2,9250,9284,13
Task 9250,Job 1,7,4,2,10,0,9,17,8,2,1,0,9250,9284,16
Task 9251,Job 0,3,6,4,11,0,7,14,7,4,1,2,9251,9284,17
Task 9251,Job 1,8,7,4,9,0,12,17,5,4,1,1,9251,9284,20
Task 9252,Job 0,1,6,1,9,1,2,10,8,1,1,2,9252,9286,2
Task 9252,Job 1,6,7,3,9,0,9,15,6,3,1,2,9252,9286,20
Task 9253,Job 0,8,6,3,12,0,11,20,9,3,2,2,9253,9287,13
Task 9253,Job 1,13,4,1,11,0,14,24,10,1,2,2,9253,9287,9
Task 9254,Job 0,6,9,4,8,1,10,14,4,4,3,1,9254,9287,8
Task 9254,Job 1,11,6,2,10,1,13,21,8,2,4,1,9254,9287,5
Task 9255,Job 0,5,5,1,8,0,6,13,7,1,2,0,9255,9289,3
Task 9255,Job 1,10,10,4,12,0,14,22,8,4,3,1,9255,9289,4
Task 9256,Job 0,3,8,3,6,0,6,9,3,3,3,2,9256,9289,12
Task 9256,Job 1,8,6,2,11,0,10,19,9,2,4,2,9256,9289,4
Task 9257,Job 0,7,5,4,10,0,11,17,6,4,2,1,9257,9291,6
Task 9257,Job 1,12,6,3,8,0,15,20,5,3,2,0,9257,9291,17
Task 9258,Job 0,2,7,2,11,0,4,13,9,2,4,0,9258,9292,7
Task 9258,Job 1,7,6,3,7,0,10,14,4,3,4,1,9258,9292,16
Task 9259,Job 0,8,4,2,8,0,10,16,6,2,2,2,9259,9293,16
Task 9259,Job 1,13,7,3,6,0,16,19,3,3,3,1,9259,9293,15
Task 9260,Job 0,7,5,4,9,1,11,16,5,4,4,0,9260,9293,18
Task 9260,Job 1,12,4,2,6,0,14,18,4,2,4,2,9260,9293,7
Task 9261,Job 0,4,4,2,9,1,6,13,7,2,3,1,9261,9294,8
Task 9261,Job 1,9,8,3,6,0,12,15,3,3,3,2,9261,9294,13
Task 9262,Job 0,2,4,4,10,0,6,12,6,4,1,0,9262,9295,16
Task 9262,Job 1,7,4,3,12,0,10,19,9,3,4,1,9262,9295,14
Task 9263,Job 0,4,10,3,6,0,7,10,3,3,1,1,9263,9296,8
Task 9263,Job 1,9,9,3,7,1,12,16,4,3,3,1,9263,9296,19
Task 9264,Job 0,2,4,1,11,0,3,13,10,1,3,1,9264,9297,18
Task 9264,Job 1,7,7,4,9,1,11,16,5,4,1,0,9264,9297,19
Task 9265,Job 0,7,7,2,6,0,9,13,4,2,2,1,9265,9298,11
Task 9265,Job 1,12,8,1,10,1,13,22,9,1,2,2,9265,9298,17
Task 9266,Job 0,8,5,2,12,1,10,20,10,2,2,2,9266,9299,8
Task 9266,Job 1,13,5,2,8,0,15,21,6,2,1,0,9266,9299,14
Task 9267,Job 0,1,9,3,7,0,4,8,4,3,1,0,9267,9300,15
Task 9267,Job 1,6,6,3,12,0,9,18,9,3,3,0,9267,9300,8
Task 9268,Job 0,2,10,2,6,0,4,8,4,2,4,2,9268,9301,14
Task 9268,Job 1,7,5,4,10,0,11,17,6,4,3,2,9268,9301,18
Task 9269,Job 0,10,6,2,11,0,12,21,9,2,2,2,9269,9302,9
Task 9269,Job 1,15,6,3,12,1,18,27,9,3,1,2,9269,9302,20
Task 9270,Job 0,3,4,1,9,0,4,12,8,1,2,1,9270,9304,18
Task 9270,Job 1,8,5,4,12,0,12,20,8,4,3,0,9270,9304,5
Task 9271,Job 0,3,6,4,6,1,7,9,2,4,4,2,9271,9305,17
Task 9271,Job 1,8,8,3,9,0,11,17,6,3,1,1,9271,9305,6
Task 9272,Job 0,6,10,2,7,0,8,13,5,2,4,1,9272,9306,13
Task 9272,Job 1,11,9,3,8,1,14,19,5,3,1,1,9272,9306,4
Task 9273,Job 0,4,6,2,12,1,6,16,10,2,2,0,9273,9307,7
Task 9273,Job 1,9,8,3,11,0,12,20,8,3,4,0,9273,9307,19
Task 9274,Job 0,9,6,4,11,1,13,20,7,4,1,2,9274,9308,15
Task 9274,Job 1,14,9,3,9,0,17,23,6,3,1,2,9274,9308,16
Task 9275,Job 0,7,4,2,7,0,9,14,5,2,1,2,9275,9308,8
Task 9275,Job 1,12,7,1,10,1,13,22,9,1,3,2,9275,9308,14
Task 9276,Job 0,2,10,1,12,0,3,14,11,1,3,2,9276,9309,19
Task 9276,Job 1,7,5,4,12,0,11,19,8,4,3,1,9276,9309,4
Task 9277,Job 0,7,8,3,11,0,10,18,8,3,1,1,9277,9311,7
Task 9277,Job 1,12,5,1,10,1,13,22,9,1,1,2,9277,9311,2
Task 9278,Job 0,4,10,4,6,1,8,10,2,4,2,0,9278,9312,6
Task 9278,Job 1,9,8,3,11,0,12,20,8,3,2,1,9278,9312,9
Task 9279,Job 0,2,8,4,11,1,6,13,7,4,1,0,9279,9312,3
Task 9279,Job 1,7,10,4,8,0,11,15,4,4,2,0,9279,9312,7
Task 9280,Job 0,9,5,3,11,0,12,20,8,3,3,1,9280,9313,12
Task 9280,Job 1,14,10,2,8,0,16,22,6,2,3,1,9280,9313,4
Task 9281,Job 0,10,9,3,10,0,13,20,7,3,2,1,9281,9314,5
Task 9281,Job 1,15,5,2,6,0,17,21,4,2,2,0,9281,9314,12
Task 9282,Job 0,10,8,4,6,0,14,16,2,4,3,1,9282,9316,11
Task 9282,Job 1,15,5,4,9,0,19,24,5,4,3,1,9282,9316,8
Task 9283,Job 0,9,8,4,6,0,13,15,2,4,4,1,9283,9316,4
Task 9283,Job 1,14,9,2,8,0,16,22,6,2,2,2,9283,9316,8
Task 9284,Job 0,3,7,3,8,0,6,11,5,3,4,0,9284,9318,20
Task 9284,Job 1,8,10,2,11,0,10,19,9,2,1,1,9284,9318,10
Task 9285,Job 0,1,8,3,8,1,4,9,5,3,2,0,9285,9319,7
Task 9285,Job 1,6,6,3,10,0,9,16,7,3,1,2,9285,9319,11
Task 9286,Job 0,2,7,3,9,0,5,11,6,3,4,2,9286,9320,15
Task 9286,Job 1,7,10,4,11,0,11,18,7,4,4,1,9286,9320,8
Task 9287,Job 0,7,5,1,9,0,8,16,8,1,2,2,9287,9320,5
Task 9287,Job 1,12,5,4,7,0,16,19,3,4,3,0,9287,9320,7
Task 9288,Job 0,2,9,4,10,0,6,12,6,4,2,2,9288,9321,15
Task 9288,Job 1,7,10,2,7,0,9,14,5,2,4,0,9288,9321,15
Task 9289,Job 0,3,10,1,12,0,4,15,11,1,1,0,9289,9322,19
Task 9289,Job 1,8,4,1,12,0,9,20,11,1,3,1,9289,9322,19
Task 9290,Job 0,8,10,1,12,0,9,20,11,1,3,0,9290,9323,9
Task 9290,Job 1,13,6,1,9,0,14,22,8,1,2,2,9290,9323,3
Task 9291,Job 0,4,9,4,12,0,8,16,8,4,2,0,9291,9325,6
Task 9291,Job 1,9,7,1,11,0,10,20,10,1,1,1,9291,9325,18
Task 9292,Job 0,5,4,2,8,1,7,13,6,2,3,1,9292,9326,16
Task 9292,Job 1,10,5,3,6,1,13,16,3,3,2,2,9292,9326,17
Task 9293,Job 0,6,9,3,11,0,9,17,8,3,4,1,9293,9326,10
Task 9293,Job 1,11,5,4,9,1,15,20,5,4,4,1,9293,9326,4
Task 9294,Job 0,9,9,1,10,0,10,19,9,1,1,0,9294,9327,7
Task 9294,Job 1,14,7,3,8,0,17,22,5,3,3,1,9294,9327,16
Task 9295,Job 0,10,5,2,9,0,12,19,7,2,2,2,9295,9328,3
Task 9295,Job 1,15,10,1,7,0,16,22,6,1,2,2,9295,9328,13
Task 9296,Job 0,4,7,4,8,0,8,12,4,4,1,1,9296,9330,15
Task 9296,Job 1,9,9,3,10,0,12,19,7,3,4,2,9296,9330,17
Task 9297,Job 0,6,6,2,7,1,8,13,5,2,3,2,9297,9330,8
Task 9297,Job 1,11,5,4,6,0,15,17,2,4,1,1,9297,9330,20
Task 9298,Job 0,3,7,3,8,0,6,11,5,3,1,2,9298,9331,5
Task 9298,Job 1,8,8,1,6,0,9,14,5,1,3,2,9298,9331,4
Task 9299,Job 0,8,9,3,9,1,11,17,6,3,2,0,9299,9332,4
Task 9299,Job 1,13,10,4,7,0,17,20,3,4,3,2,9299,9332,15
Task 9300,Job 0,8,5,3,8,0,11,16,5,3,3,0,9300,9333,5
Task 9300,Job 1,13,4,3,10,0,16,23,7,3,1,1,9300,9333,14
Task 9301,Job 0,6,7,3,7,0,9,13,4,3,3,0,9301,9334,7
Task 9301,Job 1,11,7,3,8,0,14,19,5,3,1,2,9301,9334,12
Task 9302,Job 0,5,10,1,12,0,6,17,11,1,1,2,9302,9336,15
Task 9302,Job 1,10,8,2,8,0,12,18,6,2,4,0,9302,9336,2
Task 9303,Job 0,10,10,3,7,0,13,17,4,3,1,2,9303,9337,18
Task 9303,Job 1,15,6,2,7,0,17,22,5,2,1,2,9303,9337,15
Task 9304,Job 0,5,9,4,9,1,9,14,5,4,3,1,9304,9338,14
Task 9304,Job 1,10,8,3,11,1,13,21,8,3,1,0,9304,9338,16
Task 9305,Job 0,3,4,1,12,1,4,15,11,1,3,0,9305,9338,4
Task 9305,Job 1,8,4,2,7,0,10,15,5,2,4,2,9305,9338,11
Task 9306,Job 0,5,10,3,11,0,8,16,8,3,3,0,9306,9339,20
Task 9306,Job 1,10,10,2,10,0,12,20,8,2,3,1,9306,9339,14
Task 9307,Job 0,6,5,4,7,0,10,13,3,4,1,1,9307,9341,16
Task 9307,Job 1,11,5,4,12,0,15,23,8,4,2,1,9307,9341,3
Task 9308,Job 0,8,9,3,10,1,11,18,7,3,3,2,9308,9341,6
Task 9308,Job 1,13,8,4,9,0,17,22,5,4,3,2,9308,9341,7
Task 9309,Job 0,3,7,3,7,0,6,10,4,3,2,2,9309,9343,3
Task 9309,Job 1,8,8,2,12,0,10,20,10,2,2,0,9309,9343,5
Task 9310,Job 0,10,8,2,10,1,12,20,8,2,1,1,9310,9343,12
Task 9310,Job 1,15,9,1,12,0,16,27,11,1,4,0,9310,9343,3
Task 9311,Job 0,8,5,4,7,0,12,15,3,4,1,0,9311,9344,17
Task 9311,Job 1,13,5,2,6,0,15,19,4,2,3,2,9311,9344,17
Task 9312,Job 0,10,5,2,12,0,12,22,10,2,2,0,9312,9346,15
Task 9312,Job 1,15,7,1,6,0,16,21,5,1,1,0,9312,9346,19
Task 9313,Job 0,10,5,2,7,1,12,17,5,2,3,0,9313,9347,11
Task 9313,Job 1,15,9,3,8,0,18,23,5,3,2,0,9313,9347,7
Task 9314,Job 0,2,7,3,7,0,5,9,4,3,2,2,9314,9347,17
Task 9314,Job 1,7,7,4,9,1,11,16,5,4,4,1,9314,9347,13
Task 9315,Job 0,7,4,3,11,0,10,18,8,3,1,0,9315,9349,9
Task 9315,Job 1,12,6,2,9,0,14,21,7,2,3,1,9315,9349,6
Task 9316,Job 0,7,4,4,10,0,11,17,6,4,2,0,9316,9350,2
Task 9316,Job 1,12,10,3,6,0,15,18,3,3,3,0,9316,9350,18
Task 9317,Job 0,9,4,3,7,0,12,16,4,3,2,2,9317,9350,12
Task 9317,Job 1,14,8,3,10,1,17,24,7,3,3,1,9317,9350,2
Task 9318,Job 0,7,9,2,8,0,9,15,6,2,1,0,9318,9351,13
Task 9318,Job 1,12,4,2,8,0,14,20,6,2,4,0,9318,9351,8
Task 9319,Job 0,5,5,2,10,0,7,15,8,2,4,2,9319,9352,19
Task 9319,Job 1,10,5,4,10,0,14,20,6,4,4,2,9319,9352,12
Task 9320,Job 0,4,5,1,10,0,5,14,9,1,1,0,9320,9353,10
Task 9320,Job 1,9,4,3,10,1,12,19,7,3,1,1,9320,9353,8
Task 9321,Job 0,4,4,3,12,1,7,16,9,3,2,2,9321,9354,9
Task 9321,Job 1,9,7,3,12,0,12,21,9,3,2,0,9321,9354,5
Task 9322,Job 0,4,10,1,10,0,5,14,9,1,1,0,9322,9356,7
Task 9322,Job 1,9,6,2,11,1,11,20,9,2,2,2,9322,9356,2
Task 9323,Job 0,2,6,3,7,0,5,9,4,3,2,0,9323,9356,6
Task 9323,Job 1,7,7,1,9,0,8,16,8,1,2,0,9323,9356,16
Task 9324,Job 0,8,4,4,7,0,12,15,3,4,3,2,9324,9358,15
Task 9324,Job 1,13,10,4,7,0,17,20,3,4,1,2,9324,9358,3
Task 9325,Job 0,2,7,2,6,0,4,8,4,2,3,0,9325,9358,13
Task 9325,Job 1,7,6,2,11,0,9,18,9,2,3,0,9325,9358,8
Task 9326,Job 0,1,8,4,12,0,5,13,8,4,2,2,9326,9359,13
Task 9326,Job 1,6,10,1,7,0,7,13,6,1,2,1,9326,9359,3
Task 9327,Job 0,4,10,1,12,1,5,16,11,1,1,2,9327,9361,4
Task 9327,Job 1,9,6,1,9,1,10,18,8,1,3,1,9327,9361,12
Task 9328,Job 0,2,9,4,10,0,6,12,6,4,3,0,9328,9362,16
Task 9328,Job 1,7,8,1,10,0,8,17,9,1,1,1,9328,9362,12
Task 9329,Job 0,5,10,4,9,0,9,14,5,4,2,2,9329,9363,8
Task 9329,Job 1,10,4,4,7,0,14,17,3,4,4,2,9329,9363,3
Task 9330,Job 0,4,10,4,6,1,8,10,2,4,2,1,9330,9364,7
Task 9330,Job 1,9,9,4,7,1,13,16,3,4,3,0,9330,9364,13
Task 9331,Job 0,2,9,2,10,0,4,12,8,2,2,0,9331,9364,5
Task 9331,Job 1,7,7,2,10,0,9,17,8,2,2,2,9331,9364,3
Task 9332,Job 0,5,8,4,12,1,9,17,8,4,3,1,9332,9365,11
Task 9332,Job 1,10,10,1,8,1,11,18,7,1,2,0,9332,9365,6
Task 9333,Job 0,2,4,1,8,1,3,10,7,1,2,1,9333,9366,10
Task 9333,Job 1,7,4,2,9,0,9,16,7,2,2,0,9333,9366,6
Task 9334,Job 0,5,6,3,11,0,8,16,8,3,3,1,9334,9367,8
Task 9334,Job 1,10,4,2,6,0,12,16,4,2,4,2,9334,9367,7
Task 9335,Job 0,9,10,2,12,0,11,21,10,2,1,2,9335,9368,20
Task 9335,Job 1,14,9,2,8,0,16,22,6,2,4,2,9335,9368,12
Task 9336,Job 0,6,7,2,7,1,8,13,5,2,2,0,9336,9370,18
Task 9336,Job 1,11,10,4,7,0,15,18,3,4,2,2,9336,9370,2
Task 9337,Job 0,7,7,1,11,0,8,18,10,1,2,1,9337,9371,5
Task 9337,Job 1,12,4,1,9,1,13,21,8,1,3,2,9337,9371,18
Task 9338,Job 0,9,5,2,9,0,11,18,7,2,3,2,9338,9372,13
Task 9338,Job 1,14,4,4,9,1,18,23,5,4,2,2,9338,9372,11
Task 9339,Job 0,9,5,1,6,0,10,15,5,1,3,2,9339,9373,20
Task 9339,Job 1,14,4,4,8,1,18,22,4,4,1,0,9339,9373,14
Task 9340,Job 0,4,8,4,8,0,8,12,4,4,1,0,9340,9373,10
Task 9340,Job 1,9,4,2,12,0,11,21,10,2,1,0,9340,9373,17
Task 9341,Job 0,4,6,1,10,0,5,14,9,1,4,1,9341,9374,20
Task 9341,Job 1,9,4,1,12,0,10,21,11,1,4,1,9341,9374,2
Task 9342,Job 0,2,8,2,8,1,4,10,6,2,4,0,9342,9376,17
Task 9342,Job 1,7,6,4,8,1,11,15,4,4,2,0,9342,9376,20
Task 9343,Job 0,4,10,1,9,0,5,13,8,1,4,0,9343,9376,14
Task 9343,Job 1,9,6,3,10,0,12,19,7,3,3,0,9343,9376,5
Task 9344,Job 0,10,8,3,11,0,13,21,8,3,4,2,9344,9377,18
Task 9344,Job 1,15,8,2,12,0,17,27,10,2,2,2,9344,9377,5
Task 9345,Job 0,8,6,4,11,0,12,19,7,4,4,1,9345,9378,8
Task 9345,Job 1,13,10,2,11,0,15,24,9,2,3,2,9345,9378,20
Task 9346,Job 0,6,7,3,7,0,9,13,4,3,1,2,9346,9380,13
Task 9346,Job 1,11,4,2,6,0,13,17,4,2,3,0,9346,9380,17
Task 9347,Job 0,9,5,3,8,0,12,17,5,3,3,0,9347,9381,12
Task 9347,Job 1,14,4,3,8,0,17,22,5,3,1,1,9347,9381,7
Task 9348,Job 0,1,8,2,8,1,3,9,6,2,2,1,9348,9382,13
Task 9348,Job 1,6,10,2,6,1,8,12,4,2,1,0,9348,9382,13
Task 9349,Job 0,7,7,2,10,0,9,17,8,2,4,1,9349,9382,7
Task 9349,Job 1,12,10,2,8,1,14,20,6,2,1,0,9349,9382,2
Task 9350,Job 0,8,7,1,7,0,9,15,6,1,2,1,9350,9383,20
Task 9350,Job 1,13,9,3,12,1,16,25,9,3,2,1,9350,9383,2
Task 9351,Job 0,2,7,3,11,0,5,13,8,3,3,1,9351,9385,9
Task 9351,Job 1,7,4,4,9,0,11,16,5,4,1,0,9351,9385,10
Task 9352,Job 0,10,10,1,6,0,11,16,5,1,2,0,9352,9385,17
Task 9352,Job 1,15,4,1,12,0,16,27,11,1,3,0,9352,9385,10
Task 9353,Job 0,9,9,4,12,1,13,21,8,4,3,1,9353,9386,19
Task 9353,Job 1,14,8,2,8,0,16,22,6,2,2,0,9353,9386,14
Task 9354,Job 0,1,10,2,7,0,3,8,5,2,3,2,9354,9388,4
Task 9354,Job 1,6,5,3,8,1,9,14,5,3,4,0,9354,9388,18
Task 9355,Job 0,8,10,1,12,1,9,20,11,1,2,0,9355,9388,18
Task 9355,Job 1,13,9,1,8,0,14,21,7,1,4,1,9355,9388,19
Task 9356,Job 0,3,7,3,9,0,6,12,6,3,3,1,9356,9389,8
Task 9356,Job 1,8,10,1,12,0,9,20,11,1,3,0,9356,9389,13
Task 9357,Job 0,2,6,3,9,0,5,11,6,3,2,1,9357,9391,7
Task 9357,Job 1,7,10,1,9,0,8,16,8,1,2,2,9357,9391,14
Task 9358,Job 0,9,10,4,12,0,13,21,8,4,2,0,9358,9391,13
Task 9358,Job 1,14,7,3,9,0,17,23,6,3,2,1,9358,9391,4
Task 9359,Job 0,6,4,1,7,0,7,13,6,1,1,0,9359,9392,2
Task 9359,Job 1,11,5,3,6,0,14,17,3,3,1,0,9359,9392,16
Task 9360,Job 0,5,5,4,7,0,9,12,3,4,1,0,9360,9393,11
Task 9360,Job 1,10,4,4,8,0,14,18,4,4,4,2,9360,9393,20
Task 9361,Job 0,3,6,1,10,1,4,13,9,1,3,1,9361,9394,4
Task 9361,Job 1,8,8,4,12,1,12,20,8,4,1,0,9361,9394,15
Task 9362,Job 0,6,7,2,8,1,8,14,6,2,1,2,9362,9395,8
Task 9362,Job 1,11,7,4,8,1,15,19,4,4,4,1,9362,9395,11
Task 9363,Job 0,6,5,4,9,0,10,15,5,4,4,0,9363,9396,4
Task 9363,Job 1,11,5,4,6,0,15,17,2,4,4,2,9363,9396,13
Task 9364,Job 0,6,4,3,6,0,9,12,3,3,4,0,9364,9398,10
Task 9364,Job 1,11,9,3,9,1,14,20,6,3,4,2,9364,9398,18
Task 9365,Job 0,1,9,4,11,0,5,12,7,4,1,1,9365,9399,9
Task 9365,Job 1,6,7,2,8,1,8,14,6,2,2,2,9365,9399,11
Task 9366,Job 0,6,10,3,9,0,9,15,6,3,2,0,9366,9399,5
Task 9366,Job 1,11,10,2,11,1,13,22,9,2,4,1,9366,9399,15
Task 9367,Job 0,6,7,4,10,0,10,16,6,4,1,2,9367,9401,4
Task 9367,Job 1,11,7,3,7,0,14,18,4,3,2,0,9367,9401,18
Task 9368,Job 0,8,8,3,9,0,11,17,6,3,4,0,9368,9401,9
Task 9368,Job 1,13,4,2,7,0,15,20,5,2,3,2,9368,9401,9
Task 9369,Job 0,1,7,2,10,1,3,11,8,2,2,0,9369,9402,3
Task 9369,Job 1,6,4,4,8,0,10,14,4,4,2,1,9369,9402,2
Task 9370,Job 0,5,10,1,12,0,6,17,11,1,2,2,9370,9403,3
Task 9370,Job 1,10,7,2,11,1,12,21,9,2,3,2,9370,9403,8
Task 9371,Job 0,3,4,1,8,0,4,11,7,1,3,1,9371,9405,17
Task 9371,Job 1,8,6,2,8,0,10,16,6,2,4,1,9371,9405,3
Task 9372,Job 0,7,10,2,10,0,9,17,8,2,2,2,9372,9406,8
Task 9372,Job 1,12,8,1,8,0,13,20,7,1,1,2,9372,9406,15
Task 9373,Job 0,5,7,1,8,0,6,13,7,1,1,0,9373,9407,8
Task 9373,Job 1,10,7,3,9,0,13,19,6,3,1,2,9373,9407,12
Task 9374,Job 0,1,8,3,8,0,4,9,5,3,1,0,9374,9408,17
Task 9374,Job 1,6,8,3,11,0,9,17,8,3,1,0,9374,9408,6
Task 9375,Job 0,3,9,2,10,0,5,13,8,2,2,1,9375,9409,3
Task 9375,Job 1,8,5,2,8,1,10,16,6,2,1,1,9375,9409,4
Task 9376,Job 0,2,4,3,9,1,5,11,6,3,2,2,9376,9410,18
Task 9376,Job 1,7,6,1,6,0,8,13,5,1,3,1,9376,9410,15
Task 9377,Job 0,2,4,2,7,0,4,9,5,2,2,2,9377,9410,9
Task 9377,Job 1,7,7,1,10,1,8,17,9,1,3,1,9377,9410,13
Task 9378,Job 0,8,4,3,6,0,11,14,3,3,2,0,9378,9411,11
Task 9378,Job 1,13,7,3,8,0,16,21,5,3,4,2,9378,9411,15
Task 9379,Job 0,10,7,2,10,0,12,20,8,2,1,2,9379,9413,10
Task 9379,Job 1,15,9,2,8,1,17,23,6,2,4,0,9379,9413,7
Task 9380,Job 0,6,9,2,12,1,8,18,10,2,3,2,9380,9414,19
Task 9380,Job 1,11,5,3,11,0,14,22,8,3,3,1,9380,9414,16
Task 9381,Job 0,3,10,3,6,0,6,9,3,3,2,1,9381,9414,10
Task 9381,Job 1,8,7,4,12,0,12,20,8,4,3,0,9381,9414,12
Task 9382,Job 0,3,8,4,9,0,7,12,5,4,1,1,9382,9416,13
Task 9382,Job 1,8,4,3,11,0,11,19,8,3,3,0,9382,9416,3
Task 9383,Job 0,8,4,4,8,0,12,16,4,4,1,0,9383,9417,18
Task 9383,Job 1,13,6,3,8,0,16,21,5,3,4,1,9383,9417,20
Task 9384,Job 0,9,9,1,7,0,10,16,6,1,3,0,9384,9418,16
Task 9384,Job 1,14,8,4,6,0,18,20,2,4,2,0,9384,9418,4
Task 9385,Job 0,4,8,1,12,1,5,16,11,1,1,1,9385,9418,9
Task 9385,Job 1,9,4,2,7,1,11,16,5,2,1,2,9385,9418,3
Task 9386,Job 0,3,5,1,8,0,4,11,7,1,3,0,9386,9420,15
Task 9386,Job 1,8,8,3,10,0,11,18,7,3,4,1,9386,9420,19
Task 9387,Job 0,6,5,4,6,0,10,12,2,4,1,2,9387,9420,10
Task 9387,Job 1,11,6,1,9,0,12,20,8,1,1,1,9387,9420,16
Task 9388,Job 0,3,6,4,6,1,7,9,2,4,4,0,9388,9422,14
Task 9388,Job 1,8,9,4,10,0,12,18,6,4,1,1,9388,9422,14
Task 9389,Job 0,6,10,1,11,0,7,17,10,1,2,0,9389,9422,12
Task 9389,Job 1,11,8,1,10,0,12,21,9,1,4,2,9389,9422,3
Task 9390,Job 0,8,9,4,11,0,12,19,7,4,3,1,9390,9424,16
Task 9390,Job 1,13,7,2,11,0,15,24,9,2,3,1,9390,9424,10
Task 9391,Job 0,2,8,3,11,0,5,13,8,3,2,0,9391,9425,9
Task 9391,Job 1,7,4,2,6,1,9,13,4,2,2,2,9391,9425,8
Task 9392,Job 0,1,7,3,7,0,4,8,4,3,3,2,9392,9425,8
Task 9392,Job 1,6,9,2,6,0,8,12,4,2,2,0,9392,9425,8
Task 9393,Job 0,7,4,4,6,0,11,13,2,4,3,1,9393,9426,3
Task 9393,Job 1,12,7,4,9,0,16,21,5,4,3,2,9393,9426,16
Task 9394,Job 0,8,5,3,7,1,11,15,4,3,3,1,9394,9428,5
Task 9394,Job 1,13,4,3,7,0,16,20,4,3,4,0,9394,9428,4
Task 9395,Job 0,2,4,2,7,1,4,9,5,2,2,0,9395,9429,13
Task 9395,Job 1,7,8,4,11,0,11,18,7,4,4,0,9395,9429,10
Task 9396,Job 0,1,7,1,6,0,2,7,5,1,2,1,9396,9430,9
Task 9396,Job 1,6,9,3,12,0,9,18,9,3,1,0,9396,9430,6
Task 9397,Job 0,10,8,4,11,0,14,21,7,4,4,1,9397,9430,2
Task 9397,Job 1,15,6,3,9,1,18,24,6,3,2,1,9397,9430,11
Task 9398,Job 0,8,10,2,10,1,10,18,8,2,3,0,9398,9431,7
Task 9398,Job 1,13,10,3,7,1,16,20,4,3,1,1,9398,9431,16
Task 9399,Job 0,6,4,3,10,0,9,16,7,3,3,1,9399,9433,13
Task 9399,Job 1,11,10,1,7,1,12,18,6,1,3,0,9399,9433,5
Task 9400,Job 0,5,10,1,12,0,6,17,11,1,3,1,9400,9434,15
Task 9400,Job 1,10,7,4,7,0,14,17,3,4,1,0,9400,9434,3
Task 9401,Job 0,8,8,4,8,0,12,16,4,4,1,2,9401,9435,11
Task 9401,Job 1,13,9,4,6,1,17,19,2,4,1,2,9401,9435,2
Task 9402,Job 0,1,9,2,9,0,3,10,7,2,2,0,9402,9435,17
Task 9402,Job 1,6,10,2,12,0,8,18,10,2,3,0,9402,9435,19
Task 9403,Job 0,3,10,4,11,0,7,14,7,4,2,0,9403,9437,13
Task 9403,Job 1,8,10,2,8,1,10,16,6,2,2,1,9403,9437,5
Task 9404,Job 0,10,4,3,6,1,13,16,3,3,3,0,9404,9438,13
Task 9404,Job 1,15,7,2,8,0,17,23,6,2,2,0,9404,9438,17
Task 9405,Job 0,5,7,2,9,0,7,14,7,2,4,1,9405,9439,8
Task 9405,Job 1,10,4,1,10,1,11,20,9,1,3,0,9405,9439,4
Task 9406,Job 0,3,4,4,12,0,7,15,8,4,4,0,9406,9440,2
Task 9406,Job 1,8,5,1,7,1,9,15,6,1,1,2,9406,9440,10
Task 9407,Job 0,8,6,4,7,0,12,15,3,4,2,1,9407,9440,13
Task 9407,Job 1,13,5,2,8,0,15,21,6,2,3,2,9407,9440,11
Task 9408,Job 0,8,4,1,9,1,9,17,8,1,1,2,9408,9442,9
Task 9408,Job 1,13,5,1,8,0,14,21,7,1,4,0,9408,9442,7
Task 9409,Job 0,2,4,4,10,0,6,12,6,4,3,1,9409,9442,16
Task 9409,Job 1,7,5,1,12,0,8,19,11,1,2,2,9409,9442,6
Task 9410,Job 0,2,6,1,12,0,3,14,11,1,4,2,9410,9444,20
Task 9410,Job 1,7,7,1,9,1,8,16,8,1,4,1,9410,9444,5
Task 9411,Job 0,2,7,4,10,0,6,12,6,4,2,0,9411,9444,8
Task 9411,Job 1,7,6,2,12,0,9,19,10,2,3,2,9411,9444,3
Task 9412,Job 0,5,4,3,9,1,8,14,6,3,3,0,9412,9446,17
Task 9412,Job 1,10,6,1,8,0,11,18,7,1,2,2,9412,9446,2
Task 9413,Job 0,6,9,4,12,0,10,18,8,4,2,0,9413,9446,10
Task 9413,Job 1,11,9,1,8,0,12,19,7,1,1,2,9413,9446,8
Task 9414,Job 0,7,8,2,8,0,9,15,6,2,1,0,9414,9448,2
Task 9414,Job 1,12,4,4,8,0,16,20,4,4,4,0,9414,9448,16
Task 9415,Job 0,10,9,2,11,0,12,21,9,2,2,1,9415,9448,11
Task 9415,Job 1,15,10,1,12,1,16,27,11,1,3,2,9415,9448,10
Task 9416,Job 0,7,6,4,10,0,11,17,6,4,3,1,9416,9449,11
Task 9416,Job 1,12,10,2,9,0,14,21,7,2,2,1,9416,9449,20
Task 9417,Job 0,4,8,2,12,0,6,16,10,2,1,2,9417,9451,2
Task 9417,Job 1,9,7,3,7,0,12,16,4,3,3,0,9417,9451,3
Task 9418,Job 0,4,5,1,10,0,5,14,9,1,1,2,9418,9451,7
Task 9418,Job 1,9,8,4,12,0,13,21,8,4,4,1,9418,9451,18
Task 9419,Job 0,6,9,3,12,0,9,18,9,3,1,1,9419,9453,5
Task 9419,Job 1,11,4,2,6,0,13,17,4,2,2,0,9419,9453,5
Task 9420,Job 0,8,6,1,11,0,9,19,10,1,1,0,9420,9453,13
Task 9420,Job 1,13,7,2,8,0,15,21,6,2,4,2,9420,9453,16
Task 9421,Job 0,3,6,1,8,0,4,11,7,1,2,2,9421,9454,3
Task 9421,Job 1,8,10,3,9,0,11,17,6,3,1,0,9421,9454,5
Task 9422,Job 0,10,4,4,12,0,14,22,8,4,2,2,9422,9455,17
Task 9422,Job 1,15,5,1,8,0,16,23,7,1,4,1,9422,9455,10
Task 9423,Job 0,1,10,3,8,0,4,9,5,3,2,2,9423,9456,20
Task 9423,Job 1,6,4,4,10,0,10,16,6,4,3,1,9423,9456,4
Task 9424,Job 0,1,7,2,7,0,3,8,5,2,4,0,9424,9458,8
Task 9424,Job 1,6,6,4,6,1,10,12,2,4,3,0,9424,9458,10
Task 9425,Job 0,2,10,1,7,1,3,9,6,1,4,2,9425,9458,4
Task 9425,Job 1,7,8,3,11,0,10,18,8,3,2,0,9425,9458,8
Task 9426,Job 0,3,9,3,12,0,6,15,9,3,2,2,9426,9459,15
Task 9426,Job 1,8,4,4,6,0,12,14,2,4,4,2,9426,9459,13
Task 9427,Job 0,10,9,3,8,1,13,18,5,3,3,2,9427,9461,18
Task 9427,Job 1,15,5,4,11,0,19,26,7,4,2,1,9427,9461,3
Task 9428,Job 0,10,10,3,8,0,13,18,5,3,4,0,9428,9461,16
Task 9428,Job 1,15,9,4,12,0,19,27,8,4,1,0,9428,9461,4
Task 9429,Job 0,3,4,2,12,0,5,15,10,2,2,2,9429,9463,12
Task 9429,Job 1,8,8,1,10,0,9,18,9,1,1,2,9429,9463,9
Task 9430,Job 0,3,9,1,6,0,4,9,5,1,1,1,9430,9464,3
Task 9430,Job 1,8,6,2,6,0,10,14,4,2,3,0,9430,9464,3
Task 9431,Job 0,2,8,4,10,1,6,12,6,4,2,0,9431,9465,15
Task 9431,Job 1,7,6,2,10,0,9,17,8,2,3,2,9431,9465,17
Task 9432,Job 0,7,7,3,6,1,10,13,3,3,3,2,9432,9465,18
Task 9432,Job 1,12,10,3,9,1,15,21,6,3,3,0,9432,9465,14
Task 9433,Job 0,2,6,3,6,0,5,8,3,3,2,2,9433,9467,19
Task 9433,Job 1,7,7,3,9,0,10,16,6,3,2,0,9433,9467,12
Task 9434,Job 0,9,5,1,9,0,10,18,8,1,4,0,9434,9468,15
Task 9434,Job 1,14,8,3,9,0,17,23,6,3,3,2,9434,9468,12
Task 9435,Job 0,6,4,2,10,0,8,16,8,2,2,2,9435,9468,2
Task 9435,Job 1,11,8,4,8,0,15,19,4,4,4,0,9435,9468,9
Task 9436,Job 0,6,4,1,7,0,7,13,6,1,4,2,9436,9470,16
Task 9436,Job 1,11,5,3,9,0,14,20,6,3,1,0,9436,9470,5
Task 9437,Job 0,4,9,3,10,1,7,14,7,3,2,1,9437,9470,18
Task 9437,Job 1,9,5,1,10,0,10,19,9,1,1,2,9437,9470,14
Task 9438,Job 0,3,8,2,7,1,5,10,5,2,4,1,9438,9471,17
Task 9438,Job 1,8,10,3,8,0,11,16,5,3,2,0,9438,9471,2
Task 9439,Job 0,8,8,2,11,1,10,19,9,2,4,1,9439,9473,18
Task 9439,Job 1,13,10,3,7,0,16,20,4,3,4,2,9439,9473,20
Task 9440,Job 0,8,5,2,7,0,10,15,5,2,4,2,9440,9474,5
Task 9440,Job 1,13,8,1,8,0,14,21,7,1,4,2,9440,9474,20
Task 9441,Job 0,3,10,2,11,0,5,14,9,2,2,1,9441,9475,5
Task 9441,Job 1,8,4,3,11,1,11,19,8,3,2,0,9441,9475,19
Task 9442,Job 0,10,4,4,9,0,14,19,5,4,4,1,9442,9476,5
Task 9442,Job 1,15,4,4,9,0,19,24,5,4,4,0,9442,9476,18
Task 9443,Job 0,3,6,1,7,0,4,10,6,1,4,0,9443,9476,10
Task 9443,Job 1,8,10,3,10,1,11,18,7,3,4,0,9443,9476,19
Task 9444,Job 0,2,9,3,10,0,5,12,7,3,4,2,9444,9478,5
Task 9444,Job 1,7,5,4,6,0,11,13,2,4,2,2,9444,9478,9
Task 9445,Job 0,10,6,3,8,0,13,18,5,3,3,0,9445,9479,11
Task 9445,Job 1,15,8,1,10,0,16,25,9,1,1,2,9445,9479,10
Task 9446,Job 0,6,6,1,12,0,7,18,11,1,1,2,9446,9479,14
Task 9446,Job 1,11,8,1,6,0,12,17,5,1,2,1,9446,9479,11
Task 9447,Job 0,6,4,3,11,0,9,17,8,3,1,2,9447,9480,13
Task 9447,Job 1,11,10,3,10,0,14,21,7,3,1,1,9447,9480,18
Task 9448,Job 0,7,4,3,7,1,10,14,4,3,2,2,9448,9481,9
Task 9448,Job 1,12,9,2,9,0,14,21,7,2,3,1,9448,9481,16
Task 9449,Job 0,9,10,4,8,0,13,17,4,4,4,1,9449,9482,13
Task 9449,Job 1,14,10,1,8,1,15,22,7,1,2,1,9449,9482,15
Task 9450,Job 0,6,10,2,12,0,8,18,10,2,3,1,9450,9483,12
Task 9450,Job 1,11,10,4,6,1,15,17,2,4,2,0,9450,9483,12
Task 9451,Job 0,6,7,2,12,0,8,18,10,2,3,0,9451,9484,15
Task 9451,Job 1,11,9,2,8,0,13,19,6,2,3,0,9451,9484,17
Task 9452,Job 0,1,8,1,8,1,2,9,7,1,3,1,9452,9485,13
Task 9452,Job 1,6,8,3,11,0,9,17,8,3,2,1,9452,9485,20
Task 9453,Job 0,3,7,2,6,0,5,9,4,2,3,2,9453,9486,10
Task 9453,Job 1,8,8,1,10,0,9,18,9,1,4,1,9453,9486,8
Task 9454,Job 0,9,4,3,10,0,12,19,7,3,4,1,9454,9488,17
Task 9454,Job 1,14,7,4,6,0,18,20,2,4,2,1,9454,9488,2
Task 9455,Job 0,9,10,1,8,0,10,17,7,1,2,1,9455,9488,14
Task 9455,Job 1,14,9,3,9,0,17,23,6,3,2,0,9455,9488,8
Task 9456,Job 0,7,7,1,9,0,8,16,8,1,2,1,9456,9489,4
Task 9456,Job 1,12,10,2,6,1,14,18,4,2,1,1,9456,9489,20
Task 9457,Job 0,8,4,2,8,0,10,16,6,2,3,2,9457,9491,20
Task 9457,Job 1,13,6,3,7,0,16,20,4,3,2,2,9457,9491,10
Task 9458,Job 0,6,6,1,11,0,7,17,10,1,3,0,9458,9491,3
Task 9458,Job 1,11,8,2,7,0,13,18,5,2,3,2,9458,9491,13
Task 9459,Job 0,4,8,4,12,0,8,16,8,4,2,2,9459,9492,18
Task 9459,Job 1,9,6,1,9,0,10,18,8,1,4,1,9459,9492,5
Task 9460,Job 0,9,9,2,10,1,11,19,8,2,2,2,9460,9494,2
Task 9460,Job 1,14,4,3,11,0,17,25,8,3,3,0,9460,9494,12
Task 9461,Job 0,2,7,3,8,0,5,10,5,3,4,2,9461,9495,7
Task 9461,Job 1,7,5,4,10,0,11,17,6,4,4,1,9461,9495,3
Task 9462,Job 0,10,4,3,7,0,13,17,4,3,4,0,9462,9495,18
Task 9462,Job 1,15,6,2,9,1,17,24,7,2,3,0,9462,9495,16
Task 9463,Job 0,1,10,1,8,1,2,9,7,1,2,2,9463,9496,3
Task 9463,Job 1,6,5,2,11,1,8,17,9,2,2,0,9463,9496,16
Task 9464,Job 0,7,9,4,9,0,11,16,5,4,3,1,9464,9498,19
Task 9464,Job 1,12,4,4,6,0,16,18,2,4,2,2,9464,9498,2
Task 9465,Job 0,1,9,1,6,0,2,7,5,1,4,0,9465,9498,18
Task 9465,Job 1,6,8,4,8,0,10,14,4,4,3,1,9465,9498,16
Task 9466,Job 0,6,8,3,8,0,9,14,5,3,3,2,9466,9500,18
Task 9466,Job 1,11,5,3,11,1,14,22,8,3,3,0,9466,9500,3
Task 9467,Job 0,10,4,4,11,0,14,21,7,4,3,2,9467,9500,5
Task 9467,Job 1,15,6,4,9,0,19,24,5,4,1,1,9467,9500,7
Task 9468,Job 0,7,4,3,9,0,10,16,6,3,1,1,9468,9502,18
Task 9468,Job 1,12,7,1,6,0,13,18,5,1,3,1,9468,9502,7
Task 9469,Job 0,3,5,2,7,0,5,10,5,2,2,1,9469,9503,20
Task 9469,Job 1,8,4,2,7,0,10,15,5,2,3,2,9469,9503,20
Task 9470,Job 0,4,6,4,7,0,8,11,3,4,2,1,9470,9504,13
Task 9470,Job 1,9,4,1,10,0,10,19,9,1,2,2,9470,9504,14
Task 9471,Job 0,7,4,3,12,0,10,19,9,3,2,1,9471,9504,16
Task 9471,Job 1,12,5,1,6,0,13,18,5,1,2,0,9471,9504,11
Task 9472,Job 0,1,10,3,7,0,4,8,4,3,4,1,9472,9505,5
Task 9472,Job 1,6,6,2,6,0,8,12,4,2,4,0,9472,9505,4
Task 9473,Job 0,7,9,2,12,0,9,19,10,2,3,1,9473,9506,5
Task 9473,Job 1,12,5,1,7,1,13,19,6,1,3,2,9473,9506,9
Task 9474,Job 0,4,5,2,12,0,6,16,10,2,3,2,9474,9507,4
Task 9474,Job 1,9,9,3,11,0,12,20,8,3,3,0,9474,9507,5
Task 9475,Job 0,1,10,4,10,0,5,11,6,4,3,0,9475,9508,11
Task 9475,Job 1,6,7,2,12,0,8,18,10,2,4,1,9475,9508,7
Task 9476,Job 0,2,10,4,9,0,6,11,5,4,2,2,9476,9510,13
Task 9476,Job 1,7,7,3,12,0,10,19,9,3,1,2,9476,9510,4
Task 9477,Job 0,3,5,2,7,0,5,10,5,2,3,0,9477,9511,12
Task 9477,Job 1,8,10,1,6,1,9,14,5,1,4,2,9477,9511,17
Task 9478,Job 0,7,4,3,12,0,10,19,9,3,2,1,9478,9511,9
Task 9478,Job 1,12,7,3,9,0,15,21,6,3,3,0,9478,9511,20
Task 9479,Job 0,4,7,3,9,0,7,13,6,3,2,0,9479,9512,5
Task 9479,Job 1,9,4,3,10,0,12,19,7,3,1,2,9479,9512,8
Task 9480,Job 0,5,10,2,11,0,7,16,9,2,3,1,9480,9514,12
Task 9480,Job 1,10,9,3,12,0,13,22,9,3,3,1,9480,9514,11
Task 9481,Job 0,3,9,4,7,0,7,10,3,4,1,0,9481,9514,2
Task 9481,Job 1,8,9,2,7,0,10,15,5,2,1,0,9481,9514,14
Task 9482,Job 0,10,9,1,11,0,11,21,10,1,2,1,9482,9516,16
Task 9482,Job 1,15,10,2,7,0,17,22,5,2,3,2,9482,9516,2
Task 9483,Job 0,3,5,3,8,0,6,11,5,3,3,1,9483,9516,14
Task 9483,Job 1,8,9,2,7,0,10,15,5,2,2,0,9483,9516,10
Task 9484,Job 0,10,9,2,12,0,12,22,10,2,2,1,9484,9517,13
Task 9484,Job 1,15,10,4,7,0,19,22,3,4,1,2,9484,9517,15
Task 9485,Job 0,10,5,4,10,1,14,20,6,4,4,0,9485,9519,14
Task 9485,Job 1,15,6,1,10,0,16,25,9,1,1,1,9485,9519,18
Task 9486,Job 0,8,10,4,6,0,12,14,2,4,2,0,9486,9520,15
Task 9486,Job 1,13,9,4,7,0,17,20,3,4,1,0,9486,9520,12
Task 9487,Job 0,5,4,1,9,1,6,14,8,1,1,2,9487,9520,19
Task 9487,Job 1,10,6,4,8,0,14,18,4,4,4,1,9487,9520,11
Task 9488,Job 0,8,8,3,12,0,11,20,9,3,1,0,9488,9521,13
Task 9488,Job 1,13,6,1,9,1,14,22,8,1,2,2,9488,9521,11
Task 9489,Job 0,7,5,4,9,0,11,16,5,4,4,2,9489,9522,4
Task 9489,Job 1,12,6,2,10,0,14,22,8,2,4,1,9489,9522,7
Task 9490,Job 0,1,5,3,10,0,4,11,7,3,2,1,9490,9523,14
Task 9490,Job 1,6,4,2,11,1,8,17,9,2,4,0,9490,9523,3
Task 9491,Job 0,6,8,2,8,0,8,14,6,2,2,0,9491,9524,19
Task 9491,Job 1,11,7,1,9,0,12,20,8,1,4,0,9491,9524,4
Task 9492,Job 0,9,9,2,11,0,11,20,9,2,4,1,9492,9526,5
Task 9492,Job 1,14,10,3,10,0,17,24,7,3,1,2,9492,9526,7
Task 9493,Job 0,6,5,2,12,0,8,18,10,2,4,0,9493,9527,9
Task 9493,Job 1,11,10,2,12,0,13,23,10,2,1,2,9493,9527,19
Task 9494,Job 0,6,5,4,8,0,10,14,4,4,2,2,9494,9527,15
Task 9494,Job 1,11,10,1,6,0,12,17,5,1,1,1,9494,9527,3
Task 9495,Job 0,8,8,2,9,0,10,17,7,2,3,1,9495,9528,16
Task 9495,Job 1,13,7,4,11,0,17,24,7,4,4,1,9495,9528,10
Task 9496,Job 0,7,6,2,7,0,9,14,5,2,2,1,9496,9529,15
Task 9496,Job 1,12,5,3,10,0,15,22,7,3,4,0,9496,9529,13
Task 9497,Job 0,7,7,4,10,0,11,17,6,4,2,2,9497,9531,19
Task 9497,Job 1,12,5,1,10,0,13,22,9,1,2,2,9497,9531,14
Task 9498,Job 0,8,5,3,6,0,11,14,3,3,1,1,9498,9531,12
Task 9498,Job 1,13,7,2,11,0,15,24,9,2,4,0,9498,9531,2
Task 9499,Job 0,8,5,4,9,1,12,17,5,4,1,1,9499,9532,10
Task 9499,Job 1,13,9,4,6,1,17,19,2,4,2,2,9499,9532,19
Task 9500,Job 0,1,8,1,12,0,2,13,11,1,2,2,9500,9534,2
Task 9500,Job 1,6,8,3,9,0,9,15,6,3,2,0,9500,9534,16
Task 9501,Job 0,10,4,4,7,1,14,17,3,4,2,0,9501,9534,14
Task 9501,Job 1,15,7,4,10,0,19,25,6,4,1,1,9501,9534,8
Task 9502,Job 0,2,6,2,10,0,4,12,8,2,4,1,9502,9535,10
Task 9502,Job 1,7,9,4,12,1,11,19,8,4,2,1,9502,9535,13
Task 9503,Job 0,6,7,3,8,0,9,14,5,3,1,2,9503,9537,12
Task 9503,Job 1,11,5,1,7,0,12,18,6,1,2,0,9503,9537,11
Task 9504,Job 0,5,10,2,6,0,7,11,4,2,3,2,9504,9538,9
Task 9504,Job 1,10,4,2,9,0,12,19,7,2,1,0,9504,9538,12
Task 9505,Job 0,8,6,1,8,0,9,16,7,1,4,1,9505,9539,10
Task 9505,Job 1,13,6,2,12,0,15,25,10,2,4,1,9505,9539,11
Task 9506,Job 0,6,9,3,10,0,9,16,7,3,4,1,9506,9539,13
Task 9506,Job 1,11,5,2,11,0,13,22,9,2,1,0,9506,9539,5
Task 9507,Job 0,10,10,2,9,0,12,19,7,2,1,2,9507,9540,19
Task 9507,Job 1,15,7,2,8,0,17,23,6,2,2,2,9507,9540,12
Task 9508,Job 0,2,6,2,11,0,4,13,9,2,1,1,9508,9541,2
Task 9508,Job 1,7,6,1,7,0,8,14,6,1,2,1,9508,9541,10
Task 9509,Job 0,7,6,4,6,0,11,13,2,4,2,1,9509,9542,16
Task 9509,Job 1,12,10,3,11,1,15,23,8,3,3,2,9509,9542,12
Task 9510,Job 0,3,4,3,11,1,6,14,8,3,1,0,9510,9543,11
Task 9510,Job 1,8,8,4,12,0,12,20,8,4,3,1,9510,9543,5
Task 9511,Job 0,1,9,4,11,1,5,12,7,4,4,1,9511,9544,20
Task 9511,Job 1,6,4,4,12,0,10,18,8,4,3,2,9511,9544,17
Task 9512,Job 0,2,5,1,9,0,3,11,8,1,1,1,9512,9546,8
Task 9512,Job 1,7,6,2,12,1,9,19,10,2,4,1,9512,9546,19
Task 9513,Job 0,7,7,3,6,0,10,13,3,3,2,1,9513,9546,5
Task 9513,Job 1,12,9,3,8,0,15,20,5,3,3,2,9513,9546,6
Task 9514,Job 0,8,6,4,8,0,12,16,4,4,4,0,9514,9547,9
Task 9514,Job 1,13,10,2,10,0,15,23,8,2,4,1,9514,9547,11
Task 9515,Job 0,5,7,2,9,1,7,14,7,2,1,0,9515,9549,6
Task 9515,Job 1,10,4,4,9,0,14,19,5,4,4,1,9515,9549,3
Task 9516,Job 0,3,5,2,11,1,5,14,9,2,4,2,9516,9550,18
Task 9516,Job 1,8,9,1,12,0,9,20,11,1,3,2,9516,9550,2
Task 9517,Job 0,8,5,1,11,1,9,19,10,1,4,2,9517,9550,20
Task 9517,Job 1,13,5,4,6,1,17,19,2,4,3,1,9517,9550,12
Task 9518,Job 0,2,10,4,6,0,6,8,2,4,2,2,9518,9551,10
Task 9518,Job 1,7,4,4,9,1,11,16,5,4,4,2,9518,9551,16
Task 9519,Job 0,1,8,1,7,0,2,8,6,1,1,0,9519,9553,3
Task 9519,Job 1,6,10,3,10,0,9,16,7,3,1,1,9519,9553,19
Task 9520,Job 0,4,10,4,8,0,8,12,4,4,4,0,9520,9553,19
Task 9520,Job 1,9,10,3,12,0,12,21,9,3,2,2,9520,9553,13
Task 9521,Job 0,8,8,1,10,0,9,18,9,1,4,1,9521,9555,7
Task 9521,Job 1,13,10,1,7,0,14,20,6,1,3,2,9521,9555,2
Task 9522,Job 0,4,5,3,8,0,7,12,5,3,4,0,9522,9556,7
Task 9522,Job 1,9,5,3,10,0,12,19,7,3,1,0,9522,9556,3
Task 9523,Job 0,2,6,4,7,1,6,9,3,4,3,0,9523,9556,4
Task 9523,Job 1,7,10,1,10,0,8,17,9,1,3,2,9523,9556,18
Task 9524,Job 0,3,5,1,9,0,4,12,8,1,3,0,9524,9557,5
Task 9524,Job 1,8,9,2,9,0,10,17,7,2,4,2,9524,9557,14
Task 9525,Job 0,9,5,1,12,1,10,21,11,1,2,1,9525,9558,14
Task 9525,Job 1,14,10,1,7,1,15,21,6,1,2,0,9525,9558,9
Task 9526,Job 0,4,10,3,9,0,7,13,6,3,4,1,9526,9560,19
Task 9526,Job 1,9,9,3,8,0,12,17,5,3,2,2,9526,9560,20
Task 9527,Job 0,9,7,2,9,1,11,18,7,2,4,0,9527,9561,13
Task 9527,Job 1,14,9,2,11,0,16,25,9,2,4,2,9527,9561,7
Task 9528,Job 0,10,4,3,6,0,13,16,3,3,2,1,9528,9562,17
Task 9528,Job 1,15,5,2,6,1,17,21,4,2,1,1,9528,9562,11
Task 9529,Job 0,5,8,2,6,0,7,11,4,2,2,2,9529,9563,16
Task 9529,Job 1,10,8,1,11,0,11,21,10,1,2,2,9529,9563,19
Task 9530,Job 0,3,8,3,9,0,6,12,6,3,1,0,9530,9564,4
Task 9530,Job 1,8,4,2,10,0,10,18,8,2,2,0,9530,9564,20
Task 9531,Job 0,10,4,2,8,1,12,18,6,2,3,1,9531,9564,15
Task 9531,Job 1,15,4,4,10,0,19,25,6,4,4,1,9531,9564,17
Task 9532,Job 0,5,8,3,7,0,8,12,4,3,2,2,9532,9565,15
Task 9532,Job 1,10,6,4,9,0,14,19,5,4,3,2,9532,9565,2
Task 9533,Job 0,2,6,3,11,0,5,13,8,3,3,0,9533,9566,18
Task 9533,Job 1,7,9,1,6,0,8,13,5,1,1,2,9533,9566,17
Task 9534,Job 0,6,9,2,9,1,8,15,7,2,1,1,9534,9567,9
Task 9534,Job 1,11,7,2,12,0,13,23,10,2,1,1,9534,9567,12
Task 9535,Job 0,2,6,4,8,0,6,10,4,4,3,1,9535,9568,10
Task 9535,Job 1,7,8,2,9,0,9,16,7,2,1,1,9535,9568,18
Task 9536,Job 0,1,8,2,7,1,3,8,5,2,1,2,9536,9570,9
Task 9536,Job 1,6,5,3,10,0,9,16,7,3,4,0,9536,9570,14
Task 9537,Job 0,2,6,1,6,0,3,8,5,1,2,1,9537,9571,10
Task 9537,Job 1,7,8,4,9,1,11,16,5,4,4,1,9537,9571,2
Task 9538,Job 0,5,5,2,9,1,7,14,7,2,2,0,9538,9571,3
Task 9538,Job 1,10,10,1,10,0,11,20,9,1,4,0,9538,9571,18
Task 9539,Job 0,7,10,4,9,0,11,16,5,4,1,1,9539,9572,15
Task 9539,Job 1,12,6,3,12,0,15,24,9,3,4,2,9539,9572,20
Task 9540,Job 0,9,10,2,12,0,11,21,10,2,4,2,9540,9574,8
Task 9540,Job 1,14,4,2,9,0,16,23,7,2,2,0,9540,9574,18
Task 9541,Job 0,1,4,3,7,1,4,8,4,3,4,2,9541,9575,7
Task 9541,Job 1,6,6,1,11,1,7,17,10,1,4,0,9541,9575,10
Task 9542,Job 0,1,7,1,7,0,2,8,6,1,1,1,9542,9575,10
Task 9542,Job 1,6,4,4,11,1,10,17,7,4,1,1,9542,9575,19
Task 9543,Job 0,9,4,4,7,0,13,16,3,4,1,1,9543,9576,11
Task 9543,Job 1,14,8,1,11,0,15,25,10,1,2,2,9543,9576,3
Task 9544,Job 0,5,6,1,12,0,6,17,11,1,2,2,9544,9577,11
Task 9544,Job 1,10,4,2,12,0,12,22,10,2,3,2,9544,9577,13
Task 9545,Job 0,2,6,3,12,0,5,14,9,3,2,0,9545,9578,7
Task 9545,Job 1,7,7,1,9,1,8,16,8,1,2,1,9545,9578,16
Task 9546,Job 0,3,9,4,10,0,7,13,6,4,4,1,9546,9580,6
Task 9546,Job 1,8,8,2,7,0,10,15,5,2,1,2,9546,9580,17
Task 9547,Job 0,9,8,3,7,0,12,16,4,3,2,1,9547,9580,4
Task 9547,Job 1,14,6,3,11,0,17,25,8,3,1,1,9547,9580,8
Task 9548,Job 0,6,6,3,7,0,9,13,4,3,4,0,9548,9582,16
Task 9548,Job 1,11,10,2,10,0,13,21,8,2,3,1,9548,9582,2
Task 9549,Job 0,2,5,4,12,1,6,14,8,4,3,1,9549,9583,4
Task 9549,Job 1,7,10,4,10,1,11,17,6,4,1,0,9549,9583,5
Task 9550,Job 0,9,7,2,6,1,11,15,4,2,1,0,9550,9584,3
Task 9550,Job 1,14,10,4,8,0,18,22,4,4,1,0,9550,9584,14
Task 9551,Job 0,7,9,4,10,0,11,17,6,4,4,0,9551,9584,12
Task 9551,Job 1,12,4,2,11,0,14,23,9,2,4,1,9551,9584,3
Task 9552,Job 0,4,8,2,12,0,6,16,10,2,1,0,9552,9585,8
Task 9552,Job 1,9,4,2,11,1,11,20,9,2,1,2,9552,9585,11
Task 9553,Job 0,4,6,1,11,0,5,15,10,1,3,0,9553,9587,13
Task 9553,Job 1,9,7,3,12,0,12,21,9,3,4,1,9553,9587,15
Task 9554,Job 0,7,10,2,12,0,9,19,10,2,2,1,9554,9588,20
Task 9554,Job 1,12,8,1,11,0,13,23,10,1,2,0,9554,9588,2
Task 9555,Job 0,5,10,1,6,1,6,11,5,1,2,0,9555,9588,20
Task 9555,Job 1,10,8,2,10,0,12,20,8,2,4,1,9555,9588,19
Task 9556,Job 0,9,7,1,11,0,10,20,10,1,4,1,9556,9590,10
Task 9556,Job 1,14,10,4,9,0,18,23,5,4,3,1,9556,9590,7
Task 9557,Job 0,7,6,2,9,1,9,16,7,2,4,2,9557,9591,7
Task 9557,Job 1,12,4,4,7,0,16,19,3,4,3,0,9557,9591,10
Task 9558,Job 0,2,6,3,10,0,5,12,7,3,4,2,9558,9592,11
Task 9558,Job 1,7,4,4,11,0,11,18,7,4,2,2,9558,9592,20
Task 9559,Job 0,4,9,1,12,1,5,16,11,1,2,2,9559,9593,17
Task 9559,Job 1,9,7,1,8,0,10,17,7,1,4,0,9559,9593,3
Task 9560,Job 0,1,4,2,11,0,3,12,9,2,3,2,9560,9594,18
Task 9560,Job 1,6,5,4,9,0,10,15,5,4,4,0,9560,9594,20
Task 9561,Job 0,10,10,4,11,0,14,21,7,4,2,0,9561,9595,2
Task 9561,Job 1,15,5,2,8,0,17,23,6,2,2,1,9561,9595,5
Task 9562,Job 0,10,9,3,11,0,13,21,8,3,3,0,9562,9595,14
Task 9562,Job 1,15,10,1,8,0,16,23,7,1,2,2,9562,9595,8
Task 9563,Job 0,6,7,2,9,0,8,15,7,2,1,0,9563,9596,13
Task 9563,Job 1,11,5,3,12,0,14,23,9,3,4,0,9563,9596,12
Task 9564,Job 0,3,9,4,8,0,7,11,4,4,2,2,9564,9598,2
Task 9564,Job 1,8,5,1,8,1,9,16,7,1,1,2,9564,9598,14
Task 9565,Job 0,3,10,3,12,0,6,15,9,3,1,1,9565,9599,16
Task 9565,Job 1,8,10,1,6,0,9,14,5,1,1,1,9565,9599,14
Task 9566,Job 0,4,9,4,6,1,8,10,2,4,2,1,9566,9600,14
Task 9566,Job 1,9,9,1,8,0,10,17,7,1,2,1,9566,9600,3
Task 9567,Job 0,3,9,3,10,0,6,13,7,3,3,0,9567,9601,8
Task 9567,Job 1,8,10,1,6,1,9,14,5,1,1,2,9567,9601,9
Task 9568,Job 0,8,8,1,6,0,9,14,5,1,3,1,9568,9602,14
Task 9568,Job 1,13,8,1,10,0,14,23,9,1,1,2,9568,9602,16
Task 9569,Job 0,7,4,2,8,1,9,15,6,2,4,0,9569,9603,8
Task 9569,Job 1,12,10,3,8,0,15,20,5,3,3,1,9569,9603,9
Task 9570,Job 0,6,8,2,10,1,8,16,8,2,3,2,9570,9604,16
Task 9570,Job 1,11,8,2,7,0,13,18,5,2,4,2,9570,9604,3
Task 9571,Job 0,6,9,1,10,1,7,16,9,1,4,0,9571,9605,10
Task 9571,Job 1,11,4,3,7,0,14,18,4,3,1,1,9571,9605,3
Task 9572,Job 0,6,5,2,12,1,8,18,10,2,4,1,9572,9605,4
Task 9572,Job 1,11,10,2,8,0,13,19,6,2,1,0,9572,9605,12
Task 9573,Job 0,4,9,4,10,0,8,14,6,4,2,0,9573,9606,13
Task 9573,Job 1,9,8,3,6,0,12,15,3,3,3,0,9573,9606,9
Task 9574,Job 0,9,7,1,11,0,10,20,10,1,4,1,9574,9608,15
Task 9574,Job 1,14,7,4,8,1,18,22,4,4,4,2,9574,9608,9
Task 9575,Job 0,4,8,3,6,1,7,10,3,3,4,1,9575,9608,12
Task 9575,Job 1,9,9,3,12,0,12,21,9,3,1,1,9575,9608,18
Task 9576,Job 0,8,10,3,11,0,11,19,8,3,1,0,9576,9609,17
Task 9576,Job 1,13,4,1,8,0,14,21,7,1,2,0,9576,9609,6
Task 9577,Job 0,6,5,3,11,0,9,17,8,3,1,2,9577,9610,19
Task 9577,Job 1,11,10,4,6,1,15,17,2,4,4,1,9577,9610,5
Task 9578,Job 0,4,9,3,12,1,7,16,9,3,4,2,9578,9611,3
Task 9578,Job 1,9,4,1,11,0,10,20,10,1,1,0,9578,9611,12
Task 9579,Job 0,6,8,2,7,0,8,13,5,2,4,2,9579,9612,3
Task 9579,Job 1,11,5,4,10,1,15,21,6,4,3,0,9579,9612,9
Task 9580,Job 0,6,8,2,9,0,8,15,7,2,1,0,9580,9614,2
Task 9580,Job 1,11,7,3,8,1,14,19,5,3,1,2,9580,9614,19
Task 9581,Job 0,3,6,4,7,0,7,10,3,4,1,0,9581,9615,5
Task 9581,Job 1,8,10,3,8,0,11,16,5,3,4,1,9581,9615,4
Task 9582,Job 0,1,6,3,12,1,4,13,9,3,4,1,9582,9616,5
Task 9582,Job 1,6,10,1,8,0,7,14,7,1,2,1,9582,9616,19
Task 9583,Job 0,1,4,1,10,1,2,11,9,1,2,1,9583,9617,3
Task 9583,Job 1,6,9,3,10,1,9,16,7,3,4,2,9583,9617,15
Task 9584,Job 0,3,9,1,6,0,4,9,5,1,3,0,9584,9618,2
Task 9584,Job 1,8,9,2,7,0,10,15,5,2,2,2,9584,9618,7
Task 9585,Job 0,8,4,3,12,0,11,20,9,3,3,1,9585,9619,9
Task 9585,Job 1,13,9,3,6,0,16,19,3,3,3,2,9585,9619,6
Task 9586,Job 0,6,10,3,8,1,9,14,5,3,2,1,9586,9620,3
Task 9586,Job 1,11,6,1,11,0,12,22,10,1,2,1,9586,9620,17
Task 9587,Job 0,10,7,4,6,1,14,16,2,4,3,2,9587,9620,17
Task 9587,Job 1,15,10,1,10,1,16,25,9,1,4,0,9587,9620,4
Task 9588,Job 0,10,8,2,6,0,12,16,4,2,1,2,9588,9622,3
Task 9588,Job 1,15,6,1,12,0,16,27,11,1,3,0,9588,9622,9
Task 9589,Job 0,9,5,2,10,0,11,19,8,2,3,2,9589,9623,11
Task 9589,Job 1,14,10,2,8,0,16,22,6,2,3,1,9589,9623,5
Task 9590,Job 0,4,6,1,9,0,5,13,8,1,1,0,9590,9624,9
Task 9590,Job 1,9,9,2,8,0,11,17,6,2,4,0,9590,9624,20
Task 9591,Job 0,1,7,1,12,0,2,13,11,1,1,2,9591,9624,13
Task 9591,Job 1,6,4,1,8,0,7,14,7,1,3,2,9591,9624,4
Task 9592,Job 0,2,4,3,12,0,5,14,9,3,3,1,9592,9625,16
Task 9592,Job 1,7,4,2,8,0,9,15,6,2,3,2,9592,9625,18
Task 9593,Job 0,8,10,4,7,1,12,15,3,4,2,1,9593,9626,7
Task 9593,Job 1,13,6,3,11,1,16,24,8,3,3,2,9593,9626,5
Task 9594,Job 0,9,10,3,10,1,12,19,7,3,2,1,9594,9627,10
Task 9594,Job 1,14,4,4,10,1,18,24,6,4,2,0,9594,9627,13
Task 9595,Job 0,9,9,1,12,0,10,21,11,1,2,1,9595,9629,3
Task 9595,Job 1,14,8,1,8,0,15,22,7,1,1,0,9595,9629,4
Task 9596,Job 0,1,9,2,7,0,3,8,5,2,3,0,9596,9629,19
Task 9596,Job 1,6,10,1,8,0,7,14,7,1,1,0,9596,9629,13
Task 9597,Job 0,4,8,3,8,1,7,12,5,3,3,2,9597,9630,20
Task 9597,Job 1,9,7,2,8,0,11,17,6,2,4,1,9597,9630,14
Task 9598,Job 0,9,5,2,8,0,11,17,6,2,1,1,9598,9632,12
Task 9598,Job 1,14,7,1,8,0,15,22,7,1,3,2,9598,9632,3
Task 9599,Job 0,1,6,4,8,0,5,9,4,4,2,2,9599,9633,12
Task 9599,Job 1,6,6,2,12,1,8,18,10,2,2,2,9599,9633,16
Task 9600,Job 0,8,7,3,9,0,11,17,6,3,3,0,9600,9633,3
Task 9600,Job 1,13,10,2,9,0,15,22,7,2,4,1,9600,9633,14
Task 9601,Job 0,7,9,3,10,0,10,17,7,3,1,0,9601,9634,7
Task 9601,Job 1,12,8,1,10,0,13,22,9,1,3,0,9601,9634,19
Task 9602,Job 0,6,4,3,12,0,9,18,9,3,4,0,9602,9635,10
Task 9602,Job 1,11,6,2,11,0,13,22,9,2,4,1,9602,9635,8
Task 9603,Job 0,9,9,4,12,0,13,21,8,4,4,1,9603,9636,13
Task 9603,Job 1,14,7,4,11,0,18,25,7,4,2,1,9603,9636,15
Task 9604,Job 0,2,10,3,6,1,5,8,3,3,3,2,9604,9638,12
Task 9604,Job 1,7,5,3,12,0,10,19,9,3,1,0,9604,9638,7
Task 9605,Job 0,4,6,1,6,0,5,10,5,1,1,2,9605,9638,20
Task 9605,Job 1,9,10,3,8,0,12,17,5,3,4,2,9605,9638,6
Task 9606,Job 0,4,8,3,11,0,7,15,8,3,4,2,9606,9639,7
Task 9606,Job 1,9,7,4,6,0,13,15,2,4,4,0,9606,9639,6
Task 9607,Job 0,9,9,2,11,0,11,20,9,2,4,0,9607,9641,12
Task 9607,Job 1,14,9,2,10,0,16,24,8,2,4,0,9607,9641,12
Task 9608,Job 0,10,4,4,11,0,14,21,7,4,3,1,9608,9642,5
Task 9608,Job 1,15,6,2,9,0,17,24,7,2,4,1,9608,9642,9
Task 9609,Job 0,4,9,4,8,0,8,12,4,4,4,1,9609,9642,5
Task 9609,Job 1,9,9,2,9,0,11,18,7,2,2,1,9609,9642,4
Task 9610,Job 0,6,8,4,8,0,10,14,4,4,2,2,9610,9643,6
Task 9610,Job 1,11,9,4,9,1,15,20,5,4,1,1,9610,9643,8
Task 9611,Job 0,8,5,4,9,0,12,17,5,4,3,1,9611,9644,3
Task 9611,Job 1,13,6,2,6,0,15,19,4,2,2,2,9611,9644,15
Task 9612,Job 0,4,8,1,9,0,5,13,8,1,1,2,9612,9645,16
Task 9612,Job 1,9,10,3,11,0,12,20,8,3,3,1,9612,9645,16
Task 9613,Job 0,1,8,2,8,0,3,9,6,2,1,2,9613,9647,11
Task 9613,Job 1,6,5,4,9,0,10,15,5,4,2,0,9613,9647,19
Task 9614,Job 0,8,4,1,11,0,9,19,10,1,1,2,9614,9648,19
Task 9614,Job 1,13,10,4,10,0,17,23,6,4,3,1,9614,9648,5
Task 9615,Job 0,5,4,3,10,0,8,15,7,3,2,2,9615,9649,16
Task 9615,Job 1,10,4,2,9,0,12,19,7,2,2,1,9615,9649,8
Task 9616,Job 0,7,4,4,11,0,11,18,7,4,4,2,9616,9650,7
Task 9616,Job 1,12,10,3,6,1,15,18,3,3,1,1,9616,9650,6
Task 9617,Job 0,2,9,4,11,0,6,13,7,4,4,2,9617,9650,18
Task 9617,Job 1,7,9,2,12,0,9,19,10,2,3,1,9617,9650,6
Task 9618,Job 0,1,9,2,7,0,3,8,5,2,3,0,9618,9651,4
Task 9618,Job 1,6,7,1,9,0,7,15,8,1,4,2,9618,9651,8
Task 9619,Job 0,3,4,3,6,0,6,9,3,3,1,0,9619,9652,19
Task 9619,Job 1,8,4,4,7,0,12,15,3,4,1,0,9619,9652,14
Task 9620,Job 0,9,5,1,12,0,10,21,11,1,4,1,9620,9653,14
Task 9620,Job 1,14,10,2,9,0,16,23,7,2,4,1,9620,9653,7
Task 9621,Job 0,7,5,2,8,0,9,15,6,2,4,1,9621,9654,12
Task 9621,Job 1,12,10,1,9,0,13,21,8,1,4,1,9621,9654,18
Task 9622,Job 0,2,9,4,8,0,6,10,4,4,1,0,9622,9655,19
Task 9622,Job 1,7,7,3,10,1,10,17,7,3,4,2,9622,9655,5
Task 9623,Job 0,10,6,2,10,0,12,20,8,2,2,2,9623,9656,13
Task 9623,Job 1,15,7,3,6,1,18,21,3,3,2,0,9623,9656,4
Task 9624,Job 0,7,5,4,7,0,11,14,3,4,1,1,9624,9658,14
Task 9624,Job 1,12,5,2,8,0,14,20,6,2,1,1,9624,9658,20
Task 9625,Job 0,5,9,2,7,0,7,12,5,2,3,0,9625,9659,15
Task 9625,Job 1,10,4,1,12,1,11,22,11,1,2,1,9625,9659,17
Task 9626,Job 0,9,7,4,12,0,13,21,8,4,2,1,9626,9659,3
Task 9626,Job 1,14,7,2,7,0,16,21,5,2,4,1,9626,9659,3
Task 9627,Job 0,9,9,1,11,0,10,20,10,1,4,2,9627,9661,3
Task 9627,Job 1,14,9,1,9,1,15,23,8,1,2,2,9627,9661,19
Task 9628,Job 0,9,7,3,11,0,12,20,8,3,2,2,9628,9662,5
Task 9628,Job 1,14,4,1,9,1,15,23,8,1,1,2,9628,9662,7
Task 9629,Job 0,7,10,3,12,0,10,19,9,3,3,1,9629,9663,6
Task 9629,Job 1,12,6,4,10,0,16,22,6,4,2,2,9629,9663,16
Task 9630,Job 0,10,8,2,10,0,12,20,8,2,2,0,9630,9663,6
Task 9630,Job 1,15,9,2,12,1,17,27,10,2,2,0,9630,9663,14
Task 9631,Job 0,5,8,1,6,1,6,11,5,1,4,2,9631,9665,10
Task 9631,Job 1,10,4,2,11,0,12,21,9,2,1,0,9631,9665,10
Task 9632,Job 0,7,6,3,10,0,10,17,7,3,2,1,9632,9666,17
Task 9632,Job 1,12,4,3,10,0,15,22,7,3,1,2,9632,9666,19
Task 9633,Job 0,8,5,3,10,0,11,18,7,3,2,2,9633,9667,10
Task 9633,Job 1,13,4,4,12,1,17,25,8,4,4,0,9633,9667,15
Task 9634,Job 0,3,7,4,9,1,7,12,5,4,4,0,9634,9667,16
Task 9634,Job 1,8,9,2,7,0,10,15,5,2,1,0,9634,9667,2
Task 9635,Job 0,6,8,3,6,0,9,12,3,3,1,1,9635,9668,12
Task 9635,Job 1,11,5,3,12,0,14,23,9,3,2,0,9635,9668,3
Task 9636,Job 0,6,8,3,6,0,9,12,3,3,2,0,9636,9670,5
Task 9636,Job 1,11,8,1,12,0,12,23,11,1,2,2,9636,9670,11
Task 9637,Job 0,8,4,1,8,0,9,16,7,1,2,0,9637,9670,8
Task 9637,Job 1,13,9,2,11,0,15,24,9,2,3,2,9637,9670,7
Task 9638,Job 0,6,8,1,11,0,7,17,10,1,4,0,9638,9671,14
Task 9638,Job 1,11,7,1,9,0,12,20,8,1,2,2,9638,9671,9
Task 9639,Job 0,3,8,1,9,1,4,12,8,1,4,0,9639,9672,6
Task 9639,Job 1,8,6,4,11,0,12,19,7,4,2,2,9639,9672,20
Task 9640,Job 0,4,6,2,6,0,6,10,4,2,2,2,9640,9674,8
Task 9640,Job 1,9,8,2,9,0,11,18,7,2,2,1,9640,9674,3
Task 9641,Job 0,3,8,2,9,1,5,12,7,2,1,0,9641,9674,17
Task 9641,Job 1,8,4,3,8,1,11,16,5,3,2,1,9641,9674,13
Task 9642,Job 0,7,5,2,12,0,9,19,10,2,2,2,9642,9676,11
Task 9642,Job 1,12,4,1,7,1,13,19,6,1,2,0,9642,9676,12
Task 9643,Job 0,10,4,2,10,0,12,20,8,2,2,1,9643,9676,2
Task 9643,Job 1,15,7,4,10,1,19,25,6,4,1,2,9643,9676,18
Task 9644,Job 0,7,9,3,8,0,10,15,5,3,2,2,9644,9677,2
Task 9644,Job 1,12,5,3,10,0,15,22,7,3,1,1,9644,9677,17
Task 9645,Job 0,1,5,2,8,1,3,9,6,2,4,1,9645,9679,11
Task 9645,Job 1,6,4,3,7,0,9,13,4,3,4,2,9645,9679,14
Task 9646,Job 0,4,9,4,10,0,8,14,6,4,3,1,9646,9679,18
Task 9646,Job 1,9,7,1,8,0,10,17,7,1,1,0,9646,9679,11
Task 9647,Job 0,8,7,3,9,0,11,17,6,3,4,1,9647,9680,3
Task 9647,Job 1,13,5,4,11,0,17,24,7,4,2,2,9647,9680,16
Task 9648,Job 0,2,5,3,6,0,5,8,3,3,4,2,9648,9682,4
Task 9648,Job 1,7,6,3,6,0,10,13,3,3,4,0,9648,9682,5
Task 9649,Job 0,2,9,2,11,0,4,13,9,2,3,0,9649,9682,3
Task 9649,Job 1,7,10,3,11,1,10,18,8,3,2,0,9649,9682,10
Task 9650,Job 0,3,7,1,11,0,4,14,10,1,1,1,9650,9684,17
Task 9650,Job 1,8,7,4,6,1,12,14,2,4,3,0,9650,9684,7
Task 9651,Job 0,8,8,4,10,0,12,18,6,4,4,2,9651,9684,15
Task 9651,Job 1,13,5,3,12,1,16,25,9,3,3,0,9651,9684,11
Task 9652,Job 0,1,6,4,10,0,5,11,6,4,4,1,9652,9686,15
Task 9652,Job 1,6,10,3,7,0,9,13,4,3,3,0,9652,9686,13
Task 9653,Job 0,4,8,2,7,0,6,11,5,2,4,0,9653,9687,11
Task 9653,Job 1,9,9,2,10,1,11,19,8,2,4,2,9653,9687,4
Task 9654,Job 0,9,9,3,10,1,12,19,7,3,1,2,9654,9687,14
Task 9654,Job 1,14,10,2,7,0,16,21,5,2,3,2,9654,9687,2
Task 9655,Job 0,10,10,3,11,0,13,21,8,3,2,1,9655,9688,2
Task 9655,Job 1,15,9,2,12,0,17,27,10,2,2,1,9655,9688,10
Task 9656,Job 0,9,8,3,11,0,12,20,8,3,4,2,9656,9690,8
Task 9656,Job 1,14,10,4,12,0,18,26,8,4,2,2,9656,9690,16
Task 9657,Job 0,8,7,3,7,1,11,15,4,3,2,0,9657,9691,18
Task 9657,Job 1,13,4,2,11,0,15,24,9,2,1,2,9657,9691,5
Task 9658,Job 0,8,10,3,12,0,11,20,9,3,2,1,9658,9692,12
Task 9658,Job 1,13,6,2,8,0,15,21,6,2,1,1,9658,9692,12
Task 9659,Job 0,6,7,3,11,1,9,17,8,3,1,2,9659,9692,13
Task 9659,Job 1,11,7,1,7,0,12,18,6,1,3,1,9659,9692,7
Task 9660,Job 0,4,7,2,7,0,6,11,5,2,2,1,9660,9693,8
Task 9660,Job 1,9,9,4,7,1,13,16,3,4,4,0,9660,9693,11
Task 9661,Job 0,1,10,4,8,0,5,9,4,4,3,1,9661,9695,8
Task 9661,Job 1,6,4,3,8,0,9,14,5,3,4,1,9661,9695,16
Task 9662,Job 0,10,5,4,12,0,14,22,8,4,4,2,9662,9695,3
Task 9662,Job 1,15,8,3,11,0,18,26,8,3,1,0,9662,9695,19
Task 9663,Job 0,8,9,1,12,0,9,20,11,1,2,2,9663,9697,17
Task 9663,Job 1,13,5,4,7,1,17,20,3,4,4,0,9663,9697,19
Task 9664,Job 0,1,10,3,12,0,4,13,9,3,3,0,9664,9698,8
Task 9664,Job 1,6,8,1,9,1,7,15,8,1,2,2,9664,9698,15
Task 9665,Job 0,6,4,4,7,1,10,13,3,4,2,1,9665,9698,4
Task 9665,Job 1,11,4,2,6,1,13,17,4,2,3,0,9665,9698,12
Task 9666,Job 0,6,6,4,7,1,10,13,3,4,3,0,9666,9700,13
Task 9666,Job 1,11,9,1,8,1,12,19,7,1,4,1,9666,9700,4
Task 9667,Job 0,6,5,3,11,1,9,17,8,3,4,2,9667,9700,12
Task 9667,Job 1,11,6,3,8,0,14,19,5,3,3,2,9667,9700,19
Task 9668,Job 0,7,7,1,8,0,8,15,7,1,3,1,9668,9702,19
Task 9668,Job 1,12,5,1,9,0,13,21,8,1,1,0,9668,9702,8
Task 9669,Job 0,4,8,4,11,0,8,15,7,4,4,0,9669,9702,19
Task 9669,Job 1,9,6,2,6,0,11,15,4,2,1,0,9669,9702,13
Task 9670,Job 0,2,8,3,11,1,5,13,8,3,2,1,9670,9704,14
Task 9670,Job 1,7,7,1,10,0,8,17,9,1,2,1,9670,9704,2
Task 9671,Job 0,9,6,4,6,1,13,15,2,4,4,2,9671,9704,20
Task 9671,Job 1,14,8,1,7,1,15,21,6,1,1,1,9671,9704,14
Task 9672,Job 0,4,8,2,7,0,6,11,5,2,3,0,9672,9706,9
Task 9672,Job 1,9,6,1,6,0,10,15,5,1,2,2,9672,9706,6
Task 9673,Job 0,7,9,4,6,0,11,13,2,4,4,2,9673,9707,4
Task 9673,Job 1,12,8,2,10,0,14,22,8,2,1,0,9673,9707,2
Task 9674,Job 0,6,6,3,7,1,9,13,4,3,4,0,9674,9707,9
Task 9674,Job 1,11,7,1,11,1,12,22,10,1,4,2,9674,9707,17
Task 9675,Job 0,6,9,1,8,0,7,14,7,1,1,2,9675,9708,6
Task 9675,Job 1,11,5,1,10,1,12,21,9,1,1,0,9675,9708,2
Task 9676,Job 0,4,4,1,10,0,5,14,9,1,4,1,9676,9709,3
Task 9676,Job 1,9,5,2,10,1,11,19,8,2,4,1,9676,9709,6
Task 9677,Job 0,7,10,4,10,0,11,17,6,4,3,2,9677,9710,2
Task 9677,Job 1,12,8,2,7,0,14,19,5,2,1,2,9677,9710,15
Task 9678,Job 0,9,6,3,10,1,12,19,7,3,1,0,9678,9711,5
Task 9678,Job 1,14,6,2,10,1,16,24,8,2,2,2,9678,9711,18
Task 9679,Job 0,8,7,4,9,0,12,17,5,4,2,1,9679,9712,14
Task 9679,Job 1,13,9,2,6,0,15,19,4,2,4,1,9679,9712,20
Task 9680,Job 0,7,6,4,12,0,11,19,8,4,1,0,9680,9714,3
Task 9680,Job 1,12,6,1,7,0,13,19,6,1,4,1,9680,9714,9
Task 9681,Job 0,10,9,2,6,0,12,16,4,2,3,0,9681,9715,11
Task 9681,Job 1,15,8,4,7,0,19,22,3,4,2,1,9681,9715,19
Task 9682,Job 0,8,8,2,6,0,10,14,4,2,3,0,9682,9716,14
Task 9682,Job 1,13,5,3,10,0,16,23,7,3,4,0,9682,9716,16
Task 9683,Job 0,10,7,1,12,1,11,22,11,1,2,2,9683,9716,4
Task 9683,Job 1,15,9,4,11,0,19,26,7,4,4,0,9683,9716,14
Task 9684,Job 0,5,8,1,7,0,6,12,6,1,2,0,9684,9717,14
Task 9684,Job 1,10,4,3,10,0,13,20,7,3,1,1,9684,9717,6
Task 9685,Job 0,8,9,3,8,1,11,16,5,3,4,0,9685,9718,11
Task 9685,Job 1,13,9,2,12,0,15,25,10,2,1,0,9685,9718,12
Task 9686,Job 0,7,7,4,12,0,11,19,8,4,2,0,9686,9720,3
Task 9686,Job 1,12,8,3,12,0,15,24,9,3,4,2,9686,9720,18
Task 9687,Job 0,1,7,2,11,0,3,12,9,2,1,1,9687,9721,3
Task 9687,Job 1,6,4,4,9,0,10,15,5,4,4,0,9687,9721,17
Task 9688,Job 0,5,4,2,11,0,7,16,9,2,4,2,9688,9721,17
Task 9688,Job 1,10,6,4,6,0,14,16,2,4,3,0,9688,9721,9
Task 9689,Job 0,7,6,3,12,1,10,19,9,3,3,0,9689,9723,16
Task 9689,Job 1,12,6,2,8,0,14,20,6,2,2,1,9689,9723,2
Task 9690,Job 0,7,8,4,6,0,11,13,2,4,2,0,9690,9724,13
Task 9690,Job 1,12,4,2,10,1,14,22,8,2,1,0,9690,9724,8
Task 9691,Job 0,7,9,1,9,0,8,16,8,1,3,1,9691,9725,9
Task 9691,Job 1,12,8,2,11,0,14,23,9,2,3,2,9691,9725,12
Task 9692,Job 0,9,8,4,11,1,13,20,7,4,3,0,9692,9726,2
Task 9692,Job 1,14,7,4,7,0,18,21,3,4,4,0,9692,9726,11
Task 9693,Job 0,8,10,2,10,0,10,18,8,2,1,2,9693,9727,7
Task 9693,Job 1,13,6,2,9,1,15,22,7,2,1,0,9693,9727,8
Task 9694,Job 0,5,8,3,6,0,8,11,3,3,3,0,9694,9727,14
Task 9694,Job 1,10,9,4,9,0,14,19,5,4,3,2,9694,9727,3
Task 9695,Job 0,9,8,2,8,1,11,17,6,2,1,0,9695,9728,11
Task 9695,Job 1,14,5,4,12,0,18,26,8,4,4,1,9695,9728,4
Task 9696,Job 0,5,5,3,11,0,8,16,8,3,4,0,9696,9729,12
Task 9696,Job 1,10,9,1,10,1,11,20,9,1,2,2,9696,9729,6
Task 9697,Job 0,10,10,4,12,1,14,22,8,4,2,0,9697,9731,2
Task 9697,Job 1,15,9,2,11,1,17,26,9,2,2,2,9697,9731,20
Task 9698,Job 0,8,4,1,8,0,9,16,7,1,1,0,9698,9731,11
Task 9698,Job 1,13,4,4,8,0,17,21,4,4,3,0,9698,9731,14
Task 9699,Job 0,6,6,1,8,1,7,14,7,1,4,0,9699,9732,3
Task 9699,Job 1,11,8,4,10,0,15,21,6,4,4,0,9699,9732,2
Task 9700,Job 0,7,6,2,10,1,9,17,8,2,1,0,9700,9733,19
Task 9700,Job 1,12,9,4,8,1,16,20,4,4,2,0,9700,9733,3
Task 9701,Job 0,3,9,2,10,1,5,13,8,2,3,2,9701,9735,5
Task 9701,Job 1,8,6,3,12,1,11,20,9,3,4,2,9701,9735,20
Task 9702,Job 0,9,6,4,12,0,13,21,8,4,4,1,9702,9736,3
Task 9702,Job 1,14,10,4,6,0,18,20,2,4,1,1,9702,9736,16
Task 9703,Job 0,1,10,3,7,0,4,8,4,3,1,1,9703,9736,15
Task 9703,Job 1,6,7,4,6,0,10,12,2,4,2,0,9703,9736,10
Task 9704,Job 0,9,8,1,6,1,10,15,5,1,1,1,9704,9738,4
Task 9704,Job 1,14,6,3,8,0,17,22,5,3,2,2,9704,9738,17
Task 9705,Job 0,7,9,3,6,0,10,13,3,3,1,2,9705,9739,15
Task 9705,Job 1,12,6,4,10,0,16,22,6,4,4,2,9705,9739,19
Task 9706,Job 0,6,4,1,7,0,7,13,6,1,3,2,9706,9740,10
Task 9706,Job 1,11,4,2,8,0,13,19,6,2,1,2,9706,9740,9
Task 9707,Job 0,10,10,1,9,0,11,19,8,1,2,0,9707,9740,11
Task 9707,Job 1,15,6,2,10,1,17,25,8,2,3,1,9707,9740,11
Task 9708,Job 0,5,7,4,8,0,9,13,4,4,1,1,9708,9741,5
Task 9708,Job 1,10,7,4,6,0,14,16,2,4,2,1,9708,9741,9
Task 9709,Job 0,3,5,1,8,0,4,11,7,1,4,1,9709,9742,4
Task 9709,Job 1,8,8,1,12,0,9,20,11,1,2,1,9709,9742,11
Task 9710,Job 0,5,7,1,8,0,6,13,7,1,4,2,9710,9744,5
Task 9710,Job 1,10,4,1,7,0,11,17,6,1,4,0,9710,9744,14
Task 9711,Job 0,10,9,1,11,0,11,21,10,1,1,0,9711,9745,3
Task 9711,Job 1,15,8,1,6,0,16,21,5,1,2,2,9711,9745,16
Task 9712,Job 0,3,7,4,10,0,7,13,6,4,4,1,9712,9745,15
Task 9712,Job 1,8,8,3,9,0,11,17,6,3,1,0,9712,9745,17
Task 9713,Job 0,6,5,4,10,0,10,16,6,4,3,2,9713,9746,15
Task 9713,Job 1,11,9,1,7,0,12,18,6,1,1,0,9713,9746,2
Task 9714,Job 0,6,10,3,8,0,9,14,5,3,3,1,9714,9748,9
Task 9714,Job 1,11,10,1,6,0,12,17,5,1,4,1,9714,9748,7
Task 9715,Job 0,9,6,4,12,0,13,21,8,4,4,0,9715,9749,18
Task 9715,Job 1,14,8,1,7,0,15,21,6,1,1,2,9715,9749,14
Task 9716,Job 0,9,6,2,6,0,11,15,4,2,4,2,9716,9749,10
Task 9716,Job 1,14,8,2,7,0,16,21,5,2,2,0,9716,9749,4
Task 9717,Job 0,8,9,4,10,0,12,18,6,4,4,0,9717,9751,18
Task 9717,Job 1,13,4,4,12,1,17,25,8,4,1,2,9717,9751,6
Task 9718,Job 0,4,4,3,10,1,7,14,7,3,2,1,9718,9751,20
Task 9718,Job 1,9,7,1,11,0,10,20,10,1,2,2,9718,9751,14
Task 9719,Job 0,5,9,3,6,0,8,11,3,3,2,1,9719,9752,9
Task 9719,Job 1,10,8,1,6,0,11,16,5,1,3,1,9719,9752,5
Task 9720,Job 0,3,4,4,8,0,7,11,4,4,4,2,9720,9754,15
Task 9720,Job 1,8,10,2,10,1,10,18,8,2,2,2,9720,9754,6
Task 9721,Job 0,6,4,3,6,0,9,12,3,3,1,2,9721,9755,5
Task 9721,Job 1,11,6,1,12,0,12,23,11,1,1,0,9721,9755,14
Task 9722,Job 0,8,7,3,12,0,11,20,9,3,4,0,9722,9755,5
Task 9722,Job 1,13,9,4,12,0,17,25,8,4,3,1,9722,9755,16
Task 9723,Job 0,10,6,3,11,0,13,21,8,3,1,0,9723,9756,7
Task 9723,Job 1,15,7,2,7,0,17,22,5,2,4,1,9723,9756,8
Task 9724,Job 0,2,5,2,8,0,4,10,6,2,2,1,9724,9758,11
Task 9724,Job 1,7,6,2,11,0,9,18,9,2,3,2,9724,9758,11
Task 9725,Job 0,5,6,4,8,0,9,13,4,4,3,1,9725,9758,20
Task 9725,Job 1,10,5,1,8,0,11,18,7,1,2,2,9725,9758,6
Task 9726,Job 0,7,8,4,9,1,11,16,5,4,3,0,9726,9760,20
Task 9726,Job 1,12,5,3,12,0,15,24,9,3,1,0,9726,9760,9
Task 9727,Job 0,5,9,2,6,0,7,11,4,2,2,0,9727,9761,11
Task 9727,Job 1,10,5,1,8,1,11,18,7,1,2,1,9727,9761,3
Task 9728,Job 0,5,5,1,6,0,6,11,5,1,4,0,9728,9762,7
Task 9728,Job 1,10,10,3,12,0,13,22,9,3,2,1,9728,9762,10
Task 9729,Job 0,3,7,3,7,0,6,10,4,3,1,2,9729,9763,2
Task 9729,Job 1,8,5,1,8,1,9,16,7,1,2,2,9729,9763,13
Task 9730,Job 0,1,9,2,8,1,3,9,6,2,1,0,9730,9764,3
Task 9730,Job 1,6,6,1,7,0,7,13,6,1,3,1,9730,9764,13
Task 9731,Job 0,8,4,4,9,0,12,17,5,4,1,0,9731,9765,13
Task 9731,Job 1,13,8,4,7,0,17,20,3,4,2,2,9731,9765,16
Task 9732,Job 0,9,9,3,11,0,12,20,8,3,1,1,9732,9766,11
Task 9732,Job 1,14,9,1,12,0,15,26,11,1,1,1,9732,9766,13
Task 9733,Job 0,1,7,1,7,1,2,8,6,1,1,1,9733,9766,6
Task 9733,Job 1,6,9,1,8,1,7,14,7,1,3,1,9733,9766,17
Task 9734,Job 0,4,6,1,12,1,5,16,11,1,2,0,9734,9767,15
Task 9734,Job 1,9,8,4,9,0,13,18,5,4,2,0,9734,9767,4
Task 9735,Job 0,1,10,3,12,1,4,13,9,3,1,1,9735,9768,11
Task 9735,Job 1,6,5,1,8,0,7,14,7,1,2,0,9735,9768,16
Task 9736,Job 0,5,7,2,12,1,7,17,10,2,2,0,9736,9769,13
Task 9736,Job 1,10,9,1,12,1,11,22,11,1,4,0,9736,9769,6
Task 9737,Job 0,1,4,1,10,0,2,11,9,1,2,1,9737,9771,20
Task 9737,Job 1,6,10,4,12,0,10,18,8,4,1,0,9737,9771,13
Task 9738,Job 0,6,8,4,8,0,10,14,4,4,1,2,9738,9772,20
Task 9738,Job 1,11,6,3,11,0,14,22,8,3,4,1,9738,9772,2
Task 9739,Job 0,2,9,1,10,1,3,12,9,1,3,1,9739,9773,10
Task 9739,Job 1,7,9,2,8,0,9,15,6,2,3,0,9739,9773,16
Task 9740,Job 0,10,7,1,9,0,11,19,8,1,3,2,9740,9774,16
Task 9740,Job 1,15,8,1,10,0,16,25,9,1,3,0,9740,9774,18
Task 9741,Job 0,5,8,1,10,0,6,15,9,1,4,1,9741,9775,14
Task 9741,Job 1,10,6,4,8,0,14,18,4,4,3,1,9741,9775,7
Task 9742,Job 0,7,5,3,10,0,10,17,7,3,4,1,9742,9775,10
Task 9742,Job 1,12,9,4,12,1,16,24,8,4,2,2,9742,9775,7
Task 9743,Job 0,8,7,3,11,0,11,19,8,3,4,0,9743,9777,8
Task 9743,Job 1,13,4,3,9,0,16,22,6,3,4,1,9743,9777,8
Task 9744,Job 0,9,10,3,6,1,12,15,3,3,4,1,9744,9777,11
Task 9744,Job 1,14,7,1,8,0,15,22,7,1,1,1,9744,9777,3
Task 9745,Job 0,7,8,1,9,1,8,16,8,1,1,0,9745,9778,6
Task 9745,Job 1,12,7,4,6,0,16,18,2,4,1,1,9745,9778,10
Task 9746,Job 0,2,7,2,12,1,4,14,10,2,1,0,9746,9780,10
Task 9746,Job 1,7,4,2,11,0,9,18,9,2,1,2,9746,9780,14
Task 9747,Job 0,10,7,4,11,0,14,21,7,4,2,2,9747,9780,20
Task 9747,Job 1,15,7,4,11,0,19,26,7,4,1,2,9747,9780,11
Task 9748,Job 0,5,7,2,10,0,7,15,8,2,1,1,9748,9782,10
Task 9748,Job 1,10,4,2,7,0,12,17,5,2,1,2,9748,9782,2
Task 9749,Job 0,6,8,1,9,0,7,15,8,1,1,1,9749,9782,15
Task 9749,Job 1,11,5,4,8,0,15,19,4,4,3,2,9749,9782,10
Task 9750,Job 0,5,5,1,7,1,6,12,6,1,1,1,9750,9783,14
Task 9750,Job 1,10,6,3,8,0,13,18,5,3,3,2,9750,9783,4
Task 9751,Job 0,5,5,4,7,0,9,12,3,4,2,0,9751,9784,12
Task 9751,Job 1,10,6,2,7,0,12,17,5,2,4,1,9751,9784,13
Task 9752,Job 0,4,9,4,6,0,8,10,2,4,3,2,9752,9785,18
Task 9752,Job 1,9,10,4,10,0,13,19,6,4,2,2,9752,9785,13
Task 9753,Job 0,3,6,2,6,0,5,9,4,2,3,1,9753,9786,17
Task 9753,Job 1,8,7,1,7,0,9,15,6,1,4,0,9753,9786,20
Task 9754,Job 0,9,4,1,12,0,10,21,11,1,2,2,9754,9787,17
Task 9754,Job 1,14,7,4,12,0,18,26,8,4,3,2,9754,9787,14
Task 9755,Job 0,2,4,1,7,1,3,9,6,1,2,0,9755,9788,19
Task 9755,Job 1,7,6,1,10,0,8,17,9,1,4,2,9755,9788,12
Task 9756,Job 0,10,7,1,6,0,11,16,5,1,1,0,9756,9789,8
Task 9756,Job 1,15,10,4,9,0,19,24,5,4,3,1,9756,9789,15
Task 9757,Job 0,6,10,4,8,0,10,14,4,4,3,0,9757,9791,20
Task 9757,Job 1,11,5,4,12,0,15,23,8,4,4,0,9757,9791,14
Task 9758,Job 0,8,6,1,11,1,9,19,10,1,3,1,9758,9791,17
Task 9758,Job 1,13,5,2,10,0,15,23,8,2,1,0,9758,9791,13
Task 9759,Job 0,8,8,1,9,0,9,17,8,1,4,2,9759,9793,10
Task 9759,Job 1,13,8,2,9,0,15,22,7,2,2,0,9759,9793,3
Task 9760,Job 0,6,8,2,10,1,8,16,8,2,4,1,9760,9794,3
Task 9760,Job 1,11,5,1,12,0,12,23,11,1,4,1,9760,9794,8
Task 9761,Job 0,10,6,2,7,0,12,17,5,2,3,1,9761,9795,20
Task 9761,Job 1,15,6,3,8,0,18,23,5,3,4,0,9761,9795,7
Task 9762,Job 0,5,10,1,11,0,6,16,10,1,2,2,9762,9795,20
Task 9762,Job 1,10,8,1,9,0,11,19,8,1,4,1,9762,9795,3
Task 9763,Job 0,10,8,1,10,0,11,20,9,1,4,1,9763,9797,9
Task 9763,Job 1,15,6,2,9,1,17,24,7,2,1,0,9763,9797,11
Task 9764,Job 0,9,5,4,11,1,13,20,7,4,3,1,9764,9798,3
Task 9764,Job 1,14,7,2,8,1,16,22,6,2,4,2,9764,9798,10
Task 9765,Job 0,10,6,1,8,1,11,18,7,1,1,2,9765,9799,4
Task 9765,Job 1,15,6,1,8,0,16,23,7,1,3,1,9765,9799,9
Task 9766,Job 0,8,9,1,11,0,9,19,10,1,1,2,9766,9800,6
Task 9766,Job 1,13,5,3,8,0,16,21,5,3,1,2,9766,9800,3
Task 9767,Job 0,4,10,3,12,1,7,16,9,3,4,1,9767,9801,14
Task 9767,Job 1,9,9,3,7,0,12,16,4,3,1,1,9767,9801,14
Task 9768,Job 0,10,10,1,12,1,11,22,11,1,2,1,9768,9802,20
Task 9768,Job 1,15,7,3,6,0,18,21,3,3,3,1,9768,9802,6
Task 9769,Job 0,1,9,3,12,0,4,13,9,3,1,1,9769,9803,13
Task 9769,Job 1,6,8,3,6,0,9,12,3,3,1,1,9769,9803,14
Task 9770,Job 0,4,7,3,8,0,7,12,5,3,4,2,9770,9803,6
Task 9770,Job 1,9,10,2,11,0,11,20,9,2,2,0,9770,9803,15
Task 9771,Job 0,3,4,2,6,0,5,9,4,2,4,2,9771,9805,7
Task 9771,Job 1,8,10,3,9,0,11,17,6,3,4,2,9771,9805,8
Task 9772,Job 0,9,8,1,11,0,10,20,10,1,4,0,9772,9806,2
Task 9772,Job 1,14,8,1,9,1,15,23,8,1,2,2,9772,9806,10
Task 9773,Job 0,8,7,1,12,0,9,20,11,1,1,2,9773,9807,16
Task 9773,Job 1,13,4,4,8,0,17,21,4,4,1,2,9773,9807,12
Task 9774,Job 0,5,8,1,9,0,6,14,8,1,1,0,9774,9808,13
Task 9774,Job 1,10,4,1,10,0,11,20,9,1,4,1,9774,9808,10
Task 9775,Job 0,6,8,2,7,0,8,13,5,2,3,1,9775,9809,18
Task 9775,Job 1,11,7,3,8,0,14,19,5,3,3,1,9775,9809,13
Task 9776,Job 0,8,7,3,6,1,11,14,3,3,4,0,9776,9809,12
Task 9776,Job 1,13,10,1,6,0,14,19,5,1,2,1,9776,9809,19
Task 9777,Job 0,7,7,4,11,0,11,18,7,4,2,1,9777,9810,2
Task 9777,Job 1,12,5,1,6,0,13,18,5,1,1,2,9777,9810,17
Task 9778,Job 0,10,4,1,7,1,11,17,6,1,4,0,9778,9812,13
Task 9778,Job 1,15,10,2,10,1,17,25,8,2,3,0,9778,9812,9
Task 9779,Job 0,8,4,4,6,0,12,14,2,4,2,0,9779,9812,12
Task 9779,Job 1,13,9,3,12,1,16,25,9,3,4,1,9779,9812,15
Task 9780,Job 0,8,5,1,7,0,9,15,6,1,4,0,9780,9813,11
Task 9780,Job 1,13,5,3,7,0,16,20,4,3,1,2,9780,9813,12
Task 9781,Job 0,9,5,3,12,0,12,21,9,3,2,1,9781,9815,13
Task 9781,Job 1,14,8,3,12,0,17,26,9,3,2,1,9781,9815,19
Task 9782,Job 0,7,6,3,9,0,10,16,6,3,3,2,9782,9816,4
Task 9782,Job 1,12,7,2,10,0,14,22,8,2,4,0,9782,9816,4
Task 9783,Job 0,9,4,3,10,1,12,19,7,3,4,0,9783,9817,3
Task 9783,Job 1,14,4,3,12,0,17,26,9,3,1,2,9783,9817,7
Task 9784,Job 0,7,5,3,7,0,10,14,4,3,4,1,9784,9818,11
Task 9784,Job 1,12,4,2,10,0,14,22,8,2,1,0,9784,9818,14
Task 9785,Job 0,7,9,3,7,1,10,14,4,3,1,1,9785,9818,13
Task 9785,Job 1,12,4,2,9,0,14,21,7,2,2,2,9785,9818,7
Task 9786,Job 0,10,7,1,12,0,11,22,11,1,4,0,9786,9819,6
Task 9786,Job 1,15,6,1,8,0,16,23,7,1,3,2,9786,9819,20
Task 9787,Job 0,6,7,4,11,0,10,17,7,4,2,0,9787,9820,6
Task 9787,Job 1,11,8,2,10,0,13,21,8,2,1,2,9787,9820,14
Task 9788,Job 0,9,10,1,9,0,10,18,8,1,1,2,9788,9822,20
Task 9788,Job 1,14,6,2,9,0,16,23,7,2,2,2,9788,9822,10
Task 9789,Job 0,10,6,3,11,1,13,21,8,3,4,0,9789,9822,7
Task 9789,Job 1,15,7,1,12,0,16,27,11,1,4,2,9789,9822,15
Task 9790,Job 0,1,5,2,12,0,3,13,10,2,1,1,9790,9823,11
Task 9790,Job 1,6,6,1,6,0,7,12,5,1,3,2,9790,9823,19
Task 9791,Job 0,4,7,2,9,0,6,13,7,2,3,1,9791,9825,7
Task 9791,Job 1,9,6,4,11,0,13,20,7,4,2,1,9791,9825,8
Task 9792,Job 0,9,10,2,12,0,11,21,10,2,2,0,9792,9826,11
Task 9792,Job 1,14,7,2,12,0,16,26,10,2,3,1,9792,9826,11
Task 9793,Job 0,1,4,2,10,1,3,11,8,2,3,1,9793,9827,11
Task 9793,Job 1,6,6,1,10,0,7,16,9,1,1,1,9793,9827,8
Task 9794,Job 0,3,10,1,6,0,4,9,5,1,3,2,9794,9828,15
Task 9794,Job 1,8,10,2,7,1,10,15,5,2,4,1,9794,9828,15
Task 9795,Job 0,10,7,2,12,0,12,22,10,2,2,2,9795,9828,16
Task 9795,Job 1,15,8,1,7,0,16,22,6,1,3,2,9795,9828,12
Task 9796,Job 0,9,8,4,7,0,13,16,3,4,3,1,9796,9829,8
Task 9796,Job 1,14,10,4,8,0,18,22,4,4,4,1,9796,9829,16
Task 9797,Job 0,7,5,3,8,0,10,15,5,3,1,0,9797,9830,8
Task 9797,Job 1,12,4,2,9,0,14,21,7,2,1,2,9797,9830,18
Task 9798,Job 0,10,9,1,10,0,11,20,9,1,2,1,9798,9832,20
Task 9798,Job 1,15,10,4,10,0,19,25,6,4,3,0,9798,9832,17
Task 9799,Job 0,7,7,2,8,0,9,15,6,2,2,1,9799,9832,12
Task 9799,Job 1,12,4,1,8,0,13,20,7,1,3,2,9799,9832,7
Task 9800,Job 0,8,8,2,7,1,10,15,5,2,4,2,9800,9834,11
Task 9800,Job 1,13,7,4,10,0,17,23,6,4,1,1,9800,9834,13
Task 9801,Job 0,9,8,2,9,1,11,18,7,2,1,1,9801,9835,17
Task 9801,Job 1,14,8,2,6,0,16,20,4,2,1,0,9801,9835,6
Task 9802,Job 0,8,5,2,11,0,10,19,9,2,1,2,9802,9835,17
Task 9802,Job 1,13,5,3,8,0,16,21,5,3,1,0,9802,9835,3
Task 9803,Job 0,10,10,2,12,0,12,22,10,2,2,1,9803,9837,18
Task 9803,Job 1,15,5,4,11,1,19,26,7,4,3,0,9803,9837,12
Task 9804,Job 0,1,8,1,6,0,2,7,5,1,4,0,9804,9837,17
Task 9804,Job 1,6,5,3,7,0,9,13,4,3,4,1,9804,9837,6
Task 9805,Job 0,10,5,3,12,0,13,22,9,3,3,2,9805,9839,6
Task 9805,Job 1,15,7,1,6,0,16,21,5,1,3,2,9805,9839,3
Task 9806,Job 0,4,8,3,6,0,7,10,3,3,4,0,9806,9840,15
Task 9806,Job 1,9,4,1,10,0,10,19,9,1,2,0,9806,9840,20
Task 9807,Job 0,6,8,4,11,0,10,17,7,4,4,0,9807,9841,3
Task 9807,Job 1,11,7,3,6,0,14,17,3,3,3,1,9807,9841,7
Task 9808,Job 0,7,6,2,12,0,9,19,10,2,4,2,9808,9842,4
Task 9808,Job 1,12,8,2,8,1,14,20,6,2,3,0,9808,9842,17
Task 9809,Job 0,9,8,2,11,0,11,20,9,2,2,1,9809,9842,2
Task 9809,Job 1,14,10,3,6,0,17,20,3,3,1,1,9809,9842,8
Task 9810,Job 0,10,4,3,11,1,13,21,8,3,4,1,9810,9843,9
Task 9810,Job 1,15,10,2,12,0,17,27,10,2,2,1,9810,9843,7
Task 9811,Job 0,6,9,1,9,0,7,15,8,1,3,1,9811,9845,15
Task 9811,Job 1,11,5,1,12,0,12,23,11,1,3,1,9811,9845,10
Task 9812,Job 0,3,6,4,6,0,7,9,2,4,2,2,9812,9846,11
Task 9812,Job 1,8,6,4,11,0,12,19,7,4,2,0,9812,9846,15
Task 9813,Job 0,7,6,3,9,0,10,16,6,3,1,0,9813,9847,8
Task 9813,Job 1,12,5,4,10,1,16,22,6,4,4,0,9813,9847,4
Task 9814,Job 0,1,7,4,9,0,5,10,5,4,1,1,9814,9848,8
Task 9814,Job 1,6,5,4,10,0,10,16,6,4,1,2,9814,9848,5
Task 9815,Job 0,10,9,3,6,0,13,16,3,3,2,0,9815,9848,5
Task 9815,Job 1,15,7,3,9,0,18,24,6,3,4,0,9815,9848,13
Task 9816,Job 0,7,4,2,9,1,9,16,7,2,4,1,9816,9849,16
Task 9816,Job 1,12,6,1,10,0,13,22,9,1,4,2,9816,9849,3
Task 9817,Job 0,8,4,2,10,0,10,18,8,2,1,2,9817,9851,11
Task 9817,Job 1,13,9,4,12,1,17,25,8,4,2,2,9817,9851,2
Task 9818,Job 0,4,10,2,10,0,6,14,8,2,4,1,9818,9851,11
Task 9818,Job 1,9,9,4,6,1,13,15,2,4,3,0,9818,9851,8
Task 9819,Job 0,7,10,2,10,0,9,17,8,2,4,1,9819,9853,20
Task 9819,Job 1,12,9,2,6,0,14,18,4,2,2,0,9819,9853,2
Task 9820,Job 0,1,6,2,8,0,3,9,6,2,1,2,9820,9854,6
Task 9820,Job 1,6,4,1,10,0,7,16,9,1,4,1,9820,9854,4
Task 9821,Job 0,3,8,1,11,0,4,14,10,1,1,0,9821,9855,14
Task 9821,Job 1,8,5,2,12,0,10,20,10,2,1,1,9821,9855,12
Task 9822,Job 0,6,5,1,10,0,7,16,9,1,1,1,9822,9855,16
Task 9822,Job 1,11,6,2,11,1,13,22,9,2,3,2,9822,9855,7
Task 9823,Job 0,4,8,1,7,0,5,11,6,1,4,2,9823,9857,3
Task 9823,Job 1,9,6,3,11,1,12,20,8,3,3,2,9823,9857,19
Task 9824,Job 0,2,10,1,8,0,3,10,7,1,2,2,9824,9857,13
Task 9824,Job 1,7,10,2,8,0,9,15,6,2,2,0,9824,9857,13
Task 9825,Job 0,8,7,1,9,0,9,17,8,1,3,2,9825,9858,15
Task 9825,Job 1,13,10,4,9,0,17,22,5,4,1,2,9825,9858,17
Task 9826,Job 0,3,8,4,9,0,7,12,5,4,1,0,9826,9859,16
Task 9826,Job 1,8,4,4,6,0,12,14,2,4,1,0,9826,9859,10
Task 9827,Job 0,9,10,2,11,0,11,20,9,2,3,1,9827,9860,18
Task 9827,Job 1,14,4,3,12,0,17,26,9,3,1,1,9827,9860,7
Task 9828,Job 0,4,9,2,6,0,6,10,4,2,2,0,9828,9862,8
Task 9828,Job 1,9,9,1,11,0,10,20,10,1,2,0,9828,9862,16
Task 9829,Job 0,6,10,1,9,0,7,15,8,1,2,0,9829,9862,15
Task 9829,Job 1,11,10,3,8,1,14,19,5,3,4,1,9829,9862,6
Task 9830,Job 0,7,7,4,11,0,11,18,7,4,2,0,9830,9864,7
Task 9830,Job 1,12,10,2,11,1,14,23,9,2,4,1,9830,9864,18
Task 9831,Job 0,8,7,3,12,0,11,20,9,3,3,2,9831,9865,17
Task 9831,Job 1,13,8,2,6,0,15,19,4,2,1,0,9831,9865,16
Task 9832,Job 0,6,9,2,7,0,8,13,5,2,2,1,9832,9866,19
Task 9832,Job 1,11,5,2,8,0,13,19,6,2,2,0,9832,9866,4
Task 9833,Job 0,2,7,2,7,0,4,9,5,2,3,0,9833,9866,9
Task 9833,Job 1,7,7,2,6,0,9,13,4,2,4,0,9833,9866,3
Task 9834,Job 0,10,9,2,11,0,12,21,9,2,1,0,9834,9868,6
Task 9834,Job 1,15,10,3,8,0,18,23,5,3,3,1,9834,9868,12
Task 9835,Job 0,3,9,4,7,0,7,10,3,4,2,2,9835,9869,4
Task 9835,Job 1,8,4,1,9,1,9,17,8,1,3,2,9835,9869,9
Task 9836,Job 0,9,6,2,6,1,11,15,4,2,3,2,9836,9870,16
Task 9836,Job 1,14,10,3,9,0,17,23,6,3,2,0,9836,9870,10
Task 9837,Job 0,7,9,1,8,1,8,15,7,1,2,0,9837,9870,7
Task 9837,Job 1,12,6,4,8,0,16,20,4,4,3,1,9837,9870,8
Task 9838,Job 0,10,10,3,11,0,13,21,8,3,2,1,9838,9872,15
Task 9838,Job 1,15,10,4,11,1,19,26,7,4,3,1,9838,9872,15
Task 9839,Job 0,7,9,3,11,0,10,18,8,3,3,1,9839,9872,9
Task 9839,Job 1,12,6,4,9,0,16,21,5,4,1,0,9839,9872,11
Task 9840,Job 0,10,6,4,8,1,14,18,4,4,2,0,9840,9873,5
Task 9840,Job 1,15,6,3,6,0,18,21,3,3,3,1,9840,9873,4
Task 9841,Job 0,8,8,4,6,1,12,14,2,4,3,2,9841,9874,5
Task 9841,Job 1,13,6,2,8,0,15,21,6,2,1,1,9841,9874,15
Task 9842,Job 0,7,7,1,12,0,8,19,11,1,1,2,9842,9875,13
Task 9842,Job 1,12,10,1,10,0,13,22,9,1,4,0,9842,9875,4
Task 9843,Job 0,5,5,2,10,0,7,15,8,2,4,2,9843,9876,3
Task 9843,Job 1,10,9,3,7,1,13,17,4,3,2,2,9843,9876,16
Task 9844,Job 0,5,7,2,7,0,7,12,5,2,3,1,9844,9877,12
Task 9844,Job 1,10,5,4,7,0,14,17,3,4,3,2,9844,9877,3
Task 9845,Job 0,8,9,4,7,0,12,15,3,4,2,1,9845,9878,14
Task 9845,Job 1,13,7,1,9,1,14,22,8,1,1,0,9845,9878,8
Task 9846,Job 0,6,6,2,12,0,8,18,10,2,1,1,9846,9879,18
Task 9846,Job 1,11,10,1,6,0,12,17,5,1,3,2,9846,9879,5
Task 9847,Job 0,2,4,2,8,0,4,10,6,2,1,2,9847,9880,8
Task 9847,Job 1,7,10,2,9,1,9,16,7,2,3,2,9847,9880,4
Task 9848,Job 0,1,10,1,9,1,2,10,8,1,3,2,9848,9881,5
Task 9848,Job 1,6,5,3,6,0,9,12,3,3,4,0,9848,9881,7
Task 9849,Job 0,6,8,2,12,0,8,18,10,2,3,2,9849,9882,12
Task 9849,Job 1,11,8,4,12,0,15,23,8,4,1,0,9849,9882,7
Task 9850,Job 0,4,10,1,6,1,5,10,5,1,1,0,9850,9884,2
Task 9850,Job 1,9,10,1,9,0,10,18,8,1,4,1,9850,9884,14
Task 9851,Job 0,7,4,1,12,0,8,19,11,1,2,0,9851,9884,20
Task 9851,Job 1,12,10,1,7,0,13,19,6,1,3,1,9851,9884,14
Task 9852,Job 0,5,7,2,10,0,7,15,8,2,2,0,9852,9885,3
Task 9852,Job 1,10,5,4,10,1,14,20,6,4,1,1,9852,9885,13
Task 9853,Job 0,3,8,1,8,0,4,11,7,1,2,0,9853,9886,20
Task 9853,Job 1,8,6,1,11,0,9,19,10,1,1,2,9853,9886,18
Task 9854,Job 0,9,7,3,8,0,12,17,5,3,3,2,9854,9887,18
Task 9854,Job 1,14,7,2,7,0,16,21,5,2,1,2,9854,9887,9
Task 9855,Job 0,9,10,2,12,0,11,21,10,2,4,0,9855,9889,6
Task 9855,Job 1,14,6,4,7,0,18,21,3,4,1,1,9855,9889,9
Task 9856,Job 0,4,10,4,11,1,8,15,7,4,3,1,9856,9889,2
Task 9856,Job 1,9,9,2,6,1,11,15,4,2,4,2,9856,9889,12
Task 9857,Job 0,1,5,4,9,1,5,10,5,4,2,0,9857,9891,4
Task 9857,Job 1,6,6,4,8,0,10,14,4,4,4,2,9857,9891,3
Task 9858,Job 0,8,6,1,10,1,9,18,9,1,4,1,9858,9892,20
Task 9858,Job 1,13,8,3,12,0,16,25,9,3,4,2,9858,9892,7
Task 9859,Job 0,10,10,3,11,0,13,21,8,3,1,2,9859,9893,9
Task 9859,Job 1,15,5,3,10,0,18,25,7,3,3,0,9859,9893,6
Task 9860,Job 0,2,9,1,6,0,3,8,5,1,4,2,9860,9894,12
Task 9860,Job 1,7,4,3,10,1,10,17,7,3,1,0,9860,9894,17
Task 9861,Job 0,3,9,1,9,0,4,12,8,1,4,0,9861,9894,11
Task 9861,Job 1,8,9,1,10,1,9,18,9,1,1,1,9861,9894,6
Task 9862,Job 0,5,7,4,12,0,9,17,8,4,3,1,9862,9896,20
Task 9862,Job 1,10,4,3,12,0,13,22,9,3,4,2,9862,9896,8
Task 9863,Job 0,6,7,3,6,1,9,12,3,3,3,1,9863,9897,15
Task 9863,Job 1,11,10,1,12,0,12,23,11,1,2,1,9863,9897,5
Task 9864,Job 0,2,6,4,7,0,6,9,3,4,3,1,9864,9898,16
Task 9864,Job 1,7,10,1,11,0,8,18,10,1,4,0,9864,9898,13
Task 9865,Job 0,7,8,3,6,0,10,13,3,3,3,2,9865,9898,14
Task 9865,Job 1,12,10,3,7,0,15,19,4,3,4,2,9865,9898,10
Task 9866,Job 0,4,7,3,10,0,7,14,7,3,4,1,9866,9899,10
Task 9866,Job 1,9,4,4,11,1,13,20,7,4,1,2,9866,9899,9
Task 9867,Job 0,2,10,4,9,0,6,11,5,4,3,2,9867,9901,5
Task 9867,Job 1,7,4,1,8,0,8,15,7,1,4,0,9867,9901,11
Task 9868,Job 0,7,6,2,12,0,9,19,10,2,3,2,9868,9902,20
Task 9868,Job 1,12,8,3,8,0,15,20,5,3,4,0,9868,9902,17
Task 9869,Job 0,2,4,1,8,0,3,10,7,1,2,1,9869,9903,17
Task 9869,Job 1,7,8,3,11,1,10,18,8,3,3,0,9869,9903,20
Task 9870,Job 0,10,9,4,7,0,14,17,3,4,1,2,9870,9903,14
Task 9870,Job 1,15,8,4,6,0,19,21,2,4,3,2,9870,9903,8
Task 9871,Job 0,8,8,4,6,0,12,14,2,4,4,0,9871,9904,14
Task 9871,Job 1,13,9,3,6,0,16,19,3,3,1,0,9871,9904,4
Task 9872,Job 0,3,4,3,11,1,6,14,8,3,1,2,9872,9906,4
Task 9872,Job 1,8,10,1,8,1,9,16,7,1,3,2,9872,9906,9
Task 9873,Job 0,10,8,1,10,0,11,20,9,1,4,1,9873,9907,3
Task 9873,Job 1,15,4,1,7,0,16,22,6,1,3,2,9873,9907,20
Task 9874,Job 0,7,7,1,7,0,8,14,6,1,4,2,9874,9908,15
Task 9874,Job 1,12,4,3,9,0,15,21,6,3,2,0,9874,9908,13
Task 9875,Job 0,3,5,4,10,0,7,13,6,4,3,2,9875,9908,3
Task 9875,Job 1,8,6,3,6,0,11,14,3,3,1,2,9875,9908,15
Task 9876,Job 0,1,10,1,9,0,2,10,8,1,4,0,9876,9910,8
Task 9876,Job 1,6,6,4,10,0,10,16,6,4,2,0,9876,9910,12
Task 9877,Job 0,6,10,4,6,0,10,12,2,4,4,0,9877,9910,17
Task 9877,Job 1,11,8,3,8,0,14,19,5,3,1,1,9877,9910,9
Task 9878,Job 0,5,9,3,6,0,8,11,3,3,4,2,9878,9911,13
Task 9878,Job 1,10,6,4,10,0,14,20,6,4,2,0,9878,9911,9
Task 9879,Job 0,8,4,3,7,0,11,15,4,3,4,1,9879,9913,19
Task 9879,Job 1,13,4,4,6,0,17,19,2,4,1,1,9879,9913,5
Task 9880,Job 0,1,4,2,12,0,3,13,10,2,1,1,9880,9913,3
Task 9880,Job 1,6,10,1,12,1,7,18,11,1,4,2,9880,9913,14
Task 9881,Job 0,10,8,3,6,0,13,16,3,3,4,1,9881,9914,12
Task 9881,Job 1,15,8,2,7,0,17,22,5,2,4,1,9881,9914,13
Task 9882,Job 0,6,6,3,8,0,9,14,5,3,2,1,9882,9915,16
Task 9882,Job 1,11,5,3,12,0,14,23,9,3,1,0,9882,9915,12
Task 9883,Job 0,6,7,2,9,0,8,15,7,2,3,2,9883,9917,2
Task 9883,Job 1,11,4,2,8,1,13,19,6,2,3,1,9883,9917,18
Task 9884,Job 0,7,7,2,10,1,9,17,8,2,3,2,9884,9917,20
Task 9884,Job 1,12,10,3,9,0,15,21,6,3,4,1,9884,9917,9
Task 9885,Job 0,2,9,4,7,1,6,9,3,4,1,2,9885,9918,13
Task 9885,Job 1,7,5,1,10,0,8,17,9,1,3,0,9885,9918,16
Task 9886,Job 0,3,8,2,12,0,5,15,10,2,2,2,9886,9920,6
Task 9886,Job 1,8,7,4,11,1,12,19,7,4,2,0,9886,9920,15
Task 9887,Job 0,1,10,1,12,1,2,13,11,1,4,0,9887,9921,4
Task 9887,Job 1,6,10,2,11,0,8,17,9,2,1,1,9887,9921,13
Task 9888,Job 0,2,10,2,8,1,4,10,6,2,3,0,9888,9922,19
Task 9888,Job 1,7,10,3,12,0,10,19,9,3,2,1,9888,9922,20
Task 9889,Job 0,1,4,1,12,0,2,13,11,1,2,2,9889,9922,7
Task 9889,Job 1,6,9,2,7,0,8,13,5,2,4,2,9889,9922,19
Task 9890,Job 0,2,5,2,9,0,4,11,7,2,2,0,9890,9923,4
Task 9890,Job 1,7,6,1,8,0,8,15,7,1,4,2,9890,9923,7
Task 9891,Job 0,1,5,2,7,0,3,8,5,2,2,0,9891,9924,2
Task 9891,Job 1,6,5,4,6,1,10,12,2,4,1,0,9891,9924,2
Task 9892,Job 0,8,8,1,7,0,9,15,6,1,1,2,9892,9925,17
Task 9892,Job 1,13,9,3,12,1,16,25,9,3,4,1,9892,9925,6
Task 9893,Job 0,8,10,2,10,0,10,18,8,2,3,1,9893,9926,8
Task 9893,Job 1,13,10,4,10,0,17,23,6,4,3,0,9893,9926,10
Task 9894,Job 0,2,4,1,12,1,3,14,11,1,4,2,9894,9927,15
Task 9894,Job 1,7,10,2,7,0,9,14,5,2,2,0,9894,9927,6
Task 9895,Job 0,1,9,1,10,0,2,11,9,1,4,2,9895,9928,9
Task 9895,Job 1,6,5,1,7,1,7,13,6,1,4,0,9895,9928,4
Task 9896,Job 0,10,4,4,10,0,14,20,6,4,1,2,9896,9930,5
Task 9896,Job 1,15,8,2,11,1,17,26,9,2,1,2,9896,9930,19
Task 9897,Job 0,4,8,3,7,0,7,11,4,3,3,0,9897,9931,10
Task 9897,Job 1,9,5,4,11,0,13,20,7,4,1,0,9897,9931,5
Task 9898,Job 0,7,9,2,6,1,9,13,4,2,1,0,9898,9931,6
Task 9898,Job 1,12,10,1,11,0,13,23,10,1,1,2,9898,9931,3
Task 9899,Job 0,3,4,4,11,0,7,14,7,4,3,2,9899,9933,6
Task 9899,Job 1,8,5,3,10,0,11,18,7,3,1,1,9899,9933,18
Task 9900,Job 0,8,5,1,9,0,9,17,8,1,3,0,9900,9934,19
Task 9900,Job 1,13,8,4,6,0,17,19,2,4,2,0,9900,9934,9
Task 9901,Job 0,7,10,4,10,0,11,17,6,4,2,1,9901,9935,5
Task 9901,Job 1,12,5,2,10,0,14,22,8,2,2,2,9901,9935,6
Task 9902,Job 0,4,8,4,10,0,8,14,6,4,2,0,9902,9935,16
Task 9902,Job 1,9,5,2,10,0,11,19,8,2,3,2,9902,9935,19
Task 9903,Job 0,1,10,2,6,0,3,7,4,2,3,0,9903,9936,5
Task 9903,Job 1,6,8,4,10,0,10,16,6,4,1,1,9903,9936,16
Task 9904,Job 0,5,10,1,11,0,6,16,10,1,2,2,9904,9938,3
Task 9904,Job 1,10,8,3,8,0,13,18,5,3,1,0,9904,9938,10
Task 9905,Job 0,5,6,2,6,0,7,11,4,2,1,1,9905,9938,9
Task 9905,Job 1,10,9,3,12,1,13,22,9,3,2,1,9905,9938,5
Task 9906,Job 0,7,10,3,6,0,10,13,3,3,4,0,9906,9939,13
Task 9906,Job 1,12,4,1,11,1,13,23,10,1,1,2,9906,9939,14
Task 9907,Job 0,3,8,3,11,0,6,14,8,3,3,2,9907,9940,8
Task 9907,Job 1,8,9,1,11,0,9,19,10,1,2,2,9907,9940,16
Task 9908,Job 0,1,8,4,7,0,5,8,3,4,2,0,9908,9941,19
Task 9908,Job 1,6,10,1,8,0,7,14,7,1,1,0,9908,9941,4
Task 9909,Job 0,8,7,3,9,0,11,17,6,3,2,0,9909,9942,17
Task 9909,Job 1,13,8,1,6,0,14,19,5,1,3,0,9909,9942,9
Task 9910,Job 0,2,5,3,7,0,5,9,4,3,4,2,9910,9944,7
Task 9910,Job 1,7,10,4,11,0,11,18,7,4,3,1,9910,9944,18
Task 9911,Job 0,10,6,4,8,0,14,18,4,4,3,2,9911,9944,9
Task 9911,Job 1,15,10,3,12,0,18,27,9,3,4,0,9911,9944,6
Task 9912,Job 0,1,10,2,6,0,3,7,4,2,3,2,9912,9946,2
Task 9912,Job 1,6,7,3,11,0,9,17,8,3,2,0,9912,9946,20
Task 9913,Job 0,5,6,3,8,1,8,13,5,3,3,0,9913,9946,8
Task 9913,Job 1,10,7,2,6,0,12,16,4,2,4,0,9913,9946,17
Task 9914,Job 0,10,7,3,12,0,13,22,9,3,3,2,9914,9947,12
Task 9914,Job 1,15,10,3,12,1,18,27,9,3,2,0,9914,9947,20
Task 9915,Job 0,10,7,1,8,1,11,18,7,1,2,0,9915,9948,12
Task 9915,Job 1,15,7,2,12,1,17,27,10,2,4,1,9915,9948,5
Task 9916,Job 0,1,8,4,7,0,5,8,3,4,4,0,9916,9950,11
Task 9916,Job 1,6,10,1,11,1,7,17,10,1,2,2,9916,9950,9
Task 9917,Job 0,7,10,2,9,0,9,16,7,2,4,2,9917,9950,19
Task 9917,Job 1,12,9,1,9,0,13,21,8,1,1,2,9917,9950,16
Task 9918,Job 0,5,8,2,10,1,7,15,8,2,1,1,9918,9952,11
Task 9918,Job 1,10,6,2,10,0,12,20,8,2,2,1,9918,9952,9
Task 9919,Job 0,8,10,4,7,0,12,15,3,4,4,0,9919,9953,7
Task 9919,Job 1,13,5,4,12,1,17,25,8,4,2,0,9919,9953,13
Task 9920,Job 0,4,9,3,6,0,7,10,3,3,3,0,9920,9954,14
Task 9920,Job 1,9,6,2,12,0,11,21,10,2,4,2,9920,9954,19
Task 9921,Job 0,10,10,1,10,0,11,20,9,1,4,1,9921,9954,20
Task 9921,Job 1,15,8,3,8,0,18,23,5,3,1,1,9921,9954,20
Task 9922,Job 0,10,8,1,8,0,11,18,7,1,4,0,9922,9955,11
Task 9922,Job 1,15,9,2,9,1,17,24,7,2,4,1,9922,9955,13
Task 9923,Job 0,8,5,4,11,0,12,19,7,4,4,0,9923,9957,13
Task 9923,Job 1,13,4,2,9,1,15,22,7,2,1,0,9923,9957,17
Task 9924,Job 0,2,4,4,10,1,6,12,6,4,3,2,9924,9958,2
Task 9924,Job 1,7,6,4,10,0,11,17,6,4,3,2,9924,9958,4
Task 9925,Job 0,1,7,4,9,0,5,10,5,4,2,0,9925,9958,13
Task 9925,Job 1,6,10,4,11,1,10,17,7,4,2,1,9925,9958,2
Task 9926,Job 0,5,10,4,8,0,9,13,4,4,1,1,9926,9960,15
Task 9926,Job 1,10,8,1,7,0,11,17,6,1,3,2,9926,9960,4
Task 9927,Job 0,2,7,1,11,0,3,13,10,1,1,2,9927,9961,12
Task 9927,Job 1,7,4,2,7,1,9,14,5,2,3,1,9927,9961,13
Task 9928,Job 0,10,8,1,6,0,11,16,5,1,3,0,9928,9962,14
Task 9928,Job 1,15,8,2,6,0,17,21,4,2,2,1,9928,9962,16
Task 9929,Job 0,3,5,4,6,0,7,9,2,4,4,0,9929,9962,2
Task 9929,Job 1,8,5,2,9,1,10,17,7,2,4,1,9929,9962,8
Task 9930,Job 0,8,10,4,9,0,12,17,5,4,4,2,9930,9963,16
Task 9930,Job 1,13,9,2,12,0,15,25,10,2,2,2,9930,9963,10
Task 9931,Job 0,8,5,2,11,0,10,19,9,2,2,2,9931,9965,18
Task 9931,Job 1,13,9,1,8,1,14,21,7,1,3,2,9931,9965,8
Task 9932,Job 0,5,6,2,11,0,7,16,9,2,3,0,9932,9966,13
Task 9932,Job 1,10,5,1,8,1,11,18,7,1,2,1,9932,9966,15
Task 9933,Job 0,2,10,1,6,0,3,8,5,1,3,0,9933,9967,8
Task 9933,Job 1,7,7,4,12,1,11,19,8,4,3,0,9933,9967,20
Task 9934,Job 0,10,10,3,8,0,13,18,5,3,3,1,9934,9968,12
Task 9934,Job 1,15,7,4,6,0,19,21,2,4,3,0,9934,9968,18
Task 9935,Job 0,2,9,2,8,1,4,10,6,2,1,0,9935,9968,17
Task 9935,Job 1,7,4,3,8,1,10,15,5,3,4,0,9935,9968,11
Task 9936,Job 0,2,5,1,9,1,3,11,8,1,1,0,9936,9969,16
Task 9936,Job 1,7,7,1,9,1,8,16,8,1,1,1,9936,9969,10
Task 9937,Job 0,10,9,4,6,1,14,16,2,4,3,1,9937,9971,13
Task 9937,Job 1,15,5,4,12,1,19,27,8,4,2,1,9937,9971,7
Task 9938,Job 0,8,5,1,10,0,9,18,9,1,1,0,9938,9972,10
Task 9938,Job 1,13,5,2,9,0,15,22,7,2,4,0,9938,9972,20
Task 9939,Job 0,5,6,2,7,0,7,12,5,2,1,2,9939,9972,2
Task 9939,Job 1,10,4,2,6,0,12,16,4,2,4,0,9939,9972,8
Task 9940,Job 0,8,9,4,7,1,12,15,3,4,4,0,9940,9974,12
Task 9940,Job 1,13,4,4,10,1,17,23,6,4,3,1,9940,9974,20
Task 9941,Job 0,2,5,1,8,0,3,10,7,1,1,1,9941,9974,15
Task 9941,Job 1,7,8,2,8,0,9,15,6,2,3,2,9941,9974,18
Task 9942,Job 0,10,8,2,10,0,12,20,8,2,4,1,9942,9975,14
Task 9942,Job 1,15,8,2,10,0,17,25,8,2,3,1,9942,9975,20
Task 9943,Job 0,2,7,1,11,0,3,13,10,1,1,0,9943,9977,2
Task 9943,Job 1,7,7,1,9,0,8,16,8,1,2,0,9943,9977,4
Task 9944,Job 0,9,9,2,9,0,11,18,7,2,2,1,9944,9978,7
Task 9944,Job 1,14,5,3,6,0,17,20,3,3,1,1,9944,9978,12
Task 9945,Job 0,4,4,4,7,0,8,11,3,4,2,0,9945,9979,18
Task 9945,Job 1,9,8,4,11,0,13,20,7,4,3,0,9945,9979,2
Task 9946,Job 0,5,10,2,6,0,7,11,4,2,1,0,9946,9979,7
Task 9946,Job 1,10,9,2,7,0,12,17,5,2,3,2,9946,9979,14
Task 9947,Job 0,10,6,1,9,0,11,19,8,1,3,0,9947,9980,17
Task 9947,Job 1,15,9,1,11,0,16,26,10,1,4,1,9947,9980,17
Task 9948,Job 0,4,6,4,12,0,8,16,8,4,1,0,9948,9982,7
Task 9948,Job 1,9,10,4,8,0,13,17,4,4,1,0,9948,9982,20
Task 9949,Job 0,8,10,2,9,0,10,17,7,2,3,1,9949,9982,20
Task 9949,Job 1,13,10,4,9,0,17,22,5,4,3,2,9949,9982,8
Task 9950,Job 0,4,4,1,8,0,5,12,7,1,4,1,9950,9983,10
Task 9950,Job 1,9,9,1,8,0,10,17,7,1,3,2,9950,9983,10
Task 9951,Job 0,3,8,2,11,1,5,14,9,2,4,0,9951,9984,5
Task 9951,Job 1,8,4,3,9,0,11,17,6,3,2,0,9951,9984,4
Task 9952,Job 0,4,6,4,12,0,8,16,8,4,3,1,9952,9986,7
Task 9952,Job 1,9,5,4,10,0,13,19,6,4,1,2,9952,9986,7
Task 9953,Job 0,6,5,4,10,0,10,16,6,4,2,1,9953,9987,15
Task 9953,Job 1,11,5,1,8,0,12,19,7,1,2,1,9953,9987,15
Task 9954,Job 0,5,7,2,11,1,7,16,9,2,1,1,9954,9987,20
Task 9954,Job 1,10,7,3,8,0,13,18,5,3,3,1,9954,9987,15
Task 9955,Job 0,3,6,3,10,0,6,13,7,3,4,1,9955,9989,17
Task 9955,Job 1,8,4,2,11,0,10,19,9,2,4,1,9955,9989,8
Task 9956,Job 0,8,6,2,10,0,10,18,8,2,2,2,9956,9989,14
Task 9956,Job 1,13,8,4,9,0,17,22,5,4,1,0,9956,9989,14
Task 9957,Job 0,3,9,2,7,0,5,10,5,2,4,0,9957,9990,19
Task 9957,Job 1,8,6,2,10,0,10,18,8,2,2,1,9957,9990,8
Task 9958,Job 0,7,10,1,8,0,8,15,7,1,2,1,9958,9992,18
Task 9958,Job 1,12,8,1,6,0,13,18,5,1,1,1,9958,9992,16
Task 9959,Job 0,6,7,2,6,0,8,12,4,2,3,2,9959,9993,18
Task 9959,Job 1,11,5,2,12,0,13,23,10,2,1,1,9959,9993,3
Task 9960,Job 0,10,6,1,9,0,11,19,8,1,4,1,9960,9994,9
Task 9960,Job 1,15,5,2,8,1,17,23,6,2,2,0,9960,9994,14
Task 9961,Job 0,8,6,3,11,0,11,19,8,3,1,0,9961,9994,9
Task 9961,Job 1,13,6,1,12,0,14,25,11,1,2,0,9961,9994,3
Task 9962,Job 0,1,7,4,11,1,5,12,7,4,2,0,9962,9996,9
Task 9962,Job 1,6,8,1,11,0,7,17,10,1,4,1,9962,9996,12
Task 9963,Job 0,4,10,3,11,0,7,15,8,3,1,2,9963,9996,11
Task 9963,Job 1,9,4,1,6,0,10,15,5,1,2,0,9963,9996,5
Task 9964,Job 0,6,6,1,11,0,7,17,10,1,2,1,9964,9998,15
Task 9964,Job 1,11,9,1,12,0,12,23,11,1,3,0,9964,9998,3
Task 9965,Job 0,4,6,2,6,0,6,10,4,2,1,0,9965,9999,15
Task 9965,Job 1,9,10,1,8,0,10,17,7,1,4,0,9965,9999,6
Task 9966,Job 0,4,9,1,6,0,5,10,5,1,1,0,9966,9999,2
Task 9966,Job 1,9,10,2,7,1,11,16,5,2,3,2,9966,9999,2
Task 9967,Job 0,7,6,2,6,0,9,13,4,2,3,1,9967,10001,11
Task 9967,Job 1,12,6,3,9,1,15,21,6,3,2,0,9967,10001,13
Task 9968,Job 0,6,9,4,6,0,10,12,2,4,3,0,9968,10002,8
Task 9968,Job 1,11,10,4,6,0,15,17,2,4,3,2,9968,10002,3
Task 9969,Job 0,2,7,3,9,0,5,11,6,3,4,2,9969,10002,3
Task 9969,Job 1,7,8,4,12,0,11,19,8,4,2,0,9969,10002,12
Task 9970,Job 0,3,9,1,12,1,4,15,11,1,2,0,9970,10003,20
Task 9970,Job 1,8,9,1,7,0,9,15,6,1,4,0,9970,10003,14
Task 9971,Job 0,4,5,3,10,1,7,14,7,3,1,1,9971,10005,17
Task 9971,Job 1,9,5,3,8,1,12,17,5,3,3,0,9971,10005,18
Task 9972,Job 0,6,6,3,10,0,9,16,7,3,4,1,9972,10005,17
Task 9972,Job 1,11,6,1,9,0,12,20,8,1,4,2,9972,10005,11
Task 9973,Job 0,7,8,4,8,0,11,15,4,4,1,0,9973,10007,20
Task 9973,Job 1,12,9,1,10,0,13,22,9,1,4,0,9973,10007,18
Task 9974,Job 0,6,4,1,6,1,7,12,5,1,2,1,9974,10007,12
Task 9974,Job 1,11,5,3,11,0,14,22,8,3,4,2,9974,10007,10
Task 9975,Job 0,4,9,2,8,0,6,12,6,2,4,0,9975,10009,19
Task 9975,Job 1,9,5,2,6,0,11,15,4,2,2,2,9975,10009,13
Task 9976,Job 0,6,9,4,8,1,10,14,4,4,2,0,9976,10010,14
Task 9976,Job 1,11,7,3,7,0,14,18,4,3,2,2,9976,10010,20
Task 9977,Job 0,3,9,4,8,1,7,11,4,4,1,0,9977,10010,2
Task 9977,Job 1,8,10,1,9,0,9,17,8,1,4,0,9977,10010,11
Task 9978,Job 0,5,4,3,9,0,8,14,6,3,3,1,9978,10012,18
Task 9978,Job 1,10,7,1,12,1,11,22,11,1,4,0,9978,10012,9
Task 9979,Job 0,7,4,3,6,0,10,13,3,3,2,1,9979,10013,20
Task 9979,Job 1,12,10,4,9,0,16,21,5,4,1,1,9979,10013,19
Task 9980,Job 0,3,7,3,10,0,6,13,7,3,4,0,9980,10013,9
Task 9980,Job 1,8,4,1,10,0,9,18,9,1,3,2,9980,10013,12
Task 9981,Job 0,8,6,4,8,1,12,16,4,4,3,2,9981,10014,2
Task 9981,Job 1,13,5,2,9,0,15,22,7,2,3,2,9981,10014,2
Task 9982,Job 0,7,10,2,12,0,9,19,10,2,1,0,9982,10016,11
Task 9982,Job 1,12,10,3,9,0,15,21,6,3,2,0,9982,10016,16
Task 9983,Job 0,2,8,1,9,0,3,11,8,1,2,0,9983,10016,15
Task 9983,Job 1,7,7,1,6,0,8,13,5,1,4,1,9983,10016,5
Task 9984,Job 0,4,8,3,9,0,7,13,6,3,4,2,9984,10017,2
Task 9984,Job 1,9,5,1,7,0,10,16,6,1,3,2,9984,10017,3
Task 9985,Job 0,2,5,2,7,0,4,9,5,2,1,1,9985,10018,14
Task 9985,Job 1,7,6,4,12,0,11,19,8,4,4,0,9985,10018,4
Task 9986,Job 0,7,7,3,7,0,10,14,4,3,1,0,9986,10020,20
Task 9986,Job 1,12,6,2,12,1,14,24,10,2,2,2,9986,10020,17
Task 9987,Job 0,4,9,1,7,0,5,11,6,1,1,0,9987,10021,16
Task 9987,Job 1,9,7,1,7,0,10,16,6,1,3,0,9987,10021,6
Task 9988,Job 0,2,9,2,7,1,4,9,5,2,3,2,9988,10022,16
Task 9988,Job 1,7,8,3,11,0,10,18,8,3,4,2,9988,10022,15
Task 9989,Job 0,7,8,4,6,0,11,13,2,4,2,0,9989,10022,15
Task 9989,Job 1,12,4,2,6,0,14,18,4,2,1,1,9989,10022,14
Task 9990,Job 0,10,5,3,7,0,13,17,4,3,3,2,9990,10024,13
Task 9990,Job 1,15,9,3,11,1,18,26,8,3,3,1,9990,10024,12
Task 9991,Job 0,3,9,4,8,0,7,11,4,4,1,0,9991,10024,10
Task 9991,Job 1,8,7,3,12,1,11,20,9,3,1,2,9991,10024,13
Task 9992,Job 0,2,5,4,10,0,6,12,6,4,2,1,9992,10026,13
Task 9992,Job 1,7,4,4,6,0,11,13,2,4,1,0,9992,10026,6
Task 9993,Job 0,7,9,1,12,0,8,19,11,1,1,0,9993,10026,15
Task 9993,Job 1,12,8,1,10,0,13,22,9,1,1,2,9993,10026,20
Task 9994,Job 0,10,5,2,10,1,12,20,8,2,3,2,9994,10027,18
Task 9994,Job 1,15,4,3,7,1,18,22,4,3,1,0,9994,10027,12
Task 9995,Job 0,9,7,4,10,1,13,19,6,4,2,2,9995,10028,14
Task 9995,Job 1,14,10,1,11,0,15,25,10,1,1,1,9995,10028,9
Task 9996,Job 0,8,5,1,12,0,9,20,11,1,2,1,9996,10029,9
Task 9996,Job 1,13,4,1,11,1,14,24,10,1,4,1,9996,10029,12
Task 9997,Job 0,4,6,1,8,0,5,12,7,1,1,0,9997,10030,2
Task 9997,Job 1,9,6,1,8,0,10,17,7,1,3,0,9997,10030,4
Task 9998,Job 0,8,6,3,9,0,11,17,6,3,3,0,9998,10032,7
Task 9998,Job 1,13,9,3,11,1,16,24,8,3,2,0,9998,10032,4
Task 9999,Job 0,8,7,3,8,0,11,16,5,3,1,2,9999,10033,2
Task 9999,Job 1,13,8,1,10,0,14,23,9,1,2,0,9999,10033,4
Task 10000,Job 0,1,4,1,7,0,2,8,6,1,3,1,10000,10033,10
Task 10000,Job 1,6,9,2,11,1,8,17,9,2,2,0,10000,10033,10
Task 10001,Job 0,1,4,3,10,0,4,11,7,3,4,1,10001,10035,10
Task 10001,Job 1,6,4,4,9,0,10,15,5,4,4,0,10001,10035,12
Task 10002,Job 0,9,7,4,12,0,13,21,8,4,2,0,10002,10035,19
Task 10002,Job 1,14,9,2,7,0,16,21,5,2,1,0,10002,10035,18
Task 10003,Job 0,6,6,1,12,1,7,18,11,1,2,2,10003,10037,17
Task 10003,Job 1,11,7,3,7,0,14,18,4,3,4,0,10003,10037,12
Task 10004,Job 0,8,10,2,10,0,10,18,8,2,2,2,10004,10037,9
Task 10004,Job 1,13,10,2,10,1,15,23,8,2,1,1,10004,10037,12
Task 10005,Job 0,1,4,4,6,0,5,7,2,4,2,0,10005,10038,11
Task 10005,Job 1,6,6,4,10,0,10,16,6,4,4,1,10005,10038,3
Task 10006,Job 0,2,8,3,11,0,5,13,8,3,1,1,10006,10040,20
Task 10006,Job 1,7,5,3,6,0,10,13,3,3,1,2,10006,10040,4
Task 10007,Job 0,8,8,3,7,0,11,15,4,3,3,2,10007,10040,16
Task 10007,Job 1,13,7,3,12,0,16,25,9,3,1,1,10007,10040,13
Task 10008,Job 0,10,9,3,6,0,13,16,3,3,1,2,10008,10041,17
Task 10008,Job 1,15,5,2,9,0,17,24,7,2,2,0,10008,10041,9
Task 10009,Job 0,1,9,4,6,1,5,7,2,4,3,0,10009,10042,14
Task 10009,Job 1,6,7,3,7,0,9,13,4,3,2,2,10009,10042,20
Task 10010,Job 0,1,8,1,12,0,2,13,11,1,2,2,10010,10044,18
Task 10010,Job 1,6,10,4,12,0,10,18,8,4,1,0,10010,10044,10
Task 10011,Job 0,3,10,3,8,1,6,11,5,3,4,2,10011,10044,12
Task 10011,Job 1,8,4,4,11,1,12,19,7,4,4,1,10011,10044,4
Task 10012,Job 0,2,4,1,7,1,3,9,6,1,2,1,10012,10045,10
Task 10012,Job 1,7,7,3,12,0,10,19,9,3,3,2,10012,10045,13
Task 10013,Job 0,3,6,4,8,0,7,11,4,4,2,0,10013,10046,19
Task 10013,Job 1,8,6,4,11,1,12,19,7,4,3,1,10013,10046,15
Task 10014,Job 0,2,5,2,7,0,4,9,5,2,4,1,10014,10047,18
Task 10014,Job 1,7,5,4,8,1,11,15,4,4,3,1,10014,10047,18
Task 10015,Job 0,4,10,4,12,0,8,16,8,4,1,2,10015,10049,12
Task 10015,Job 1,9,8,1,7,1,10,16,6,1,3,2,10015,10049,2
Task 10016,Job 0,3,9,3,9,0,6,12,6,3,4,2,10016,10050,14
Task 10016,Job 1,8,8,2,11,0,10,19,9,2,3,0,10016,10050,11
Task 10017,Job 0,2,9,4,7,0,6,9,3,4,3,0,10017,10050,19
Task 10017,Job 1,7,4,3,11,0,10,18,8,3,4,0,10017,10050,11
Task 10018,Job 0,3,5,2,11,0,5,14,9,2,2,2,10018,10051,18
Task 10018,Job 1,8,8,2,8,0,10,16,6,2,2,0,10018,10051,7
Task 10019,Job 0,1,6,1,11,1,2,12,10,1,3,0,10019,10052,6
Task 10019,Job 1,6,4,2,12,0,8,18,10,2,4,0,10019,10052,11
Task 10020,Job 0,1,6,3,9,0,4,10,6,3,2,0,10020,10054,13
Task 10020,Job 1,6,5,4,9,0,10,15,5,4,1,2,10020,10054,14
Task 10021,Job 0,8,4,1,9,0,9,17,8,1,4,0,10021,10054,13
Task 10021,Job 1,13,7,3,11,1,16,24,8,3,2,0,10021,10054,10
Task 10022,Job 0,10,9,3,12,0,13,22,9,3,1,2,10022,10056,4
Task 10022,Job 1,15,4,3,6,0,18,21,3,3,3,0,10022,10056,2
Task 10023,Job 0,5,4,3,6,0,8,11,3,3,4,1,10023,10057,5
Task 10023,Job 1,10,5,1,8,1,11,18,7,1,2,1,10023,10057,2
Task 10024,Job 0,7,6,3,6,0,10,13,3,3,1,0,10024,10057,5
Task 10024,Job 1,12,9,2,10,0,14,22,8,2,1,0,10024,10057,13
Task 10025,Job 0,8,5,1,8,0,9,16,7,1,3,2,10025,10058,19
Task 10025,Job 1,13,8,4,9,1,17,22,5,4,1,1,10025,10058,7
Task 10026,Job 0,8,4,2,8,1,10,16,6,2,3,1,10026,10060,15
Task 10026,Job 1,13,4,1,9,0,14,22,8,1,3,0,10026,10060,17
Task 10027,Job 0,8,10,2,12,1,10,20,10,2,2,1,10027,10060,20
Task 10027,Job 1,13,7,3,6,0,16,19,3,3,1,0,10027,10060,10
Task 10028,Job 0,5,5,3,11,0,8,16,8,3,1,2,10028,10061,7
Task 10028,Job 1,10,4,4,11,1,14,21,7,4,2,0,10028,10061,20
Task 10029,Job 0,3,4,1,8,0,4,11,7,1,3,0,10029,10062,17
Task 10029,Job 1,8,9,1,7,0,9,15,6,1,2,0,10029,10062,19
Task 10030,Job 0,10,9,2,9,0,12,19,7,2,2,2,10030,10063,9
Task 10030,Job 1,15,8,4,9,0,19,24,5,4,3,0,10030,10063,10
Task 10031,Job 0,9,4,1,11,0,10,20,10,1,2,1,10031,10064,13
Task 10031,Job 1,14,9,2,11,0,16,25,9,2,3,0,10031,10064,2
Task 10032,Job 0,6,9,2,8,1,8,14,6,2,4,0,10032,10065,16
Task 10032,Job 1,11,9,3,11,0,14,22,8,3,3,0,10032,10065,13
Task 10033,Job 0,4,4,1,9,0,5,13,8,1,4,0,10033,10067,6
Task 10033,Job 1,9,10,3,7,0,12,16,4,3,3,1,10033,10067,20
Task 10034,Job 0,6,7,2,8,0,8,14,6,2,3,1,10034,10067,12
Task 10034,Job 1,11,9,1,7,0,12,18,6,1,4,0,10034,10067,10
Task 10035,Job 0,6,9,2,9,1,8,15,7,2,1,1,10035,10069,3
Task 10035,Job 1,11,4,4,9,1,15,20,5,4,4,2,10035,10069,7
Task 10036,Job 0,1,8,1,11,1,2,12,10,1,4,2,10036,10069,15
Task 10036,Job 1,6,5,3,10,0,9,16,7,3,1,2,10036,10069,3
Task 10037,Job 0,5,8,3,10,0,8,15,7,3,2,1,10037,10071,16
Task 10037,Job 1,10,10,1,6,0,11,16,5,1,2,1,10037,10071,20
Task 10038,Job 0,9,10,1,12,1,10,21,11,1,4,0,10038,10071,17
Task 10038,Job 1,14,5,4,8,0,18,22,4,4,1,0,10038,10071,2
Task 10039,Job 0,4,9,2,6,0,6,10,4,2,4,1,10039,10072,19
Task 10039,Job 1,9,5,1,7,0,10,16,6,1,3,2,10039,10072,18
Task 10040,Job 0,4,4,1,8,0,5,12,7,1,4,2,10040,10074,19
Task 10040,Job 1,9,6,3,10,0,12,19,7,3,4,0,10040,10074,19
Task 10041,Job 0,2,6,3,8,0,5,10,5,3,4,0,10041,10074,16
Task 10041,Job 1,7,9,3,8,0,10,15,5,3,2,2,10041,10074,3
Task 10042,Job 0,9,7,2,12,0,11,21,10,2,3,0,10042,10076,3
Task 10042,Job 1,14,9,2,10,0,16,24,8,2,4,0,10042,10076,8
Task 10043,Job 0,7,8,3,8,0,10,15,5,3,2,0,10043,10077,4
Task 10043,Job 1,12,8,3,11,0,15,23,8,3,2,0,10043,10077,7
Task 10044,Job 0,2,8,4,6,0,6,8,2,4,4,1,10044,10077,2
Task 10044,Job 1,7,10,1,8,0,8,15,7,1,4,2,10044,10077,17
Task 10045,Job 0,7,10,3,8,0,10,15,5,3,3,1,10045,10079,4
Task 10045,Job 1,12,10,2,6,0,14,18,4,2,3,1,10045,10079,16
Task 10046,Job 0,2,9,2,12,0,4,14,10,2,1,1,10046,10079,11
Task 10046,Job 1,7,5,2,12,1,9,19,10,2,2,1,10046,10079,3
Task 10047,Job 0,4,8,2,6,0,6,10,4,2,4,2,10047,10080,8
Task 10047,Job 1,9,4,1,11,0,10,20,10,1,2,2,10047,10080,3
Task 10048,Job 0,5,8,1,10,1,6,15,9,1,3,1,10048,10082,6
Task 10048,Job 1,10,9,1,10,1,11,20,9,1,2,2,10048,10082,20
Task 10049,Job 0,3,10,1,8,0,4,11,7,1,1,2,10049,10082,5
Task 10049,Job 1,8,7,1,9,1,9,17,8,1,4,2,10049,10082,4
Task 10050,Job 0,3,7,4,12,0,7,15,8,4,4,0,10050,10084,2
Task 10050,Job 1,8,9,2,8,1,10,16,6,2,1,2,10050,10084,19
Task 10051,Job 0,8,4,4,9,1,12,17,5,4,4,1,10051,10085,2
Task 10051,Job 1,13,10,3,12,0,16,25,9,3,1,2,10051,10085,15
Task 10052,Job 0,6,9,1,6,0,7,12,5,1,3,0,10052,10086,5
Task 10052,Job 1,11,8,1,6,1,12,17,5,1,2,1,10052,10086,17
Task 10053,Job 0,7,7,4,7,0,11,14,3,4,2,1,10053,10086,4
Task 10053,Job 1,12,10,3,10,0,15,22,7,3,2,2,10053,10086,15
Task 10054,Job 0,8,7,2,7,0,10,15,5,2,4,0,10054,10087,14
Task 10054,Job 1,13,7,4,7,0,17,20,3,4,1,2,10054,10087,7
Task 10055,Job 0,10,10,1,11,1,11,21,10,1,3,1,10055,10089,12
Task 10055,Job 1,15,6,2,9,0,17,24,7,2,4,2,10055,10089,2
Task 10056,Job 0,3,8,3,6,0,6,9,3,3,3,2,10056,10089,8
Task 10056,Job 1,8,9,3,6,0,11,14,3,3,3,0,10056,10089,2
Task 10057,Job 0,2,4,4,6,0,6,8,2,4,3,0,10057,10090,5
Task 10057,Job 1,7,7,4,12,0,11,19,8,4,3,0,10057,10090,9
Task 10058,Job 0,6,5,3,12,0,9,18,9,3,4,1,10058,10091,16
Task 10058,Job 1,11,5,3,10,0,14,21,7,3,3,2,10058,10091,7
Task 10059,Job 0,8,8,1,12,0,9,20,11,1,2,0,10059,10092,5
Task 10059,Job 1,13,5,4,10,0,17,23,6,4,4,1,10059,10092,6
Task 10060,Job 0,2,4,3,12,0,5,14,9,3,2,0,10060,10094,5
Task 10060,Job 1,7,6,4,12,0,11,19,8,4,4,1,10060,10094,11
Task 10061,Job 0,10,10,1,7,0,11,17,6,1,4,1,10061,10094,2
Task 10061,Job 1,15,5,2,9,0,17,24,7,2,3,2,10061,10094,6
Task 10062,Job 0,8,9,1,8,0,9,16,7,1,1,0,10062,10096,17
Task 10062,Job 1,13,9,3,9,1,16,22,6,3,4,0,10062,10096,10
Task 10063,Job 0,8,9,1,10,0,9,18,9,1,2,0,10063,10096,5
Task 10063,Job 1,13,8,4,9,0,17,22,5,4,1,2,10063,10096,5
Task 10064,Job 0,7,4,2,10,0,9,17,8,2,1,0,10064,10098,2
Task 10064,Job 1,12,9,4,8,0,16,20,4,4,4,1,10064,10098,5
Task 10065,Job 0,10,4,4,12,0,14,22,8,4,2,1,10065,10098,9
Task 10065,Job 1,15,9,2,10,0,17,25,8,2,1,2,10065,10098,7
Task 10066,Job 0,7,6,3,8,0,10,15,5,3,1,1,10066,10099,20
Task 10066,Job 1,12,10,3,9,1,15,21,6,3,4,1,10066,10099,13
Task 10067,Job 0,2,9,3,12,1,5,14,9,3,4,2,10067,10101,10
Task 10067,Job 1,7,4,4,8,0,11,15,4,4,1,1,10067,10101,17
Task 10068,Job 0,7,7,2,12,1,9,19,10,2,1,2,10068,10101,16
Task 10068,Job 1,12,8,4,8,1,16,20,4,4,4,2,10068,10101,2
Task 10069,Job 0,2,7,2,12,1,4,14,10,2,3,1,10069,10102,9
Task 10069,Job 1,7,10,4,7,0,11,14,3,4,3,1,10069,10102,15
Task 10070,Job 0,10,10,1,6,0,11,16,5,1,3,0,10070,10104,17
Task 10070,Job 1,15,4,4,8,0,19,23,4,4,4,2,10070,10104,13
Task 10071,Job 0,7,5,2,11,1,9,18,9,2,1,2,10071,10104,7
Task 10071,Job 1,12,4,1,10,0,13,22,9,1,2,2,10071,10104,7
Task 10072,Job 0,1,4,3,8,0,4,9,5,3,3,2,10072,10106,18
Task 10072,Job 1,6,8,2,11,0,8,17,9,2,1,2,10072,10106,4
Task 10073,Job 0,1,10,1,11,0,2,12,10,1,1,0,10073,10107,17
Task 10073,Job 1,6,10,2,11,0,8,17,9,2,3,0,10073,10107,8
Task 10074,Job 0,3,7,3,6,1,6,9,3,3,4,1,10074,10107,12
Task 10074,Job 1,8,7,1,7,0,9,15,6,1,3,2,10074,10107,9
Task 10075,Job 0,6,4,3,6,0,9,12,3,3,3,1,10075,10108,14
Task 10075,Job 1,11,5,4,12,0,15,23,8,4,2,2,10075,10108,8
Task 10076,Job 0,6,6,4,12,1,10,18,8,4,2,2,10076,10110,13
Task 10076,Job 1,11,6,1,11,1,12,22,10,1,1,2,10076,10110,15
Task 10077,Job 0,6,10,3,8,0,9,14,5,3,3,0,10077,10111,12
Task 10077,Job 1,11,10,1,11,0,12,22,10,1,2,2,10077,10111,19
Task 10078,Job 0,6,5,3,10,0,9,16,7,3,3,1,10078,10111,19
Task 10078,Job 1,11,5,4,6,1,15,17,2,4,3,2,10078,10111,11
Task 10079,Job 0,8,8,2,8,0,10,16,6,2,3,0,10079,10113,14
Task 10079,Job 1,13,6,4,9,1,17,22,5,4,3,2,10079,10113,13
Task 10080,Job 0,3,6,2,11,0,5,14,9,2,1,2,10080,10114,9
Task 10080,Job 1,8,10,1,7,1,9,15,6,1,1,2,10080,10114,4
Task 10081,Job 0,2,8,3,11,0,5,13,8,3,3,0,10081,10115,4
Task 10081,Job 1,7,4,4,9,1,11,16,5,4,3,1,10081,10115,5
Task 10082,Job 0,10,7,2,11,0,12,21,9,2,2,2,10082,10116,13
Task 10082,Job 1,15,6,1,12,1,16,27,11,1,1,0,10082,10116,16
Task 10083,Job 0,7,4,4,11,1,11,18,7,4,4,0,10083,10116,20
Task 10083,Job 1,12,6,1,10,1,13,22,9,1,3,1,10083,10116,12
Task 10084,Job 0,8,7,4,7,0,12,15,3,4,2,1,10084,10117,14
Task 10084,Job 1,13,6,1,7,1,14,20,6,1,3,0,10084,10117,8
Task 10085,Job 0,5,8,4,7,0,9,12,3,4,1,1,10085,10118,3
Task 10085,Job 1,10,7,1,8,1,11,18,7,1,3,2,10085,10118,11
Task 10086,Job 0,7,5,2,12,0,9,19,10,2,2,1,10086,10119,12
Task 10086,Job 1,12,10,3,12,0,15,24,9,3,4,2,10086,10119,11
Task 10087,Job 0,1,7,2,10,0,3,11,8,2,2,2,10087,10121,14
Task 10087,Job 1,6,5,3,6,0,9,12,3,3,4,1,10087,10121,9
Task 10088,Job 0,1,4,3,8,0,4,9,5,3,2,2,10088,10122,3
Task 10088,Job 1,6,9,3,7,1,9,13,4,3,4,2,10088,10122,18
Task 10089,Job 0,9,5,4,8,0,13,17,4,4,1,1,10089,10123,2
Task 10089,Job 1,14,6,2,8,0,16,22,6,2,3,1,10089,10123,5
Task 10090,Job 0,5,9,4,10,0,9,15,6,4,3,1,10090,10123,20
Task 10090,Job 1,10,9,1,11,1,11,21,10,1,1,0,10090,10123,2
Task 10091,Job 0,9,8,3,9,1,12,18,6,3,2,2,10091,10125,5
Task 10091,Job 1,14,5,1,11,0,15,25,10,1,4,0,10091,10125,6
Task 10092,Job 0,6,5,1,9,0,7,15,8,1,2,0,10092,10126,5
Task 10092,Job 1,11,6,4,12,1,15,23,8,4,2,2,10092,10126,13
Task 10093,Job 0,1,10,4,7,1,5,8,3,4,2,1,10093,10126,12
Task 10093,Job 1,6,6,4,12,0,10,18,8,4,4,1,10093,10126,3
Task 10094,Job 0,8,9,1,6,1,9,14,5,1,3,1,10094,10127,8
Task 10094,Job 1,13,5,4,11,0,17,24,7,4,4,0,10094,10127,13
Task 10095,Job 0,7,4,4,12,1,11,19,8,4,3,2,10095,10128,14
Task 10095,Job 1,12,6,1,10,0,13,22,9,1,1,2,10095,10128,19
Task 10096,Job 0,10,6,3,10,0,13,20,7,3,3,2,10096,10130,10
Task 10096,Job 1,15,9,2,7,0,17,22,5,2,3,2,10096,10130,9
Task 10097,Job 0,4,9,2,9,0,6,13,7,2,1,0,10097,10130,3
Task 10097,Job 1,9,5,1,11,0,10,20,10,1,1,2,10097,10130,3
Task 10098,Job 0,4,8,1,7,0,5,11,6,1,2,1,10098,10131,16
Task 10098,Job 1,9,5,3,10,1,12,19,7,3,1,2,10098,10131,6
Task 10099,Job 0,9,10,2,7,0,11,16,5,2,2,1,10099,10133,6
Task 10099,Job 1,14,10,2,11,0,16,25,9,2,4,0,10099,10133,17
Task 10100,Job 0,9,5,3,11,1,12,20,8,3,1,1,10100,10133,5
Task 10100,Job 1,14,6,4,9,0,18,23,5,4,2,0,10100,10133,10
Task 10101,Job 0,4,9,1,7,0,5,11,6,1,2,2,10101,10135,10
Task 10101,Job 1,9,7,1,11,1,10,20,10,1,1,2,10101,10135,18
Task 10102,Job 0,4,6,3,6,0,7,10,3,3,3,1,10102,10135,13
Task 10102,Job 1,9,9,1,11,0,10,20,10,1,2,1,10102,10135,5
Task 10103,Job 0,5,10,1,8,0,6,13,7,1,2,2,10103,10137,6
Task 10103,Job 1,10,10,1,7,0,11,17,6,1,3,1,10103,10137,18
Task 10104,Job 0,5,9,4,8,1,9,13,4,4,2,1,10104,10137,12
Task 10104,Job 1,10,4,4,6,0,14,16,2,4,1,2,10104,10137,13
Task 10105,Job 0,7,10,2,10,0,9,17,8,2,3,2,10105,10138,8
Task 10105,Job 1,12,8,4,6,0,16,18,2,4,3,2,10105,10138,2
Task 10106,Job 0,1,6,4,12,0,5,13,8,4,1,0,10106,10139,14
Task 10106,Job 1,6,4,2,9,0,8,15,7,2,3,2,10106,10139,3
Task 10107,Job 0,3,10,4,9,1,7,12,5,4,2,1,10107,10141,17
Task 10107,Job 1,8,10,1,10,0,9,18,9,1,1,0,10107,10141,8
Task 10108,Job 0,8,4,3,12,0,11,20,9,3,3,2,10108,10142,9
Task 10108,Job 1,13,8,2,8,0,15,21,6,2,4,1,10108,10142,17
Task 10109,Job 0,4,6,4,8,1,8,12,4,4,3,2,10109,10142,10
Task 10109,Job 1,9,4,2,9,0,11,18,7,2,2,0,10109,10142,14
Task 10110,Job 0,2,9,1,6,0,3,8,5,1,2,0,10110,10144,3
Task 10110,Job 1,7,4,2,8,0,9,15,6,2,4,1,10110,10144,15
Task 10111,Job 0,5,6,2,9,0,7,14,7,2,1,1,10111,10145,3
Task 10111,Job 1,10,10,3,6,0,13,16,3,3,2,0,10111,10145,14
Task 10112,Job 0,10,7,3,11,1,13,21,8,3,3,0,10112,10145,14
Task 10112,Job 1,15,9,3,10,0,18,25,7,3,2,2,10112,10145,18
Task 10113,Job 0,2,9,3,6,1,5,8,3,3,2,0,10113,10147,8
Task 10113,Job 1,7,9,1,9,1,8,16,8,1,1,2,10113,10147,13
Task 10114,Job 0,2,10,3,8,0,5,10,5,3,4,0,10114,10147,12
Task 10114,Job 1,7,8,4,6,0,11,13,2,4,4,0,10114,10147,15
Task 10115,Job 0,10,9,3,9,0,13,19,6,3,4,2,10115,10148,11
Task 10115,Job 1,15,10,2,8,0,17,23,6,2,3,2,10115,10148,4
Task 10116,Job 0,7,7,1,6,0,8,13,5,1,2,1,10116,10150,11
Task 10116,Job 1,12,9,2,7,0,14,19,5,2,1,2,10116,10150,9
Task 10117,Job 0,5,8,3,6,0,8,11,3,3,1,1,10117,10150,4
Task 10117,Job 1,10,6,1,12,0,11,22,11,1,1,1,10117,10150,2
Task 10118,Job 0,4,5,4,11,0,8,15,7,4,2,0,10118,10152,4
Task 10118,Job 1,9,7,4,9,0,13,18,5,4,4,0,10118,10152,12
Task 10119,Job 0,6,7,2,12,0,8,18,10,2,1,1,10119,10152,11
Task 10119,Job 1,11,4,4,8,0,15,19,4,4,1,0,10119,10152,3
Task 10120,Job 0,2,10,2,8,0,4,10,6,2,3,1,10120,10153,10
Task 10120,Job 1,7,10,2,8,0,9,15,6,2,4,0,10120,10153,6
Task 10121,Job 0,7,10,4,7,0,11,14,3,4,2,2,10121,10154,8
Task 10121,Job 1,12,6,2,6,1,14,18,4,2,2,1,10121,10154,4
Task 10122,Job 0,8,4,3,9,0,11,17,6,3,1,2,10122,10155,14
Task 10122,Job 1,13,10,4,12,0,17,25,8,4,2,0,10122,10155,12
Task 10123,Job 0,8,5,2,10,1,10,18,8,2,2,1,10123,10157,9
Task 10123,Job 1,13,5,4,7,0,17,20,3,4,1,0,10123,10157,4
Task 10124,Job 0,1,9,1,11,0,2,12,10,1,3,0,10124,10158,14
Task 10124,Job 1,6,8,3,12,0,9,18,9,3,2,2,10124,10158,20
Task 10125,Job 0,7,8,4,12,0,11,19,8,4,1,0,10125,10159,13
Task 10125,Job 1,12,8,1,10,0,13,22,9,1,1,2,10125,10159,13
Task 10126,Job 0,8,5,3,8,0,11,16,5,3,4,2,10126,10159,15
Task 10126,Job 1,13,8,4,11,1,17,24,7,4,4,0,10126,10159,6
Task 10127,Job 0,9,5,3,7,1,12,16,4,3,3,2,10127,10160,7
Task 10127,Job 1,14,4,1,7,0,15,21,6,1,2,2,10127,10160,19
Task 10128,Job 0,5,10,4,8,0,9,13,4,4,4,2,10128,10161,5
Task 10128,Job 1,10,10,1,12,0,11,22,11,1,3,0,10128,10161,2
Task 10129,Job 0,8,5,2,9,1,10,17,7,2,1,0,10129,10163,17
Task 10129,Job 1,13,10,1,11,0,14,24,10,1,2,0,10129,10163,6
Task 10130,Job 0,7,5,1,8,1,8,15,7,1,1,1,10130,10163,15
Task 10130,Job 1,12,7,1,8,0,13,20,7,1,2,2,10130,10163,14
Task 10131,Job 0,3,4,3,12,0,6,15,9,3,2,1,10131,10164,13
Task 10131,Job 1,8,9,3,10,1,11,18,7,3,3,0,10131,10164,6
Task 10132,Job 0,3,10,3,6,1,6,9,3,3,2,0,10132,10165,12
Task 10132,Job 1,8,7,2,11,0,10,19,9,2,4,0,10132,10165,15
Task 10133,Job 0,3,5,2,11,0,5,14,9,2,4,0,10133,10167,6
Task 10133,Job 1,8,6,1,11,1,9,19,10,1,2,2,10133,10167,11
Task 10134,Job 0,5,7,1,11,0,6,16,10,1,3,1,10134,10168,15
Task 10134,Job 1,10,5,1,11,1,11,21,10,1,4,1,10134,10168,2
Task 10135,Job 0,6,4,4,11,0,10,17,7,4,4,2,10135,10168,12
Task 10135,Job 1,11,6,4,8,0,15,19,4,4,3,2,10135,10168,14
Task 10136,Job 0,1,7,3,10,0,4,11,7,3,2,0,10136,10170,8
Task 10136,Job 1,6,10,4,9,1,10,15,5,4,3,2,10136,10170,9
Task 10137,Job 0,1,5,1,12,1,2,13,11,1,4,0,10137,10171,3
Task 10137,Job 1,6,6,1,9,0,7,15,8,1,3,2,10137,10171,12
Task 10138,Job 0,5,10,4,8,1,9,13,4,4,3,0,10138,10171,14
Task 10138,Job 1,10,5,3,12,0,13,22,9,3,2,2,10138,10171,12
Task 10139,Job 0,9,7,1,9,1,10,18,8,1,1,0,10139,10173,6
Task 10139,Job 1,14,5,1,12,0,15,26,11,1,1,0,10139,10173,17
Task 10140,Job 0,5,10,2,12,0,7,17,10,2,4,0,10140,10174,2
Task 10140,Job 1,10,5,3,12,0,13,22,9,3,2,0,10140,10174,2
Task 10141,Job 0,10,10,4,8,0,14,18,4,4,2,0,10141,10174,18
Task 10141,Job 1,15,7,4,12,0,19,27,8,4,2,1,10141,10174,4
Task 10142,Job 0,3,6,4,10,1,7,13,6,4,4,2,10142,10176,6
Task 10142,Job 1,8,8,2,9,1,10,17,7,2,1,2,10142,10176,10
Task 10143,Job 0,8,6,1,12,0,9,20,11,1,1,1,10143,10177,6
Task 10143,Job 1,13,6,3,12,0,16,25,9,3,4,1,10143,10177,11
Task 10144,Job 0,3,5,2,12,0,5,15,10,2,3,2,10144,10177,12
Task 10144,Job 1,8,10,2,12,0,10,20,10,2,3,0,10144,10177,2
Task 10145,Job 0,6,4,4,12,1,10,18,8,4,4,1,10145,10178,11
Task 10145,Job 1,11,4,3,6,1,14,17,3,3,4,1,10145,10178,17
Task 10146,Job 0,6,10,3,7,1,9,13,4,3,4,2,10146,10179,7
Task 10146,Job 1,11,7,2,10,0,13,21,8,2,3,0,10146,10179,16
Task 10147,Job 0,4,7,3,11,0,7,15,8,3,4,0,10147,10181,6
Task 10147,Job 1,9,8,2,6,0,11,15,4,2,4,2,10147,10181,9
Task 10148,Job 0,5,8,3,10,0,8,15,7,3,1,2,10148,10181,16
Task 10148,Job 1,10,7,3,11,0,13,21,8,3,3,2,10148,10181,17
Task 10149,Job 0,6,4,3,11,0,9,17,8,3,1,2,10149,10183,10
Task 10149,Job 1,11,5,4,8,0,15,19,4,4,2,2,10149,10183,2
Task 10150,Job 0,9,9,3,6,1,12,15,3,3,1,2,10150,10184,18
Task 10150,Job 1,14,10,2,7,0,16,21,5,2,1,0,10150,10184,7
Task 10151,Job 0,2,7,1,9,0,3,11,8,1,4,0,10151,10185,15
Task 10151,Job 1,7,4,4,10,0,11,17,6,4,2,2,10151,10185,15
Task 10152,Job 0,1,5,3,6,0,4,7,3,3,1,0,10152,10185,7
Task 10152,Job 1,6,7,3,11,1,9,17,8,3,2,2,10152,10185,13
Task 10153,Job 0,1,5,4,6,0,5,7,2,4,4,0,10153,10186,12
Task 10153,Job 1,6,6,4,12,0,10,18,8,4,3,2,10153,10186,18
Task 10154,Job 0,2,4,3,12,0,5,14,9,3,4,0,10154,10187,9
Task 10154,Job 1,7,7,4,8,0,11,15,4,4,4,1,10154,10187,12
Task 10155,Job 0,4,8,1,11,0,5,15,10,1,1,1,10155,10188,18
Task 10155,Job 1,9,9,1,12,0,10,21,11,1,2,2,10155,10188,10
Task 10156,Job 0,6,7,3,12,0,9,18,9,3,2,2,10156,10190,11
Task 10156,Job 1,11,9,2,10,0,13,21,8,2,1,1,10156,10190,6
Task 10157,Job 0,4,8,1,8,0,5,12,7,1,1,1,10157,10191,18
Task 10157,Job 1,9,9,4,6,0,13,15,2,4,2,0,10157,10191,2
Task 10158,Job 0,6,8,2,7,0,8,13,5,2,4,1,10158,10191,10
Task 10158,Job 1,11,9,3,6,0,14,17,3,3,1,1,10158,10191,6
Task 10159,Job 0,4,4,4,8,0,8,12,4,4,3,2,10159,10193,17
Task 10159,Job 1,9,9,3,12,0,12,21,9,3,1,2,10159,10193,4
Task 10160,Job 0,1,6,4,6,0,5,7,2,4,2,1,10160,10194,4
Task 10160,Job 1,6,5,4,9,1,10,15,5,4,4,2,10160,10194,16
Task 10161,Job 0,3,10,2,10,0,5,13,8,2,3,0,10161,10194,15
Task 10161,Job 1,8,5,1,9,0,9,17,8,1,2,1,10161,10194,16
Task 10162,Job 0,5,9,1,12,0,6,17,11,1,4,2,10162,10195,17
Task 10162,Job 1,10,7,4,10,0,14,20,6,4,1,2,10162,10195,8
Task 10163,Job 0,4,4,2,12,0,6,16,10,2,3,2,10163,10196,18
Task 10163,Job 1,9,4,1,8,0,10,17,7,1,4,0,10163,10196,14
Task 10164,Job 0,9,10,1,11,0,10,20,10,1,1,2,10164,10198,19
Task 10164,Job 1,14,6,3,12,1,17,26,9,3,1,0,10164,10198,12
Task 10165,Job 0,4,10,1,8,0,5,12,7,1,3,0,10165,10198,4
Task 10165,Job 1,9,4,4,9,1,13,18,5,4,1,0,10165,10198,13
Task 10166,Job 0,8,7,4,9,1,12,17,5,4,4,2,10166,10199,9
Task 10166,Job 1,13,5,4,10,0,17,23,6,4,2,0,10166,10199,12
Task 10167,Job 0,3,7,4,12,0,7,15,8,4,3,1,10167,10201,2
Task 10167,Job 1,8,4,2,7,0,10,15,5,2,2,2,10167,10201,11
Task 10168,Job 0,6,4,4,7,1,10,13,3,4,2,0,10168,10201,20
Task 10168,Job 1,11,9,4,12,0,15,23,8,4,4,2,10168,10201,16
Task 10169,Job 0,4,10,4,8,0,8,12,4,4,2,0,10169,10203,16
Task 10169,Job 1,9,7,4,11,0,13,20,7,4,3,1,10169,10203,15
Task 10170,Job 0,5,8,1,8,0,6,13,7,1,3,2,10170,10203,16
Task 10170,Job 1,10,8,3,9,0,13,19,6,3,1,1,10170,10203,19
Task 10171,Job 0,10,4,3,12,1,13,22,9,3,2,0,10171,10204,6
Task 10171,Job 1,15,8,4,12,0,19,27,8,4,3,1,10171,10204,17
Task 10172,Job 0,1,6,3,11,0,4,12,8,3,1,1,10172,10205,6
Task 10172,Job 1,6,8,3,11,1,9,17,8,3,2,1,10172,10205,13
Task 10173,Job 0,10,9,3,9,0,13,19,6,3,1,2,10173,10206,19
Task 10173,Job 1,15,4,4,7,0,19,22,3,4,2,0,10173,10206,11
Task 10174,Job 0,2,10,2,6,1,4,8,4,2,3,0,10174,10207,13
Task 10174,Job 1,7,5,1,6,1,8,13,5,1,1,0,10174,10207,11
Task 10175,Job 0,8,6,2,7,1,10,15,5,2,1,0,10175,10209,20
Task 10175,Job 1,13,7,4,8,1,17,21,4,4,2,1,10175,10209,8
Task 10176,Job 0,5,10,3,8,0,8,13,5,3,3,2,10176,10210,13
Task 10176,Job 1,10,10,3,6,1,13,16,3,3,3,2,10176,10210,18
Task 10177,Job 0,7,4,3,9,0,10,16,6,3,3,1,10177,10211,10
Task 10177,Job 1,12,5,3,7,0,15,19,4,3,2,1,10177,10211,11
Task 10178,Job 0,6,4,2,7,1,8,13,5,2,2,0,10178,10212,17
Task 10178,Job 1,11,6,2,6,0,13,17,4,2,4,2,10178,10212,17
Task 10179,Job 0,5,7,3,10,0,8,15,7,3,2,1,10179,10212,14
Task 10179,Job 1,10,9,3,9,0,13,19,6,3,2,1,10179,10212,9
Task 10180,Job 0,1,4,3,9,0,4,10,6,3,1,0,10180,10214,18
Task 10180,Job 1,6,4,4,8,0,10,14,4,4,4,0,10180,10214,7
Task 10181,Job 0,3,5,3,6,1,6,9,3,3,3,1,10181,10214,6
Task 10181,Job 1,8,9,4,11,0,12,19,7,4,3,2,10181,10214,20
Task 10182,Job 0,4,5,3,12,0,7,16,9,3,4,0,10182,10215,20
Task 10182,Job 1,9,10,4,7,0,13,16,3,4,1,0,10182,10215,6
Task 10183,Job 0,10,10,1,11,0,11,21,10,1,3,2,10183,10217,13
Task 10183,Job 1,15,6,4,10,0,19,25,6,4,4,1,10183,10217,17
Task 10184,Job 0,3,9,4,12,0,7,15,8,4,1,1,10184,10217,15
Task 10184,Job 1,8,5,4,11,0,12,19,7,4,4,2,10184,10217,11
Task 10185,Job 0,6,4,1,7,0,7,13,6,1,1,0,10185,10218,10
Task 10185,Job 1,11,9,3,7,0,14,18,4,3,3,2,10185,10218,19
Task 10186,Job 0,10,7,3,7,0,13,17,4,3,3,0,10186,10220,18
Task 10186,Job 1,15,8,4,9,0,19,24,5,4,2,2,10186,10220,14
Task 10187,Job 0,6,7,4,12,0,10,18,8,4,4,0,10187,10221,8
Task 10187,Job 1,11,7,3,6,0,14,17,3,3,1,1,10187,10221,19
Task 10188,Job 0,9,10,3,10,0,12,19,7,3,4,1,10188,10222,19
Task 10188,Job 1,14,10,2,7,0,16,21,5,2,1,2,10188,10222,13
Task 10189,Job 0,5,4,2,6,0,7,11,4,2,3,0,10189,10222,13
Task 10189,Job 1,10,8,3,12,0,13,22,9,3,3,1,10189,10222,3
Task 10190,Job 0,1,9,4,7,0,5,8,3,4,2,0,10190,10223,7
Task 10190,Job 1,6,7,1,11,0,7,17,10,1,3,1,10190,10223,18
Task 10191,Job 0,10,6,4,7,0,14,17,3,4,3,1,10191,10224,10
Task 10191,Job 1,15,9,4,9,0,19,24,5,4,1,2,10191,10224,8
Task 10192,Job 0,7,10,2,10,0,9,17,8,2,1,2,10192,10226,14
Task 10192,Job 1,12,5,2,8,0,14,20,6,2,3,1,10192,10226,6
Task 10193,Job 0,1,10,3,6,0,4,7,3,3,1,1,10193,10227,4
Task 10193,Job 1,6,7,3,8,0,9,14,5,3,1,0,10193,10227,13
Task 10194,Job 0,3,10,1,7,0,4,10,6,1,4,2,10194,10228,6
Task 10194,Job 1,8,6,4,7,0,12,15,3,4,3,1,10194,10228,10
Task 10195,Job 0,10,6,3,8,0,13,18,5,3,1,2,10195,10228,3
Task 10195,Job 1,15,5,3,7,0,18,22,4,3,1,2,10195,10228,8
Task 10196,Job 0,9,9,2,12,0,11,21,10,2,1,1,10196,10229,3
Task 10196,Job 1,14,4,3,11,0,17,25,8,3,3,1,10196,10229,5
Task 10197,Job 0,7,4,3,9,0,10,16,6,3,3,0,10197,10230,6
Task 10197,Job 1,12,6,3,10,1,15,22,7,3,3,2,10197,10230,4
Task 10198,Job 0,7,10,2,6,0,9,13,4,2,2,1,10198,10231,15
Task 10198,Job 1,12,7,1,6,0,13,18,5,1,1,0,10198,10231,8
Task 10199,Job 0,7,9,2,10,0,9,17,8,2,4,0,10199,10232,17
Task 10199,Job 1,12,6,1,9,1,13,21,8,1,3,1,10199,10232,17
Task 10200,Job 0,4,7,2,7,1,6,11,5,2,2,0,10200,10233,5
Task 10200,Job 1,9,4,4,12,1,13,21,8,4,3,2,10200,10233,2
Task 10201,Job 0,10,5,3,9,0,13,19,6,3,3,2,10201,10234,11
Task 10201,Job 1,15,4,2,8,0,17,23,6,2,1,1,10201,10234,16
Task 10202,Job 0,3,6,2,10,0,5,13,8,2,4,0,10202,10236,3
Task 10202,Job 1,8,4,1,12,0,9,20,11,1,3,0,10202,10236,17
Task 10203,Job 0,6,9,1,10,1,7,16,9,1,4,1,10203,10237,10
Task 10203,Job 1,11,6,3,7,0,14,18,4,3,3,0,10203,10237,20
Task 10204,Job 0,3,7,1,9,0,4,12,8,1,2,1,10204,10238,3
Task 10204,Job 1,8,9,2,10,0,10,18,8,2,1,0,10204,10238,17
Task 10205,Job 0,3,8,2,11,0,5,14,9,2,3,2,10205,10238,19
Task 10205,Job 1,8,8,2,6,0,10,14,4,2,4,1,10205,10238,17
Task 10206,Job 0,8,6,1,8,0,9,16,7,1,1,0,10206,10239,2
Task 10206,Job 1,13,4,3,6,0,16,19,3,3,3,1,10206,10239,7
Task 10207,Job 0,4,10,1,6,1,5,10,5,1,1,1,10207,10241,11
Task 10207,Job 1,9,4,2,9,0,11,18,7,2,1,0,10207,10241,12
Task 10208,Job 0,3,6,4,7,0,7,10,3,4,3,2,10208,10241,7
Task 10208,Job 1,8,6,3,12,0,11,20,9,3,1,2,10208,10241,13
Task 10209,Job 0,4,10,1,9,0,5,13,8,1,3,1,10209,10242,20
Task 10209,Job 1,9,9,1,8,0,10,17,7,1,2,0,10209,10242,9
Task 10210,Job 0,7,7,2,12,0,9,19,10,2,1,2,10210,10243,7
Task 10210,Job 1,12,4,2,8,1,14,20,6,2,1,0,10210,10243,3
Task 10211,Job 0,9,5,1,12,0,10,21,11,1,3,1,10211,10244,17
Task 10211,Job 1,14,8,1,8,0,15,22,7,1,3,1,10211,10244,15
Task 10212,Job 0,5,8,2,12,0,7,17,10,2,4,1,10212,10245,14
Task 10212,Job 1,10,10,4,6,0,14,16,2,4,4,0,10212,10245,16
Task 10213,Job 0,1,6,3,12,0,4,13,9,3,3,0,10213,10247,2
Task 10213,Job 1,6,4,3,11,0,9,17,8,3,4,2,10213,10247,11
Task 10214,Job 0,6,8,3,6,0,9,12,3,3,3,0,10214,10247,18
Task 10214,Job 1,11,6,3,12,0,14,23,9,3,4,0,10214,10247,15
Task 10215,Job 0,8,5,1,11,0,9,19,10,1,3,1,10215,10248,17
Task 10215,Job 1,13,8,4,8,0,17,21,4,4,3,1,10215,10248,16
Task 10216,Job 0,5,8,1,11,1,6,16,10,1,3,0,10216,10249,12
Task 10216,Job 1,10,10,2,7,0,12,17,5,2,1,0,10216,10249,18
Task 10217,Job 0,1,7,2,7,0,3,8,5,2,2,0,10217,10250,7
Task 10217,Job 1,6,7,2,9,0,8,15,7,2,1,2,10217,10250,14
Task 10218,Job 0,5,10,3,7,0,8,12,4,3,2,2,10218,10252,14
Task 10218,Job 1,10,10,1,10,0,11,20,9,1,3,0,10218,10252,19
Task 10219,Job 0,9,5,3,9,1,12,18,6,3,4,1,10219,10252,16
Task 10219,Job 1,14,6,3,6,0,17,20,3,3,4,0,10219,10252,16
Task 10220,Job 0,1,10,2,6,0,3,7,4,2,2,1,10220,10253,20
Task 10220,Job 1,6,6,2,8,0,8,14,6,2,2,2,10220,10253,13
Task 10221,Job 0,8,10,2,7,0,10,15,5,2,2,0,10221,10255,4
Task 10221,Job 1,13,8,1,12,0,14,25,11,1,2,1,10221,10255,15
Task 10222,Job 0,9,9,4,9,1,13,18,5,4,4,0,10222,10256,2
Task 10222,Job 1,14,10,1,10,0,15,24,9,1,3,1,10222,10256,6
Task 10223,Job 0,10,5,2,7,0,12,17,5,2,1,1,10223,10256,11
Task 10223,Job 1,15,10,1,11,0,16,26,10,1,4,0,10223,10256,4
Task 10224,Job 0,9,9,4,12,0,13,21,8,4,1,2,10224,10257,12
Task 10224,Job 1,14,6,4,10,0,18,24,6,4,2,2,10224,10257,11
Task 10225,Job 0,6,6,3,11,1,9,17,8,3,1,1,10225,10259,4
Task 10225,Job 1,11,8,4,6,1,15,17,2,4,3,1,10225,10259,12
Task 10226,Job 0,2,10,1,11,0,3,13,10,1,2,0,10226,10259,15
Task 10226,Job 1,7,8,3,12,1,10,19,9,3,2,0,10226,10259,15
Task 10227,Job 0,5,7,1,12,0,6,17,11,1,1,2,10227,10260,12
Task 10227,Job 1,10,4,1,10,0,11,20,9,1,3,2,10227,10260,20
Task 10228,Job 0,8,5,2,12,0,10,20,10,2,1,0,10228,10261,10
Task 10228,Job 1,13,8,4,6,0,17,19,2,4,4,0,10228,10261,9
Task 10229,Job 0,4,10,1,6,0,5,10,5,1,1,2,10229,10262,10
Task 10229,Job 1,9,4,1,11,0,10,20,10,1,2,0,10229,10262,8
Task 10230,Job 0,9,9,1,7,1,10,16,6,1,2,2,10230,10264,7
Task 10230,Job 1,14,4,4,8,0,18,22,4,4,1,0,10230,10264,19
Task 10231,Job 0,8,7,2,7,0,10,15,5,2,3,1,10231,10265,9
Task 10231,Job 1,13,7,2,7,0,15,20,5,2,3,0,10231,10265,17
Task 10232,Job 0,5,9,3,11,0,8,16,8,3,2,1,10232,10266,8
Task 10232,Job 1,10,5,3,12,0,13,22,9,3,3,0,10232,10266,18
Task 10233,Job 0,10,9,4,9,0,14,19,5,4,2,1,10233,10267,15
Task 10233,Job 1,15,10,3,10,0,18,25,7,3,2,0,10233,10267,13
Task 10234,Job 0,2,8,1,12,0,3,14,11,1,3,2,10234,10268,10
Task 10234,Job 1,7,9,3,11,0,10,18,8,3,1,0,10234,10268,18
Task 10235,Job 0,3,7,3,10,0,6,13,7,3,1,2,10235,10268,3
Task 10235,Job 1,8,4,2,12,1,10,20,10,2,1,2,10235,10268,10
Task 10236,Job 0,1,10,2,6,0,3,7,4,2,2,2,10236,10269,6
Task 10236,Job 1,6,6,4,10,0,10,16,6,4,3,2,10236,10269,14
Task 10237,Job 0,3,8,2,9,0,5,12,7,2,3,0,10237,10271,5
Task 10237,Job 1,8,5,1,6,0,9,14,5,1,4,0,10237,10271,18
Task 10238,Job 0,6,7,1,10,1,7,16,9,1,2,1,10238,10272,4
Task 10238,Job 1,11,4,1,12,0,12,23,11,1,3,0,10238,10272,6
Task 10239,Job 0,1,10,3,12,0,4,13,9,3,2,1,10239,10272,10
Task 10239,Job 1,6,10,4,12,0,10,18,8,4,2,1,10239,10272,11
Task 10240,Job 0,8,9,2,9,0,10,17,7,2,2,1,10240,10273,10
Task 10240,Job 1,13,6,3,8,0,16,21,5,3,3,2,10240,10273,9
Task 10241,Job 0,8,10,1,6,1,9,14,5,1,1,1,10241,10274,17
Task 10241,Job 1,13,7,4,9,1,17,22,5,4,2,2,10241,10274,19
Task 10242,Job 0,6,5,1,12,0,7,18,11,1,4,1,10242,10276,9
Task 10242,Job 1,11,4,3,12,0,14,23,9,3,2,0,10242,10276,11
Task 10243,Job 0,7,5,3,9,1,10,16,6,3,4,0,10243,10276,7
Task 10243,Job 1,12,6,1,12,0,13,24,11,1,3,0,10243,10276,19
Task 10244,Job 0,8,10,1,12,0,9,20,11,1,3,2,10244,10278,4
Task 10244,Job 1,13,5,1,12,0,14,25,11,1,1,0,10244,10278,19
Task 10245,Job 0,7,7,4,12,0,11,19,8,4,4,1,10245,10279,8
Task 10245,Job 1,12,4,2,10,0,14,22,8,2,3,1,10245,10279,13
Task 10246,Job 0,2,7,3,7,0,5,9,4,3,2,0,10246,10279,18
Task 10246,Job 1,7,6,3,6,0,10,13,3,3,3,2,10246,10279,18
Task 10247,Job 0,6,8,2,9,1,8,15,7,2,4,1,10247,10280,9
Task 10247,Job 1,11,6,4,11,1,15,22,7,4,3,2,10247,10280,9
Task 10248,Job 0,9,8,2,7,0,11,16,5,2,2,0,10248,10281,6
Task 10248,Job 1,14,10,3,9,0,17,23,6,3,1,0,10248,10281,2
Task 10249,Job 0,8,10,1,6,1,9,14,5,1,4,0,10249,10282,2
Task 10249,Job 1,13,9,2,9,0,15,22,7,2,4,1,10249,10282,5
Task 10250,Job 0,9,7,4,11,1,13,20,7,4,2,2,10250,10284,12
Task 10250,Job 1,14,4,4,7,0,18,21,3,4,4,0,10250,10284,5
Task 10251,Job 0,6,10,2,7,0,8,13,5,2,4,0,10251,10285,13
Task 10251,Job 1,11,6,2,10,0,13,21,8,2,2,1,10251,10285,16
Task 10252,Job 0,8,9,3,11,1,11,19,8,3,4,2,10252,10286,11
Task 10252,Job 1,13,8,2,12,0,15,25,10,2,4,1,10252,10286,7
Task 10253,Job 0,5,4,1,11,1,6,16,10,1,4,2,10253,10286,18
Task 10253,Job 1,10,8,4,7,1,14,17,3,4,4,0,10253,10286,19
Task 10254,Job 0,4,7,4,6,0,8,10,2,4,3,1,10254,10288,10
Task 10254,Job 1,9,10,2,8,0,11,17,6,2,3,1,10254,10288,15
Task 10255,Job 0,9,4,1,9,1,10,18,8,1,1,0,10255,10288,15
Task 10255,Job 1,14,7,2,6,0,16,20,4,2,1,2,10255,10288,4
Task 10256,Job 0,8,8,4,7,0,12,15,3,4,4,0,10256,10289,13
Task 10256,Job 1,13,8,3,12,0,16,25,9,3,4,2,10256,10289,6
Task 10257,Job 0,7,4,1,11,0,8,18,10,1,3,2,10257,10290,12
Task 10257,Job 1,12,5,3,11,0,15,23,8,3,4,2,10257,10290,10
Task 10258,Job 0,7,8,1,9,0,8,16,8,1,2,0,10258,10292,6
Task 10258,Job 1,12,6,3,9,0,15,21,6,3,1,1,10258,10292,6
Task 10259,Job 0,5,5,1,11,0,6,16,10,1,1,2,10259,10292,8
Task 10259,Job 1,10,7,3,11,0,13,21,8,3,1,2,10259,10292,4
Task 10260,Job 0,2,6,1,9,0,3,11,8,1,3,2,10260,10293,11
Task 10260,Job 1,7,10,4,11,0,11,18,7,4,3,0,10260,10293,5
Task 10261,Job 0,2,5,3,10,0,5,12,7,3,3,0,10261,10295,16
Task 10261,Job 1,7,9,2,12,1,9,19,10,2,2,1,10261,10295,9
Task 10262,Job 0,10,6,1,10,0,11,20,9,1,4,1,10262,10295,3
Task 10262,Job 1,15,10,2,8,0,17,23,6,2,1,1,10262,10295,16
Task 10263,Job 0,1,10,2,7,0,3,8,5,2,4,0,10263,10296,10
Task 10263,Job 1,6,9,2,7,0,8,13,5,2,1,0,10263,10296,18
Task 10264,Job 0,10,6,4,10,1,14,20,6,4,2,2,10264,10298,16
Task 10264,Job 1,15,4,1,8,0,16,23,7,1,1,2,10264,10298,8
Task 10265,Job 0,1,5,2,11,0,3,12,9,2,4,2,10265,10299,12
Task 10265,Job 1,6,5,4,6,0,10,12,2,4,3,1,10265,10299,8
Task 10266,Job 0,3,7,4,11,0,7,14,7,4,1,2,10266,10299,12
Task 10266,Job 1,8,6,1,11,0,9,19,10,1,1,1,10266,10299,9
Task 10267,Job 0,5,4,3,7,1,8,12,4,3,3,2,10267,10300,9
Task 10267,Job 1,10,9,4,10,0,14,20,6,4,4,2,10267,10300,4
Task 10268,Job 0,4,9,3,7,0,7,11,4,3,3,0,10268,10302,14
Task 10268,Job 1,9,9,3,7,1,12,16,4,3,1,2,10268,10302,20
Task 10269,Job 0,7,9,4,12,0,11,19,8,4,4,2,10269,10303,13
Task 10269,Job 1,12,9,2,6,0,14,18,4,2,2,0,10269,10303,7
Task 10270,Job 0,6,8,3,7,0,9,13,4,3,3,1,10270,10303,4
Task 10270,Job 1,11,4,4,11,0,15,22,7,4,1,0,10270,10303,14
Task 10271,Job 0,5,4,2,7,0,7,12,5,2,4,0,10271,10305,9
Task 10271,Job 1,10,6,1,9,1,11,19,8,1,1,1,10271,10305,6
Task 10272,Job 0,6,10,2,8,0,8,14,6,2,4,1,10272,10305,7
Task 10272,Job 1,11,10,3,12,0,14,23,9,3,2,0,10272,10305,12
Task 10273,Job 0,2,5,1,8,1,3,10,7,1,4,0,10273,10306,15
Task 10273,Job 1,7,8,2,11,1,9,18,9,2,2,2,10273,10306,2
Task 10274,Job 0,2,7,1,6,1,3,8,5,1,4,2,10274,10307,5
Task 10274,Job 1,7,5,3,12,0,10,19,9,3,4,2,10274,10307,3
Task 10275,Job 0,10,4,4,9,0,14,19,5,4,1,0,10275,10308,2
Task 10275,Job 1,15,5,4,9,0,19,24,5,4,2,1,10275,10308,6
Task 10276,Job 0,5,9,2,12,0,7,17,10,2,1,0,10276,10310,13
Task 10276,Job 1,10,7,3,12,0,13,22,9,3,2,2,10276,10310,4
Task 10277,Job 0,1,9,3,7,1,4,8,4,3,3,1,10277,10310,6
Task 10277,Job 1,6,9,1,7,1,7,13,6,1,2,1,10277,10310,7
Task 10278,Job 0,7,6,1,12,1,8,19,11,1,2,1,10278,10312,15
Task 10278,Job 1,12,8,4,11,0,16,23,7,4,1,2,10278,10312,13
Task 10279,Job 0,10,4,4,9,0,14,19,5,4,3,2,10279,10313,16
Task 10279,Job 1,15,9,2,6,0,17,21,4,2,3,2,10279,10313,7
Task 10280,Job 0,9,7,2,7,1,11,16,5,2,3,0,10280,10314,16
Task 10280,Job 1,14,9,3,12,0,17,26,9,3,1,1,10280,10314,6
Task 10281,Job 0,4,8,3,11,1,7,15,8,3,4,1,10281,10315,19
Task 10281,Job 1,9,6,4,12,0,13,21,8,4,1,2,10281,10315,10
Task 10282,Job 0,4,10,1,6,0,5,10,5,1,1,1,10282,10316,4
Task 10282,Job 1,9,10,3,7,1,12,16,4,3,4,2,10282,10316,13
Task 10283,Job 0,5,7,3,8,1,8,13,5,3,1,1,10283,10317,14
Task 10283,Job 1,10,9,3,8,0,13,18,5,3,3,0,10283,10317,2
Task 10284,Job 0,8,5,2,9,0,10,17,7,2,4,0,10284,10318,20
Task 10284,Job 1,13,5,2,12,0,15,25,10,2,4,1,10284,10318,8
Task 10285,Job 0,2,5,1,12,0,3,14,11,1,3,2,10285,10318,16
Task 10285,Job 1,7,7,1,12,0,8,19,11,1,2,2,10285,10318,10
Task 10286,Job 0,7,6,1,9,1,8,16,8,1,2,0,10286,10319,10
Task 10286,Job 1,12,9,4,12,0,16,24,8,4,1,1,10286,10319,18
Task 10287,Job 0,9,6,1,8,0,10,17,7,1,4,1,10287,10321,2
Task 10287,Job 1,14,8,3,9,0,17,23,6,3,2,1,10287,10321,19
Task 10288,Job 0,3,7,4,11,0,7,14,7,4,3,0,10288,10322,7
Task 10288,Job 1,8,4,2,11,1,10,19,9,2,1,2,10288,10322,17
Task 10289,Job 0,10,8,2,7,0,12,17,5,2,1,2,10289,10322,3
Task 10289,Job 1,15,8,1,10,0,16,25,9,1,4,0,10289,10322,2
Task 10290,Job 0,9,5,4,8,1,13,17,4,4,3,2,10290,10324,11
Task 10290,Job 1,14,4,3,11,0,17,25,8,3,3,1,10290,10324,10
Task 10291,Job 0,3,7,2,10,1,5,13,8,2,2,0,10291,10324,14
Task 10291,Job 1,8,6,3,12,0,11,20,9,3,4,2,10291,10324,15
Task 10292,Job 0,10,10,1,12,0,11,22,11,1,3,2,10292,10326,10
Task 10292,Job 1,15,8,3,12,1,18,27,9,3,4,2,10292,10326,2
Task 10293,Job 0,6,7,1,10,0,7,16,9,1,4,0,10293,10326,3
Task 10293,Job 1,11,6,3,12,1,14,23,9,3,2,0,10293,10326,15
Task 10294,Job 0,7,4,1,8,0,8,15,7,1,4,2,10294,10328,8
Task 10294,Job 1,12,9,3,8,0,15,20,5,3,3,0,10294,10328,9
Task 10295,Job 0,5,7,3,6,0,8,11,3,3,1,0,10295,10328,19
Task 10295,Job 1,10,9,4,11,0,14,21,7,4,2,2,10295,10328,9
Task 10296,Job 0,2,8,2,10,0,4,12,8,2,3,0,10296,10330,13
Task 10296,Job 1,7,5,4,8,0,11,15,4,4,2,2,10296,10330,2
Task 10297,Job 0,8,6,2,10,1,10,18,8,2,4,0,10297,10330,3
Task 10297,Job 1,13,4,2,7,0,15,20,5,2,1,2,10297,10330,3
Task 10298,Job 0,6,6,2,10,0,8,16,8,2,2,2,10298,10331,10
Task 10298,Job 1,11,7,1,10,0,12,21,9,1,2,1,10298,10331,6
Task 10299,Job 0,7,5,4,9,0,11,16,5,4,2,2,10299,10333,8
Task 10299,Job 1,12,8,4,7,1,16,19,3,4,4,1,10299,10333,11
Task 10300,Job 0,5,9,3,6,1,8,11,3,3,2,0,10300,10334,6
Task 10300,Job 1,10,6,2,11,1,12,21,9,2,2,2,10300,10334,2
Task 10301,Job 0,6,9,2,6,0,8,12,4,2,4,2,10301,10334,15
Task 10301,Job 1,11,7,4,12,0,15,23,8,4,1,0,10301,10334,6
Task 10302,Job 0,10,7,2,10,0,12,20,8,2,1,0,10302,10336,2
Task 10302,Job 1,15,10,2,9,0,17,24,7,2,1,2,10302,10336,14
Task 10303,Job 0,3,6,1,8,0,4,11,7,1,4,1,10303,10336,7
Task 10303,Job 1,8,4,1,8,1,9,16,7,1,4,0,10303,10336,20
Task 10304,Job 0,10,10,2,9,0,12,19,7,2,3,1,10304,10338,5
Task 10304,Job 1,15,10,1,6,1,16,21,5,1,2,1,10304,10338,7
Task 10305,Job 0,5,5,3,11,0,8,16,8,3,4,0,10305,10339,2
Task 10305,Job 1,10,5,2,12,0,12,22,10,2,1,2,10305,10339,3
Task 10306,Job 0,4,5,3,7,1,7,11,4,3,1,1,10306,10340,20
Task 10306,Job 1,9,10,1,8,1,10,17,7,1,4,1,10306,10340,11
Task 10307,Job 0,6,6,3,11,0,9,17,8,3,4,1,10307,10341,4
Task 10307,Job 1,11,4,2,10,0,13,21,8,2,1,0,10307,10341,13
Task 10308,Job 0,2,10,2,6,0,4,8,4,2,2,0,10308,10342,5
Task 10308,Job 1,7,4,4,7,0,11,14,3,4,2,1,10308,10342,2
Task 10309,Job 0,7,6,2,7,0,9,14,5,2,3,0,10309,10343,15
Task 10309,Job 1,12,4,1,6,1,13,18,5,1,2,2,10309,10343,4
Task 10310,Job 0,8,5,4,12,1,12,20,8,4,2,0,10310,10343,16
Task 10310,Job 1,13,5,1,9,0,14,22,8,1,3,0,10310,10343,13
Task 10311,Job 0,2,7,4,12,1,6,14,8,4,2,1,10311,10344,3
Task 10311,Job 1,7,7,3,11,1,10,18,8,3,1,0,10311,10344,7
Task 10312,Job 0,5,8,1,12,0,6,17,11,1,2,2,10312,10345,19
Task 10312,Job 1,10,6,1,6,0,11,16,5,1,1,1,10312,10345,13
Task 10313,Job 0,1,8,3,12,0,4,13,9,3,3,0,10313,10346,19
Task 10313,Job 1,6,9,4,9,0,10,15,5,4,4,2,10313,10346,14
Task 10314,Job 0,10,6,4,8,0,14,18,4,4,3,0,10314,10347,10
Task 10314,Job 1,15,5,3,12,1,18,27,9,3,3,2,10314,10347,17
Task 10315,Job 0,9,10,4,6,0,13,15,2,4,1,0,10315,10349,16
Task 10315,Job 1,14,10,3,10,0,17,24,7,3,4,2,10315,10349,7
Task 10316,Job 0,6,10,3,11,0,9,17,8,3,4,1,10316,10350,10
Task 10316,Job 1,11,9,2,6,0,13,17,4,2,1,2,10316,10350,14
Task 10317,Job 0,6,7,4,7,0,10,13,3,4,2,1,10317,10350,16
Task 10317,Job 1,11,8,4,7,1,15,18,3,4,1,2,10317,10350,13
Task 10318,Job 0,1,10,3,6,1,4,7,3,3,1,1,10318,10351,8
Task 10318,Job 1,6,6,3,6,0,9,12,3,3,4,2,10318,10351,10
Task 10319,Job 0,3,6,4,9,1,7,12,5,4,1,1,10319,10353,19
Task 10319,Job 1,8,6,2,7,0,10,15,5,2,4,0,10319,10353,12
Task 10320,Job 0,1,6,1,9,0,2,10,8,1,3,1,10320,10353,19
Task 10320,Job 1,6,9,3,7,0,9,13,4,3,1,1,10320,10353,11
Task 10321,Job 0,8,7,1,8,0,9,16,7,1,2,1,10321,10354,12
Task 10321,Job 1,13,10,4,11,0,17,24,7,4,1,2,10321,10354,5
Task 10322,Job 0,2,9,4,12,0,6,14,8,4,2,2,10322,10356,17
Task 10322,Job 1,7,4,4,9,1,11,16,5,4,3,0,10322,10356,8
Task 10323,Job 0,5,6,2,10,0,7,15,8,2,3,1,10323,10357,19
Task 10323,Job 1,10,7,4,11,1,14,21,7,4,1,0,10323,10357,20
Task 10324,Job 0,6,10,4,11,0,10,17,7,4,4,2,10324,10358,15
Task 10324,Job 1,11,7,3,12,1,14,23,9,3,4,1,10324,10358,6
Task 10325,Job 0,3,8,4,9,0,7,12,5,4,4,2,10325,10358,15
Task 10325,Job 1,8,4,2,7,1,10,15,5,2,1,2,10325,10358,4
Task 10326,Job 0,6,9,3,6,0,9,12,3,3,2,0,10326,10360,7
Task 10326,Job 1,11,9,3,8,1,14,19,5,3,2,2,10326,10360,8
Task 10327,Job 0,10,5,3,9,0,13,19,6,3,2,0,10327,10361,18
Task 10327,Job 1,15,10,3,7,0,18,22,4,3,3,0,10327,10361,18
Task 10328,Job 0,5,10,4,10,0,9,15,6,4,1,2,10328,10362,20
Task 10328,Job 1,10,8,2,12,1,12,22,10,2,1,1,10328,10362,2
Task 10329,Job 0,7,10,4,6,1,11,13,2,4,1,1,10329,10362,8
Task 10329,Job 1,12,10,3,7,0,15,19,4,3,3,0,10329,10362,2
Task 10330,Job 0,9,6,4,11,1,13,20,7,4,2,1,10330,10364,16
Task 10330,Job 1,14,8,4,9,0,18,23,5,4,3,1,10330,10364,19
Task 10331,Job 0,7,8,4,7,0,11,14,3,4,3,2,10331,10365,9
Task 10331,Job 1,12,10,1,8,0,13,20,7,1,3,0,10331,10365,2
Task 10332,Job 0,10,7,2,7,0,12,17,5,2,4,1,10332,10365,6
Task 10332,Job 1,15,8,1,12,0,16,27,11,1,4,1,10332,10365,15
Task 10333,Job 0,4,5,1,12,0,5,16,11,1,3,2,10333,10367,2
Task 10333,Job 1,9,7,4,10,0,13,19,6,4,4,1,10333,10367,7
Task 10334,Job 0,2,6,2,9,0,4,11,7,2,1,2,10334,10368,9
Task 10334,Job 1,7,5,4,7,0,11,14,3,4,2,0,10334,10368,6
Task 10335,Job 0,8,5,3,9,0,11,17,6,3,1,0,10335,10368,7
Task 10335,Job 1,13,8,3,8,1,16,21,5,3,1,1,10335,10368,12
Task 10336,Job 0,6,9,1,9,0,7,15,8,1,1,0,10336,10369,16
Task 10336,Job 1,11,10,1,11,0,12,22,10,1,2,1,10336,10369,11
Task 10337,Job 0,3,9,4,6,1,7,9,2,4,4,0,10337,10370,10
Task 10337,Job 1,8,7,1,7,0,9,15,6,1,1,0,10337,10370,16
Task 10338,Job 0,4,6,3,10,0,7,14,7,3,1,0,10338,10372,9
Task 10338,Job 1,9,5,3,7,1,12,16,4,3,4,0,10338,10372,14
Task 10339,Job 0,5,10,1,10,0,6,15,9,1,1,2,10339,10373,19
Task 10339,Job 1,10,6,4,10,0,14,20,6,4,2,2,10339,10373,11
Task 10340,Job 0,6,8,1,7,0,7,13,6,1,2,1,10340,10373,10
Task 10340,Job 1,11,9,3,9,0,14,20,6,3,3,2,10340,10373,9
Task 10341,Job 0,6,4,1,8,0,7,14,7,1,2,2,10341,10375,19
Task 10341,Job 1,11,7,4,6,0,15,17,2,4,3,0,10341,10375,16
Task 10342,Job 0,4,7,3,7,0,7,11,4,3,1,0,10342,10375,14
Task 10342,Job 1,9,8,2,10,0,11,19,8,2,1,0,10342,10375,4
Task 10343,Job 0,2,6,1,9,1,3,11,8,1,1,1,10343,10377,11
Task 10343,Job 1,7,5,2,9,0,9,16,7,2,1,1,10343,10377,2
Task 10344,Job 0,5,4,3,12,0,8,17,9,3,4,2,10344,10378,16
Task 10344,Job 1,10,7,1,10,0,11,20,9,1,3,2,10344,10378,9
Task 10345,Job 0,10,10,3,12,0,13,22,9,3,2,0,10345,10378,7
Task 10345,Job 1,15,9,2,12,0,17,27,10,2,1,1,10345,10378,10
Task 10346,Job 0,7,4,4,6,0,11,13,2,4,4,0,10346,10379,20
Task 10346,Job 1,12,5,1,7,0,13,19,6,1,4,1,10346,10379,16
Task 10347,Job 0,3,7,2,7,0,5,10,5,2,3,0,10347,10381,4
Task 10347,Job 1,8,9,3,6,0,11,14,3,3,1,0,10347,10381,15
Task 10348,Job 0,6,10,3,8,1,9,14,5,3,4,0,10348,10381,7
Task 10348,Job 1,11,6,1,7,0,12,18,6,1,3,0,10348,10381,14
Task 10349,Job 0,9,7,4,7,0,13,16,3,4,2,2,10349,10383,16
Task 10349,Job 1,14,9,2,7,0,16,21,5,2,1,0,10349,10383,16
Task 10350,Job 0,10,7,3,9,0,13,19,6,3,3,1,10350,10383,5
Task 10350,Job 1,15,4,3,11,0,18,26,8,3,1,2,10350,10383,4
Task 10351,Job 0,5,4,3,6,0,8,11,3,3,4,2,10351,10384,10
Task 10351,Job 1,10,5,1,10,0,11,20,9,1,2,2,10351,10384,13
Task 10352,Job 0,8,4,4,11,0,12,19,7,4,1,1,10352,10386,13
Task 10352,Job 1,13,9,3,12,0,16,25,9,3,4,2,10352,10386,17
Task 10353,Job 0,3,10,2,6,0,5,9,4,2,1,2,10353,10386,4
Task 10353,Job 1,8,5,2,12,0,10,20,10,2,4,1,10353,10386,18
Task 10354,Job 0,1,5,4,12,0,5,13,8,4,3,2,10354,10388,6
Task 10354,Job 1,6,7,4,7,0,10,13,3,4,4,2,10354,10388,2
Task 10355,Job 0,7,5,1,12,0,8,19,11,1,4,0,10355,10388,13
Task 10355,Job 1,12,8,3,10,0,15,22,7,3,1,1,10355,10388,10
Task 10356,Job 0,6,6,4,6,0,10,12,2,4,3,0,10356,10389,3
Task 10356,Job 1,11,4,2,7,0,13,18,5,2,2,2,10356,10389,3
Task 10357,Job 0,3,10,3,10,1,6,13,7,3,4,1,10357,10391,9
Task 10357,Job 1,8,8,4,12,0,12,20,8,4,2,1,10357,10391,5
Task 10358,Job 0,6,8,4,9,0,10,15,5,4,1,0,10358,10392,2
Task 10358,Job 1,11,8,4,6,0,15,17,2,4,3,0,10358,10392,19
Task 10359,Job 0,2,7,2,12,0,4,14,10,2,4,0,10359,10392,19
Task 10359,Job 1,7,8,1,11,0,8,18,10,1,2,0,10359,10392,17
Task 10360,Job 0,10,10,3,9,0,13,19,6,3,3,1,10360,10393,8
Task 10360,Job 1,15,6,1,12,1,16,27,11,1,2,1,10360,10393,7
Task 10361,Job 0,3,4,1,12,0,4,15,11,1,3,0,10361,10395,2
Task 10361,Job 1,8,6,2,7,1,10,15,5,2,3,0,10361,10395,19
Task 10362,Job 0,1,8,4,11,1,5,12,7,4,1,0,10362,10395,5
Task 10362,Job 1,6,4,4,12,0,10,18,8,4,3,1,10362,10395,10
Task 10363,Job 0,4,6,3,6,1,7,10,3,3,4,2,10363,10397,3
Task 10363,Job 1,9,7,1,8,0,10,17,7,1,3,0,10363,10397,16
Task 10364,Job 0,1,10,1,7,0,2,8,6,1,2,1,10364,10398,5
Task 10364,Job 1,6,10,2,6,0,8,12,4,2,4,2,10364,10398,5
Task 10365,Job 0,2,4,4,10,0,6,12,6,4,3,2,10365,10399,10
Task 10365,Job 1,7,6,3,11,0,10,18,8,3,2,0,10365,10399,4
Task 10366,Job 0,5,4,1,11,1,6,16,10,1,1,1,10366,10399,14
Task 10366,Job 1,10,8,3,11,0,13,21,8,3,4,2,10366,10399,6
Task 10367,Job 0,3,10,3,12,0,6,15,9,3,4,2,10367,10400,4
Task 10367,Job 1,8,5,1,9,0,9,17,8,1,2,1,10367,10400,15
Task 10368,Job 0,4,8,1,8,0,5,12,7,1,1,2,10368,10401,9
Task 10368,Job 1,9,10,2,12,1,11,21,10,2,4,2,10368,10401,8
Task 10369,Job 0,3,8,4,9,0,7,12,5,4,3,0,10369,10403,7
Task 10369,Job 1,8,7,2,7,1,10,15,5,2,2,1,10369,10403,7
Task 10370,Job 0,1,8,3,8,0,4,9,5,3,1,1,10370,10404,14
Task 10370,Job 1,6,7,2,7,0,8,13,5,2,4,2,10370,10404,11
Task 10371,Job 0,5,4,3,9,0,8,14,6,3,3,1,10371,10404,6
Task 10371,Job 1,10,5,1,10,0,11,20,9,1,3,2,10371,10404,15
Task 10372,Job 0,2,7,3,12,0,5,14,9,3,2,0,10372,10405,6
Task 10372,Job 1,7,6,4,12,0,11,19,8,4,3,1,10372,10405,9
Task 10373,Job 0,10,8,3,7,1,13,17,4,3,2,1,10373,10407,19
Task 10373,Job 1,15,7,4,10,0,19,25,6,4,1,1,10373,10407,15
Task 10374,Job 0,2,10,4,8,0,6,10,4,4,2,2,10374,10407,2
Task 10374,Job 1,7,8,3,9,1,10,16,6,3,1,2,10374,10407,5
Task 10375,Job 0,8,8,2,6,0,10,14,4,2,1,0,10375,10408,14
Task 10375,Job 1,13,4,4,6,0,17,19,2,4,4,0,10375,10408,7
Task 10376,Job 0,9,6,3,6,0,12,15,3,3,3,2,10376,10409,9
Task 10376,Job 1,14,7,4,10,0,18,24,6,4,4,0,10376,10409,19
Task 10377,Job 0,6,10,3,8,0,9,14,5,3,4,1,10377,10410,19
Task 10377,Job 1,11,4,4,12,0,15,23,8,4,3,0,10377,10410,11
Task 10378,Job 0,5,8,1,7,0,6,12,6,1,3,0,10378,10411,13
Task 10378,Job 1,10,9,1,7,0,11,17,6,1,4,1,10378,10411,7
Task 10379,Job 0,2,5,4,8,1,6,10,4,4,3,1,10379,10413,19
Task 10379,Job 1,7,10,1,10,0,8,17,9,1,2,0,10379,10413,12
Task 10380,Job 0,5,10,4,8,0,9,13,4,4,2,2,10380,10414,10
Task 10380,Job 1,10,10,3,7,1,13,17,4,3,4,0,10380,10414,7
Task 10381,Job 0,1,6,3,7,0,4,8,4,3,2,0,10381,10415,6
Task 10381,Job 1,6,7,4,12,1,10,18,8,4,2,1,10381,10415,6
Task 10382,Job 0,6,6,1,10,1,7,16,9,1,3,2,10382,10415,10
Task 10382,Job 1,11,5,1,11,0,12,22,10,1,3,1,10382,10415,13
Task 10383,Job 0,3,6,1,10,0,4,13,9,1,3,1,10383,10416,13
Task 10383,Job 1,8,8,3,10,1,11,18,7,3,1,1,10383,10416,16
Task 10384,Job 0,6,5,3,10,0,9,16,7,3,2,1,10384,10417,11
Task 10384,Job 1,11,7,4,6,1,15,17,2,4,2,1,10384,10417,5
Task 10385,Job 0,2,5,3,11,0,5,13,8,3,3,2,10385,10418,20
Task 10385,Job 1,7,7,4,11,0,11,18,7,4,3,2,10385,10418,17
Task 10386,Job 0,8,5,4,9,0,12,17,5,4,4,0,10386,10419,8
Task 10386,Job 1,13,8,3,12,0,16,25,9,3,1,2,10386,10419,14
Task 10387,Job 0,6,10,3,9,1,9,15,6,3,2,2,10387,10420,20
Task 10387,Job 1,11,5,3,12,0,14,23,9,3,2,2,10387,10420,10
Task 10388,Job 0,2,10,3,6,1,5,8,3,3,4,0,10388,10421,6
Task 10388,Job 1,7,8,2,6,0,9,13,4,2,1,2,10388,10421,4
Task 10389,Job 0,10,8,3,8,0,13,18,5,3,3,2,10389,10423,18
Task 10389,Job 1,15,4,2,8,0,17,23,6,2,1,1,10389,10423,10
Task 10390,Job 0,10,8,1,7,0,11,17,6,1,1,0,10390,10424,3
Task 10390,Job 1,15,8,2,11,0,17,26,9,2,4,1,10390,10424,8
Task 10391,Job 0,4,5,3,11,1,7,15,8,3,2,2,10391,10425,5
Task 10391,Job 1,9,9,3,6,0,12,15,3,3,3,1,10391,10425,14
Task 10392,Job 0,4,4,1,10,0,5,14,9,1,2,2,10392,10425,12
Task 10392,Job 1,9,5,4,11,1,13,20,7,4,1,2,10392,10425,19
Task 10393,Job 0,3,8,2,7,0,5,10,5,2,3,0,10393,10426,19
Task 10393,Job 1,8,8,1,9,0,9,17,8,1,4,0,10393,10426,17
Task 10394,Job 0,9,8,3,9,0,12,18,6,3,3,1,10394,10428,9
Task 10394,Job 1,14,7,4,8,0,18,22,4,4,1,2,10394,10428,19
Task 10395,Job 0,9,8,4,9,0,13,18,5,4,4,0,10395,10428,3
Task 10395,Job 1,14,7,3,9,0,17,23,6,3,1,0,10395,10428,3
Task 10396,Job 0,1,5,1,7,0,2,8,6,1,4,0,10396,10430,20
Task 10396,Job 1,6,4,1,9,0,7,15,8,1,2,2,10396,10430,10
Task 10397,Job 0,1,6,3,7,0,4,8,4,3,4,0,10397,10431,7
Task 10397,Job 1,6,10,1,10,1,7,16,9,1,4,2,10397,10431,13
Task 10398,Job 0,3,7,3,12,0,6,15,9,3,1,2,10398,10432,3
Task 10398,Job 1,8,6,4,11,0,12,19,7,4,2,2,10398,10432,8
Task 10399,Job 0,9,7,2,11,0,11,20,9,2,3,0,10399,10433,20
Task 10399,Job 1,14,10,1,11,0,15,25,10,1,2,2,10399,10433,8
Task 10400,Job 0,5,5,2,8,0,7,13,6,2,4,0,10400,10433,19
Task 10400,Job 1,10,9,4,7,1,14,17,3,4,2,1,10400,10433,18
Task 10401,Job 0,8,7,2,12,1,10,20,10,2,4,0,10401,10435,14
Task 10401,Job 1,13,6,4,10,0,17,23,6,4,3,1,10401,10435,11
Task 10402,Job 0,7,9,4,12,1,11,19,8,4,3,0,10402,10436,8
Task 10402,Job 1,12,4,3,12,1,15,24,9,3,1,1,10402,10436,15
Task 10403,Job 0,10,5,1,8,1,11,18,7,1,4,2,10403,10437,4
Task 10403,Job 1,15,5,3,6,0,18,21,3,3,4,0,10403,10437,5
Task 10404,Job 0,8,8,2,10,0,10,18,8,2,1,0,10404,10437,16
Task 10404,Job 1,13,10,4,10,1,17,23,6,4,1,2,10404,10437,7
Task 10405,Job 0,3,4,3,10,0,6,13,7,3,3,0,10405,10439,12
Task 10405,Job 1,8,8,4,8,0,12,16,4,4,4,0,10405,10439,6
Task 10406,Job 0,2,8,1,11,0,3,13,10,1,1,0,10406,10440,18
Task 10406,Job 1,7,5,4,12,0,11,19,8,4,1,1,10406,10440,16
Task 10407,Job 0,6,6,2,10,0,8,16,8,2,4,2,10407,10441,4
Task 10407,Job 1,11,7,3,7,0,14,18,4,3,3,1,10407,10441,17
Task 10408,Job 0,9,8,1,11,0,10,20,10,1,4,2,10408,10442,7
Task 10408,Job 1,14,6,4,11,0,18,25,7,4,4,0,10408,10442,15
Task 10409,Job 0,2,6,1,6,0,3,8,5,1,1,1,10409,10443,17
Task 10409,Job 1,7,9,3,11,0,10,18,8,3,2,1,10409,10443,7
Task 10410,Job 0,6,9,3,11,1,9,17,8,3,3,0,10410,10444,20
Task 10410,Job 1,11,10,4,9,0,15,20,5,4,1,1,10410,10444,18
Task 10411,Job 0,4,4,4,6,0,8,10,2,4,2,0,10411,10444,4
Task 10411,Job 1,9,8,1,11,1,10,20,10,1,3,0,10411,10444,7
Task 10412,Job 0,9,9,3,12,1,12,21,9,3,1,2,10412,10446,9
Task 10412,Job 1,14,7,3,6,0,17,20,3,3,1,0,10412,10446,8
Task 10413,Job 0,9,7,4,12,0,13,21,8,4,3,1,10413,10446,10
Task 10413,Job 1,14,10,3,8,1,17,22,5,3,2,0,10413,10446,12
Task 10414,Job 0,8,5,3,9,0,11,17,6,3,4,0,10414,10448,5
Task 10414,Job 1,13,4,2,6,0,15,19,4,2,2,2,10414,10448,3
Task 10415,Job 0,1,5,2,9,0,3,10,7,2,1,2,10415,10448,20
Task 10415,Job 1,6,8,4,11,0,10,17,7,4,1,1,10415,10448,2
Task 10416,Job 0,10,9,4,8,1,14,18,4,4,3,2,10416,10450,6
Task 10416,Job 1,15,4,3,10,0,18,25,7,3,3,1,10416,10450,8
Task 10417,Job 0,5,4,3,11,0,8,16,8,3,2,2,10417,10450,16
Task 10417,Job 1,10,10,3,6,1,13,16,3,3,3,1,10417,10450,7
Task 10418,Job 0,10,6,4,12,1,14,22,8,4,1,1,10418,10451,5
Task 10418,Job 1,15,10,2,7,0,17,22,5,2,1,0,10418,10451,7
Task 10419,Job 0,2,4,1,7,0,3,9,6,1,2,0,10419,10453,9
Task 10419,Job 1,7,9,2,8,0,9,15,6,2,2,2,10419,10453,20
Task 10420,Job 0,8,6,3,11,1,11,19,8,3,2,2,10420,10454,4
Task 10420,Job 1,13,5,4,11,0,17,24,7,4,2,1,10420,10454,16
Task 10421,Job 0,3,6,4,10,0,7,13,6,4,4,2,10421,10455,18
Task 10421,Job 1,8,9,1,11,0,9,19,10,1,2,1,10421,10455,8
Task 10422,Job 0,5,9,3,12,1,8,17,9,3,1,2,10422,10455,4
Task 10422,Job 1,10,5,2,9,0,12,19,7,2,3,2,10422,10455,5
Task 10423,Job 0,10,10,3,11,0,13,21,8,3,1,1,10423,10457,8
Task 10423,Job 1,15,4,1,12,0,16,27,11,1,3,0,10423,10457,19
Task 10424,Job 0,10,9,4,6,1,14,16,2,4,2,1,10424,10458,7
Task 10424,Job 1,15,4,2,9,0,17,24,7,2,1,1,10424,10458,17
Task 10425,Job 0,4,9,1,7,0,5,11,6,1,4,0,10425,10458,20
Task 10425,Job 1,9,6,2,9,0,11,18,7,2,4,0,10425,10458,11
Task 10426,Job 0,1,10,2,11,1,3,12,9,2,1,1,10426,10459,18
Task 10426,Job 1,6,8,1,6,0,7,12,5,1,2,1,10426,10459,15
Task 10427,Job 0,1,4,3,12,0,4,13,9,3,2,0,10427,10461,20
Task 10427,Job 1,6,4,2,10,0,8,16,8,2,1,2,10427,10461,13
Task 10428,Job 0,6,9,3,10,0,9,16,7,3,4,2,10428,10461,2
Task 10428,Job 1,11,8,2,7,0,13,18,5,2,2,2,10428,10461,9
Task 10429,Job 0,3,4,4,6,0,7,9,2,4,3,0,10429,10462,12
Task 10429,Job 1,8,7,1,9,1,9,17,8,1,2,1,10429,10462,17
Task 10430,Job 0,9,9,1,8,0,10,17,7,1,2,0,10430,10463,4
Task 10430,Job 1,14,5,2,8,0,16,22,6,2,2,0,10430,10463,10
Task 10431,Job 0,10,5,3,12,0,13,22,9,3,1,0,10431,10465,10
Task 10431,Job 1,15,8,1,9,0,16,24,8,1,3,1,10431,10465,13
Task 10432,Job 0,8,9,4,8,1,12,16,4,4,3,0,10432,10466,17
Task 10432,Job 1,13,6,4,12,0,17,25,8,4,1,2,10432,10466,12
Task 10433,Job 0,4,8,4,11,0,8,15,7,4,3,1,10433,10467,18
Task 10433,Job 1,9,5,1,12,0,10,21,11,1,1,2,10433,10467,20
Task 10434,Job 0,6,9,1,10,1,7,16,9,1,4,2,10434,10467,17
Task 10434,Job 1,11,6,4,11,0,15,22,7,4,2,1,10434,10467,8
Task 10435,Job 0,8,4,1,10,1,9,18,9,1,1,1,10435,10469,11
Task 10435,Job 1,13,4,4,7,0,17,20,3,4,2,1,10435,10469,6
Task 10436,Job 0,6,5,4,9,1,10,15,5,4,1,0,10436,10470,4
Task 10436,Job 1,11,8,1,6,0,12,17,5,1,1,2,10436,10470,4
Task 10437,Job 0,4,6,3,6,0,7,10,3,3,4,1,10437,10471,5
Task 10437,Job 1,9,5,2,9,1,11,18,7,2,1,1,10437,10471,4
Task 10438,Job 0,7,8,1,6,1,8,13,5,1,1,0,10438,10471,11
Task 10438,Job 1,12,10,4,12,0,16,24,8,4,3,2,10438,10471,10
Task 10439,Job 0,10,4,4,6,0,14,16,2,4,4,1,10439,10473,11
Task 10439,Job 1,15,10,2,9,0,17,24,7,2,4,1,10439,10473,2
Task 10440,Job 0,1,5,3,6,0,4,7,3,3,2,2,10440,10474,11
Task 10440,Job 1,6,5,1,7,0,7,13,6,1,3,0,10440,10474,11
Task 10441,Job 0,1,9,4,12,0,5,13,8,4,4,1,10441,10474,15
Task 10441,Job 1,6,9,1,10,1,7,16,9,1,4,0,10441,10474,7
Task 10442,Job 0,6,8,4,10,0,10,16,6,4,1,1,10442,10476,16
Task 10442,Job 1,11,7,4,8,0,15,19,4,4,1,2,10442,10476,11
Task 10443,Job 0,7,10,3,6,1,10,13,3,3,1,2,10443,10477,9
Task 10443,Job 1,12,7,1,8,0,13,20,7,1,3,1,10443,10477,18
Task 10444,Job 0,7,5,3,8,0,10,15,5,3,2,2,10444,10477,11
Task 10444,Job 1,12,4,1,6,1,13,18,5,1,3,2,10444,10477,12
Task 10445,Job 0,2,6,3,8,0,5,10,5,3,1,2,10445,10479,4
Task 10445,Job 1,7,4,3,12,0,10,19,9,3,2,2,10445,10479,16
Task 10446,Job 0,3,5,3,9,0,6,12,6,3,4,0,10446,10480,17
Task 10446,Job 1,8,7,1,10,0,9,18,9,1,3,1,10446,10480,8
Task 10447,Job 0,8,4,3,12,0,11,20,9,3,2,2,10447,10481,4
Task 10447,Job 1,13,6,2,6,0,15,19,4,2,3,0,10447,10481,11
Task 10448,Job 0,9,6,3,10,0,12,19,7,3,1,1,10448,10482,14
Task 10448,Job 1,14,8,3,10,1,17,24,7,3,4,0,10448,10482,7
Task 10449,Job 0,8,10,4,8,0,12,16,4,4,4,2,10449,10482,18
Task 10449,Job 1,13,4,1,7,0,14,20,6,1,1,1,10449,10482,15
Task 10450,Job 0,5,5,2,7,0,7,12,5,2,2,0,10450,10483,8
Task 10450,Job 1,10,8,4,10,0,14,20,6,4,1,2,10450,10483,7
Task 10451,Job 0,8,10,4,11,1,12,19,7,4,4,2,10451,10484,15
Task 10451,Job 1,13,6,2,10,0,15,23,8,2,1,2,10451,10484,14
Task 10452,Job 0,8,10,2,8,1,10,16,6,2,2,0,10452,10486,5
Task 10452,Job 1,13,8,3,12,0,16,25,9,3,2,2,10452,10486,15
Task 10453,Job 0,8,8,1,7,1,9,15,6,1,4,2,10453,10486,3
Task 10453,Job 1,13,9,1,12,0,14,25,11,1,4,0,10453,10486,16
Task 10454,Job 0,9,7,2,10,0,11,19,8,2,4,2,10454,10488,2
Task 10454,Job 1,14,4,2,9,0,16,23,7,2,3,2,10454,10488,17
Task 10455,Job 0,9,9,1,11,1,10,20,10,1,4,2,10455,10488,8
Task 10455,Job 1,14,8,4,6,0,18,20,2,4,3,1,10455,10488,12
Task 10456,Job 0,9,5,3,10,0,12,19,7,3,2,2,10456,10490,2
Task 10456,Job 1,14,7,4,10,0,18,24,6,4,2,2,10456,10490,9
Task 10457,Job 0,5,6,1,6,0,6,11,5,1,1,1,10457,10490,17
Task 10457,Job 1,10,5,3,12,1,13,22,9,3,1,0,10457,10490,20
Task 10458,Job 0,10,7,2,11,1,12,21,9,2,1,2,10458,10492,2
Task 10458,Job 1,15,4,4,9,1,19,24,5,4,1,2,10458,10492,13
Task 10459,Job 0,2,9,2,8,1,4,10,6,2,1,0,10459,10492,10
Task 10459,Job 1,7,10,3,9,0,10,16,6,3,1,0,10459,10492,8
Task 10460,Job 0,5,4,1,11,1,6,16,10,1,4,0,10460,10493,13
Task 10460,Job 1,10,8,2,11,0,12,21,9,2,1,1,10460,10493,19
Task 10461,Job 0,3,5,4,11,0,7,14,7,4,2,1,10461,10494,16
Task 10461,Job 1,8,9,2,9,0,10,17,7,2,3,2,10461,10494,13
Task 10462,Job 0,3,5,4,12,0,7,15,8,4,3,0,10462,10495,8
Task 10462,Job 1,8,4,4,10,0,12,18,6,4,1,2,10462,10495,16
Task 10463,Job 0,2,8,1,6,0,3,8,5,1,4,0,10463,10497,17
Task 10463,Job 1,7,8,1,12,0,8,19,11,1,1,2,10463,10497,9
Task 10464,Job 0,3,10,2,9,0,5,12,7,2,1,0,10464,10497,7
Task 10464,Job 1,8,6,2,7,0,10,15,5,2,2,0,10464,10497,6
Task 10465,Job 0,2,8,3,9,0,5,11,6,3,2,2,10465,10498,3
Task 10465,Job 1,7,9,3,7,0,10,14,4,3,1,1,10465,10498,5
Task 10466,Job 0,9,7,4,9,0,13,18,5,4,1,2,10466,10499,13
Task 10466,Job 1,14,8,3,8,0,17,22,5,3,3,1,10466,10499,10
Task 10467,Job 0,7,7,4,7,1,11,14,3,4,1,2,10467,10500,11
Task 10467,Job 1,12,7,1,6,1,13,18,5,1,1,1,10467,10500,18
Task 10468,Job 0,10,5,2,7,0,12,17,5,2,3,1,10468,10501,19
Task 10468,Job 1,15,4,4,12,0,19,27,8,4,2,2,10468,10501,10
Task 10469,Job 0,1,4,4,8,0,5,9,4,4,3,0,10469,10502,2
Task 10469,Job 1,6,9,4,7,0,10,13,3,4,4,1,10469,10502,16
Task 10470,Job 0,3,7,3,6,0,6,9,3,3,4,1,10470,10503,7
Task 10470,Job 1,8,4,3,6,1,11,14,3,3,3,2,10470,10503,13
Task 10471,Job 0,6,6,1,12,0,7,18,11,1,2,2,10471,10505,8
Task 10471,Job 1,11,5,2,10,0,13,21,8,2,2,1,10471,10505,17
Task 10472,Job 0,9,10,1,9,0,10,18,8,1,2,0,10472,10506,5
Task 10472,Job 1,14,6,3,6,0,17,20,3,3,4,1,10472,10506,17
Task 10473,Job 0,6,9,4,11,0,10,17,7,4,4,2,10473,10506,7
Task 10473,Job 1,11,5,1,11,1,12,22,10,1,2,2,10473,10506,14
Task 10474,Job 0,2,8,4,7,0,6,9,3,4,3,2,10474,10508,6
Task 10474,Job 1,7,5,1,10,0,8,17,9,1,4,0,10474,10508,14
Task 10475,Job 0,1,7,1,8,0,2,9,7,1,4,1,10475,10508,4
Task 10475,Job 1,6,9,2,7,0,8,13,5,2,4,2,10475,10508,9
Task 10476,Job 0,1,5,2,10,0,3,11,8,2,2,2,10476,10510,7
Task 10476,Job 1,6,10,3,9,1,9,15,6,3,1,1,10476,10510,9
Task 10477,Job 0,3,5,4,10,1,7,13,6,4,3,2,10477,10511,17
Task 10477,Job 1,8,4,3,8,0,11,16,5,3,3,2,10477,10511,17
Task 10478,Job 0,2,10,4,12,0,6,14,8,4,1,0,10478,10511,5
Task 10478,Job 1,7,8,1,9,0,8,16,8,1,2,2,10478,10511,8
Task 10479,Job 0,7,8,3,8,0,10,15,5,3,2,0,10479,10513,6
Task 10479,Job 1,12,5,3,7,1,15,19,4,3,3,2,10479,10513,11
Task 10480,Job 0,10,5,1,8,0,11,18,7,1,3,1,10480,10513,20
Task 10480,Job 1,15,8,2,7,0,17,22,5,2,3,1,10480,10513,6
Task 10481,Job 0,7,4,1,12,0,8,19,11,1,4,2,10481,10515,16
Task 10481,Job 1,12,7,2,12,0,14,24,10,2,2,1,10481,10515,12
Task 10482,Job 0,6,8,1,9,0,7,15,8,1,3,1,10482,10516,15
Task 10482,Job 1,11,8,1,9,0,12,20,8,1,4,2,10482,10516,2
Task 10483,Job 0,3,4,2,6,0,5,9,4,2,4,1,10483,10517,4
Task 10483,Job 1,8,8,3,10,0,11,18,7,3,2,0,10483,10517,3
Task 10484,Job 0,1,5,4,7,0,5,8,3,4,3,0,10484,10517,19
Task 10484,Job 1,6,9,3,7,1,9,13,4,3,4,1,10484,10517,14
Task 10485,Job 0,2,9,2,10,0,4,12,8,2,2,1,10485,10518,2
Task 10485,Job 1,7,8,1,7,0,8,14,6,1,2,2,10485,10518,5
Task 10486,Job 0,6,7,1,6,0,7,12,5,1,1,2,10486,10520,2
Task 10486,Job 1,11,7,1,11,1,12,22,10,1,2,0,10486,10520,18
Task 10487,Job 0,10,4,1,8,0,11,18,7,1,1,0,10487,10521,14
Task 10487,Job 1,15,7,1,8,0,16,23,7,1,2,1,10487,10521,20
Task 10488,Job 0,3,10,3,6,0,6,9,3,3,3,2,10488,10521,16
Task 10488,Job 1,8,5,4,6,0,12,14,2,4,4,1,10488,10521,6
Task 10489,Job 0,6,10,2,6,0,8,12,4,2,1,1,10489,10522,9
Task 10489,Job 1,11,6,4,11,0,15,22,7,4,3,2,10489,10522,3
Task 10490,Job 0,7,5,2,8,0,9,15,6,2,2,0,10490,10524,2
Task 10490,Job 1,12,5,2,7,1,14,19,5,2,1,2,10490,10524,11
Task 10491,Job 0,2,7,2,12,0,4,14,10,2,2,0,10491,10525,9
Task 10491,Job 1,7,7,1,9,0,8,16,8,1,1,1,10491,10525,10
Task 10492,Job 0,4,7,4,10,0,8,14,6,4,4,2,10492,10525,7
Task 10492,Job 1,9,10,2,12,1,11,21,10,2,2,1,10492,10525,9
Task 10493,Job 0,6,4,4,6,0,10,12,2,4,4,2,10493,10526,8
Task 10493,Job 1,11,8,3,7,0,14,18,4,3,3,1,10493,10526,5
Task 10494,Job 0,7,7,2,12,1,9,19,10,2,1,0,10494,10528,4
Task 10494,Job 1,12,5,2,8,0,14,20,6,2,2,2,10494,10528,19
Task 10495,Job 0,5,8,3,9,0,8,14,6,3,3,2,10495,10528,19
Task 10495,Job 1,10,5,3,12,0,13,22,9,3,3,1,10495,10528,3
Task 10496,Job 0,1,8,1,7,1,2,8,6,1,4,1,10496,10529,8
Task 10496,Job 1,6,9,3,8,0,9,14,5,3,1,2,10496,10529,4
Task 10497,Job 0,8,10,3,8,1,11,16,5,3,2,2,10497,10530,8
Task 10497,Job 1,13,6,2,6,0,15,19,4,2,4,1,10497,10530,11
Task 10498,Job 0,1,10,3,9,0,4,10,6,3,1,0,10498,10531,19
Task 10498,Job 1,6,5,2,10,0,8,16,8,2,1,1,10498,10531,20
Task 10499,Job 0,3,10,4,8,1,7,11,4,4,2,0,10499,10533,13
Task 10499,Job 1,8,10,3,6,1,11,14,3,3,2,2,10499,10533,2
Task 10500,Job 0,4,7,4,11,1,8,15,7,4,3,0,10500,10534,12
Task 10500,Job 1,9,5,4,7,0,13,16,3,4,3,0,10500,10534,13
Task 10501,Job 0,10,9,1,8,1,11,18,7,1,3,1,10501,10534,3
Task 10501,Job 1,15,9,3,11,0,18,26,8,3,4,1,10501,10534,18
Task 10502,Job 0,5,4,1,6,0,6,11,5,1,4,2,10502,10536,4
Task 10502,Job 1,10,6,2,11,1,12,21,9,2,2,1,10502,10536,5
Task 10503,Job 0,4,9,1,12,0,5,16,11,1,1,0,10503,10536,16
Task 10503,Job 1,9,7,3,8,0,12,17,5,3,1,1,10503,10536,3
Task 10504,Job 0,2,10,1,10,0,3,12,9,1,3,2,10504,10537,4
Task 10504,Job 1,7,8,4,11,1,11,18,7,4,2,2,10504,10537,4
Task 10505,Job 0,2,7,1,8,1,3,10,7,1,1,2,10505,10539,5
Task 10505,Job 1,7,9,2,12,0,9,19,10,2,2,1,10505,10539,2
Task 10506,Job 0,2,8,1,11,0,3,13,10,1,1,1,10506,10539,16
Task 10506,Job 1,7,8,3,7,1,10,14,4,3,4,1,10506,10539,20
Task 10507,Job 0,6,10,1,10,1,7,16,9,1,1,1,10507,10541,9
Task 10507,Job 1,11,5,4,6,0,15,17,2,4,4,0,10507,10541,10
Task 10508,Job 0,8,8,1,11,0,9,19,10,1,2,2,10508,10542,14
Task 10508,Job 1,13,10,3,7,1,16,20,4,3,1,0,10508,10542,2
Task 10509,Job 0,2,6,3,11,0,5,13,8,3,4,2,10509,10542,17
Task 10509,Job 1,7,6,4,10,0,11,17,6,4,4,2,10509,10542,4
Task 10510,Job 0,3,9,1,12,0,4,15,11,1,3,0,10510,10544,13
Task 10510,Job 1,8,10,4,9,0,12,17,5,4,2,1,10510,10544,18
Task 10511,Job 0,9,6,3,11,0,12,20,8,3,1,2,10511,10544,3
Task 10511,Job 1,14,9,1,9,1,15,23,8,1,2,0,10511,10544,5
Task 10512,Job 0,10,10,4,9,0,14,19,5,4,1,1,10512,10545,7
Task 10512,Job 1,15,8,2,8,0,17,23,6,2,1,0,10512,10545,8
Task 10513,Job 0,10,4,1,8,1,11,18,7,1,4,2,10513,10547,7
Task 10513,Job 1,15,6,1,10,1,16,25,9,1,3,0,10513,10547,3
Task 10514,Job 0,4,4,1,9,1,5,13,8,1,1,0,10514,10548,11
Task 10514,Job 1,9,7,4,6,0,13,15,2,4,3,0,10514,10548,15
Task 10515,Job 0,9,10,4,6,0,13,15,2,4,1,0,10515,10548,16
Task 10515,Job 1,14,4,2,9,0,16,23,7,2,1,1,10515,10548,15
Task 10516,Job 0,9,4,2,6,0,11,15,4,2,2,2,10516,10549,16
Task 10516,Job 1,14,9,3,10,1,17,24,7,3,2,2,10516,10549,7
Task 10517,Job 0,10,6,1,12,0,11,22,11,1,3,2,10517,10550,6
Task 10517,Job 1,15,7,3,10,0,18,25,7,3,3,1,10517,10550,2
Task 10518,Job 0,4,7,3,9,1,7,13,6,3,2,1,10518,10551,13
Task 10518,Job 1,9,5,4,12,0,13,21,8,4,4,0,10518,10551,12
Task 10519,Job 0,8,5,3,9,0,11,17,6,3,2,0,10519,10553,15
Task 10519,Job 1,13,6,3,9,0,16,22,6,3,2,0,10519,10553,7
Task 10520,Job 0,1,5,4,8,0,5,9,4,4,2,2,10520,10553,8
Task 10520,Job 1,6,8,4,7,1,10,13,3,4,3,2,10520,10553,6
Task 10521,Job 0,9,9,4,8,1,13,17,4,4,1,2,10521,10554,3
Task 10521,Job 1,14,9,3,8,0,17,22,5,3,1,1,10521,10554,8
Task 10522,Job 0,2,8,1,11,0,3,13,10,1,4,1,10522,10555,11
Task 10522,Job 1,7,6,4,8,1,11,15,4,4,4,0,10522,10555,11
Task 10523,Job 0,10,5,2,8,0,12,18,6,2,4,2,10523,10556,18
Task 10523,Job 1,15,10,1,10,0,16,25,9,1,1,2,10523,10556,8
Task 10524,Job 0,3,7,1,12,0,4,15,11,1,4,2,10524,10558,9
Task 10524,Job 1,8,4,2,9,0,10,17,7,2,4,1,10524,10558,15
Task 10525,Job 0,4,7,4,7,0,8,11,3,4,4,0,10525,10558,20
Task 10525,Job 1,9,5,1,8,0,10,17,7,1,1,0,10525,10558,4
Task 10526,Job 0,1,10,1,10,0,2,11,9,1,2,0,10526,10560,11
Task 10526,Job 1,6,4,4,12,1,10,18,8,4,2,1,10526,10560,17
Task 10527,Job 0,3,8,2,9,0,5,12,7,2,1,1,10527,10560,19
Task 10527,Job 1,8,5,1,6,0,9,14,5,1,3,0,10527,10560,13
Task 10528,Job 0,5,4,2,8,0,7,13,6,2,2,2,10528,10562,13
Task 10528,Job 1,10,5,3,7,0,13,17,4,3,1,0,10528,10562,8
Task 10529,Job 0,2,8,3,9,0,5,11,6,3,2,0,10529,10562,13
Task 10529,Job 1,7,8,4,11,0,11,18,7,4,3,0,10529,10562,3
Task 10530,Job 0,10,7,2,8,0,12,18,6,2,2,2,10530,10564,12
Task 10530,Job 1,15,7,1,7,0,16,22,6,1,4,1,10530,10564,3
Task 10531,Job 0,1,6,4,11,1,5,12,7,4,1,0,10531,10565,4
Task 10531,Job 1,6,4,1,9,0,7,15,8,1,3,2,10531,10565,11
Task 10532,Job 0,6,10,2,10,0,8,16,8,2,4,2,10532,10565,14
Task 10532,Job 1,11,6,1,9,1,12,20,8,1,1,2,10532,10565,12
Task 10533,Job 0,9,10,1,12,1,10,21,11,1,4,2,10533,10566,4
Task 10533,Job 1,14,9,4,11,0,18,25,7,4,1,2,10533,10566,15
Task 10534,Job 0,6,9,4,6,1,10,12,2,4,4,2,10534,10567,19
Task 10534,Job 1,11,10,1,8,1,12,19,7,1,1,2,10534,10567,2
Task 10535,Job 0,7,10,2,7,0,9,14,5,2,2,2,10535,10568,10
Task 10535,Job 1,12,9,1,12,1,13,24,11,1,2,1,10535,10568,5
Task 10536,Job 0,5,8,3,7,0,8,12,4,3,2,2,10536,10569,11
Task 10536,Job 1,10,9,2,12,1,12,22,10,2,2,2,10536,10569,8
Task 10537,Job 0,7,6,3,10,0,10,17,7,3,4,2,10537,10570,2
Task 10537,Job 1,12,9,1,12,0,13,24,11,1,2,2,10537,10570,18
Task 10538,Job 0,9,9,1,7,1,10,16,6,1,3,0,10538,10572,14
Task 10538,Job 1,14,6,3,11,1,17,25,8,3,1,2,10538,10572,16
Task 10539,Job 0,4,10,4,7,0,8,11,3,4,2,0,10539,10573,18
Task 10539,Job 1,9,7,3,10,0,12,19,7,3,1,2,10539,10573,19
Task 10540,Job 0,4,4,2,10,0,6,14,8,2,2,2,10540,10573,17
Task 10540,Job 1,9,5,4,6,0,13,15,2,4,3,1,10540,10573,12
Task 10541,Job 0,1,7,2,8,0,3,9,6,2,1,0,10541,10574,20
Task 10541,Job 1,6,9,3,10,1,9,16,7,3,2,0,10541,10574,12
Task 10542,Job 0,4,4,4,7,0,8,11,3,4,4,2,10542,10576,13
Task 10542,Job 1,9,5,4,10,0,13,19,6,4,1,0,10542,10576,5
Task 10543,Job 0,5,9,1,10,0,6,15,9,1,4,0,10543,10576,3
Task 10543,Job 1,10,5,3,12,0,13,22,9,3,1,2,10543,10576,14
Task 10544,Job 0,7,5,2,11,0,9,18,9,2,2,1,10544,10578,4
Task 10544,Job 1,12,6,3,6,1,15,18,3,3,4,2,10544,10578,9
Task 10545,Job 0,1,7,4,10,0,5,11,6,4,1,1,10545,10578,2
Task 10545,Job 1,6,9,3,9,1,9,15,6,3,2,2,10545,10578,11
Task 10546,Job 0,8,5,3,12,0,11,20,9,3,1,1,10546,10580,16
Task 10546,Job 1,13,10,2,12,0,15,25,10,2,3,0,10546,10580,2
Task 10547,Job 0,3,10,2,6,0,5,9,4,2,1,1,10547,10580,6
Task 10547,Job 1,8,4,2,6,0,10,14,4,2,1,1,10547,10580,7
Task 10548,Job 0,9,10,2,6,0,11,15,4,2,3,0,10548,10582,4
Task 10548,Job 1,14,8,2,11,0,16,25,9,2,2,1,10548,10582,3
Task 10549,Job 0,5,5,1,7,0,6,12,6,1,4,0,10549,10583,5
Task 10549,Job 1,10,9,1,10,0,11,20,9,1,3,1,10549,10583,8
Task 10550,Job 0,7,7,2,8,0,9,15,6,2,2,0,10550,10584,14
Task 10550,Job 1,12,4,3,6,0,15,18,3,3,3,1,10550,10584,19
Task 10551,Job 0,10,6,4,8,1,14,18,4,4,1,2,10551,10584,9
Task 10551,Job 1,15,7,3,9,0,18,24,6,3,2,0,10551,10584,5
Task 10552,Job 0,1,8,2,10,0,3,11,8,2,3,2,10552,10585,17
Task 10552,Job 1,6,7,3,11,0,9,17,8,3,1,2,10552,10585,17
Task 10553,Job 0,3,7,3,6,1,6,9,3,3,3,0,10553,10587,18
Task 10553,Job 1,8,4,3,7,0,11,15,4,3,4,1,10553,10587,19
Task 10554,Job 0,3,5,4,8,0,7,11,4,4,3,0,10554,10588,11
Task 10554,Job 1,8,8,2,10,0,10,18,8,2,2,2,10554,10588,19
Task 10555,Job 0,8,7,2,6,0,10,14,4,2,1,0,10555,10588,9
Task 10555,Job 1,13,7,3,10,0,16,23,7,3,2,0,10555,10588,4
Task 10556,Job 0,8,7,4,10,0,12,18,6,4,3,2,10556,10590,19
Task 10556,Job 1,13,10,3,7,1,16,20,4,3,4,2,10556,10590,17
Task 10557,Job 0,4,6,4,10,0,8,14,6,4,1,1,10557,10590,17
Task 10557,Job 1,9,10,4,9,0,13,18,5,4,4,1,10557,10590,9
Task 10558,Job 0,5,8,4,12,0,9,17,8,4,3,1,10558,10591,9
Task 10558,Job 1,10,8,4,8,1,14,18,4,4,2,0,10558,10591,4
Task 10559,Job 0,8,6,4,12,0,12,20,8,4,2,1,10559,10592,10
Task 10559,Job 1,13,9,1,12,0,14,25,11,1,1,2,10559,10592,7
Task 10560,Job 0,3,9,1,10,1,4,13,9,1,2,2,10560,10593,20
Task 10560,Job 1,8,5,3,7,0,11,15,4,3,2,2,10560,10593,17
Task 10561,Job 0,5,10,3,9,0,8,14,6,3,2,0,10561,10595,17
Task 10561,Job 1,10,9,4,8,0,14,18,4,4,3,2,10561,10595,18
Task 10562,Job 0,10,5,1,6,1,11,16,5,1,2,1,10562,10595,20
Task 10562,Job 1,15,6,2,11,0,17,26,9,2,4,2,10562,10595,2
Task 10563,Job 0,2,7,4,9,0,6,11,5,4,4,1,10563,10596,14
Task 10563,Job 1,7,7,4,6,0,11,13,2,4,1,2,10563,10596,16
Task 10564,Job 0,1,6,3,11,0,4,12,8,3,3,2,10564,10597,7
Task 10564,Job 1,6,4,2,12,0,8,18,10,2,3,0,10564,10597,13
Task 10565,Job 0,5,10,4,9,0,9,14,5,4,4,2,10565,10599,11
Task 10565,Job 1,10,10,4,7,0,14,17,3,4,1,2,10565,10599,12
Task 10566,Job 0,8,7,1,6,0,9,14,5,1,4,0,10566,10600,5
Task 10566,Job 1,13,5,2,10,0,15,23,8,2,1,2,10566,10600,11
Task 10567,Job 0,4,8,1,8,0,5,12,7,1,4,2,10567,10601,17
Task 10567,Job 1,9,5,3,10,0,12,19,7,3,2,2,10567,10601,13
Task 10568,Job 0,7,8,1,11,0,8,18,10,1,3,2,10568,10601,14
Task 10568,Job 1,12,9,3,6,1,15,18,3,3,4,0,10568,10601,4
Task 10569,Job 0,3,5,4,6,0,7,9,2,4,2,1,10569,10603,16
Task 10569,Job 1,8,7,1,9,0,9,17,8,1,1,1,10569,10603,16
Task 10570,Job 0,7,9,4,6,0,11,13,2,4,4,0,10570,10603,3
Task 10570,Job 1,12,5,2,6,0,14,18,4,2,1,2,10570,10603,13
Task 10571,Job 0,10,7,2,12,0,12,22,10,2,1,0,10571,10604,13
Task 10571,Job 1,15,9,4,11,0,19,26,7,4,4,0,10571,10604,13
Task 10572,Job 0,8,10,2,7,0,10,15,5,2,3,2,10572,10606,2
Task 10572,Job 1,13,6,3,10,0,16,23,7,3,4,0,10572,10606,13
Task 10573,Job 0,3,9,4,11,0,7,14,7,4,3,2,10573,10607,11
Task 10573,Job 1,8,8,2,12,0,10,20,10,2,3,1,10573,10607,4
Task 10574,Job 0,7,6,1,11,0,8,18,10,1,4,1,10574,10608,17
Task 10574,Job 1,12,8,1,6,1,13,18,5,1,2,2,10574,10608,16
Task 10575,Job 0,9,10,2,10,0,11,19,8,2,4,1,10575,10609,3
Task 10575,Job 1,14,9,2,8,0,16,22,6,2,2,2,10575,10609,17
Task 10576,Job 0,5,9,1,6,0,6,11,5,1,4,0,10576,10610,15
Task 10576,Job 1,10,10,1,10,0,11,20,9,1,4,2,10576,10610,3
Task 10577,Job 0,7,8,3,12,0,10,19,9,3,4,1,10577,10610,4
Task 10577,Job 1,12,8,1,8,0,13,20,7,1,3,2,10577,10610,7
Task 10578,Job 0,8,4,3,11,0,11,19,8,3,4,2,10578,10612,3
Task 10578,Job 1,13,7,4,8,0,17,21,4,4,3,1,10578,10612,16
Task 10579,Job 0,8,4,4,6,0,12,14,2,4,4,1,10579,10612,10
Task 10579,Job 1,13,8,1,7,1,14,20,6,1,4,2,10579,10612,8
Task 10580,Job 0,7,4,1,7,0,8,14,6,1,2,1,10580,10613,19
Task 10580,Job 1,12,8,3,7,0,15,19,4,3,4,1,10580,10613,13
Task 10581,Job 0,4,10,1,8,1,5,12,7,1,4,2,10581,10615,8
Task 10581,Job 1,9,7,3,10,0,12,19,7,3,4,0,10581,10615,17
Task 10582,Job 0,1,7,1,6,0,2,7,5,1,3,0,10582,10616,14
Task 10582,Job 1,6,8,3,12,0,9,18,9,3,2,2,10582,10616,2
Task 10583,Job 0,5,10,3,7,0,8,12,4,3,1,2,10583,10617,10
Task 10583,Job 1,10,4,1,11,0,11,21,10,1,1,0,10583,10617,19
Task 10584,Job 0,4,6,3,7,0,7,11,4,3,4,2,10584,10618,3
Task 10584,Job 1,9,8,3,10,0,12,19,7,3,3,0,10584,10618,7
Task 10585,Job 0,9,9,1,6,0,10,15,5,1,2,0,10585,10619,17
Task 10585,Job 1,14,6,3,8,0,17,22,5,3,1,2,10585,10619,18
Task 10586,Job 0,6,10,2,11,1,8,17,9,2,4,1,10586,10620,6
Task 10586,Job 1,11,5,4,9,0,15,20,5,4,1,0,10586,10620,2
Task 10587,Job 0,7,8,4,9,0,11,16,5,4,1,0,10587,10621,20
Task 10587,Job 1,12,5,4,12,1,16,24,8,4,4,2,10587,10621,3
Task 10588,Job 0,5,5,4,9,0,9,14,5,4,1,2,10588,10621,6
Task 10588,Job 1,10,7,3,7,0,13,17,4,3,1,1,10588,10621,9
Task 10589,Job 0,6,5,1,12,0,7,18,11,1,2,0,10589,10622,13
Task 10589,Job 1,11,5,2,10,0,13,21,8,2,2,1,10589,10622,11
Task 10590,Job 0,10,5,2,11,0,12,21,9,2,3,2,10590,10624,8
Task 10590,Job 1,15,4,3,6,1,18,21,3,3,2,2,10590,10624,6
Task 10591,Job 0,2,8,1,7,0,3,9,6,1,4,2,10591,10624,10
Task 10591,Job 1,7,8,1,7,0,8,14,6,1,3,1,10591,10624,14
Task 10592,Job 0,10,10,3,6,1,13,16,3,3,2,0,10592,10625,8
Task 10592,Job 1,15,10,1,8,0,16,23,7,1,2,2,10592,10625,3
Task 10593,Job 0,5,9,3,8,0,8,13,5,3,3,2,10593,10627,13
Task 10593,Job 1,10,9,3,6,1,13,16,3,3,3,0,10593,10627,17
Task 10594,Job 0,3,9,3,12,0,6,15,9,3,2,0,10594,10627,12
Task 10594,Job 1,8,8,1,11,0,9,19,10,1,2,1,10594,10627,9
Task 10595,Job 0,8,10,1,12,1,9,20,11,1,3,2,10595,10628,6
Task 10595,Job 1,13,10,1,8,0,14,21,7,1,3,2,10595,10628,9
Task 10596,Job 0,5,5,2,9,1,7,14,7,2,2,0,10596,10629,18
Task 10596,Job 1,10,4,1,7,0,11,17,6,1,3,1,10596,10629,20
Task 10597,Job 0,2,10,1,7,0,3,9,6,1,1,1,10597,10631,18
Task 10597,Job 1,7,10,1,6,0,8,13,5,1,2,1,10597,10631,4
Task 10598,Job 0,3,10,3,9,1,6,12,6,3,4,0,10598,10631,10
Task 10598,Job 1,8,7,2,11,1,10,19,9,2,1,2,10598,10631,19
Task 10599,Job 0,3,4,1,8,0,4,11,7,1,4,1,10599,10632,16
Task 10599,Job 1,8,5,2,6,0,10,14,4,2,2,2,10599,10632,12
Task 10600,Job 0,8,6,2,7,1,10,15,5,2,4,2,10600,10633,20
Task 10600,Job 1,13,8,1,11,0,14,24,10,1,1,1,10600,10633,6
Task 10601,Job 0,4,10,1,6,0,5,10,5,1,3,0,10601,10634,15
Task 10601,Job 1,9,9,4,9,0,13,18,5,4,3,1,10601,10634,17
Task 10602,Job 0,10,7,2,10,0,12,20,8,2,3,2,10602,10636,11
Task 10602,Job 1,15,6,3,9,1,18,24,6,3,2,2,10602,10636,10
Task 10603,Job 0,3,4,3,10,1,6,13,7,3,2,1,10603,10636,15
Task 10603,Job 1,8,8,4,11,0,12,19,7,4,1,2,10603,10636,9
Task 10604,Job 0,7,9,1,8,0,8,15,7,1,2,0,10604,10638,18
Task 10604,Job 1,12,9,1,8,0,13,20,7,1,3,2,10604,10638,5
Task 10605,Job 0,7,6,3,11,0,10,18,8,3,4,2,10605,10639,4
Task 10605,Job 1,12,8,2,12,1,14,24,10,2,3,2,10605,10639,15
Task 10606,Job 0,8,10,1,7,0,9,15,6,1,4,2,10606,10639,14
Task 10606,Job 1,13,10,3,12,1,16,25,9,3,1,1,10606,10639,8
Task 10607,Job 0,7,6,4,8,0,11,15,4,4,2,2,10607,10640,20
Task 10607,Job 1,12,8,2,9,0,14,21,7,2,1,2,10607,10640,3
Task 10608,Job 0,9,8,4,6,0,13,15,2,4,3,1,10608,10641,3
Task 10608,Job 1,14,5,4,10,1,18,24,6,4,4,0,10608,10641,9
Task 10609,Job 0,2,9,1,7,0,3,9,6,1,1,1,10609,10643,9
Task 10609,Job 1,7,10,4,10,1,11,17,6,4,2,1,10609,10643,20
Task 10610,Job 0,2,7,2,6,0,4,8,4,2,2,0,10610,10644,3
Task 10610,Job 1,7,7,2,8,0,9,15,6,2,3,0,10610,10644,14
Task 10611,Job 0,8,8,2,8,0,10,16,6,2,3,0,10611,10645,5
Task 10611,Job 1,13,7,4,10,0,17,23,6,4,1,0,10611,10645,2
Task 10612,Job 0,10,10,3,9,0,13,19,6,3,4,1,10612,10645,17
Task 10612,Job 1,15,7,3,9,0,18,24,6,3,2,2,10612,10645,10
Task 10613,Job 0,10,6,1,12,1,11,22,11,1,2,0,10613,10647,7
Task 10613,Job 1,15,6,1,11,0,16,26,10,1,3,2,10613,10647,5
Task 10614,Job 0,10,4,1,8,1,11,18,7,1,1,0,10614,10648,19
Task 10614,Job 1,15,5,1,8,0,16,23,7,1,1,1,10614,10648,17
Task 10615,Job 0,4,6,4,10,1,8,14,6,4,1,0,10615,10649,8
Task 10615,Job 1,9,10,2,11,0,11,20,9,2,4,1,10615,10649,2
Task 10616,Job 0,6,4,1,7,0,7,13,6,1,2,0,10616,10650,5
Task 10616,Job 1,11,8,2,11,0,13,22,9,2,1,1,10616,10650,4
Task 10617,Job 0,7,6,1,10,0,8,17,9,1,2,0,10617,10650,20
Task 10617,Job 1,12,9,3,6,1,15,18,3,3,4,1,10617,10650,9
Task 10618,Job 0,3,7,1,9,1,4,12,8,1,2,1,10618,10652,20
Task 10618,Job 1,8,5,2,7,0,10,15,5,2,2,0,10618,10652,20
Task 10619,Job 0,4,6,3,10,0,7,14,7,3,4,1,10619,10652,13
Task 10619,Job 1,9,6,4,12,1,13,21,8,4,3,1,10619,10652,7
Task 10620,Job 0,4,7,2,8,1,6,12,6,2,3,0,10620,10653,2
Task 10620,Job 1,9,10,1,6,0,10,15,5,1,2,1,10620,10653,16
Task 10621,Job 0,6,7,1,9,0,7,15,8,1,1,2,10621,10654,17
Task 10621,Job 1,11,9,2,11,1,13,22,9,2,2,0,10621,10654,20
Task 10622,Job 0,10,6,3,6,0,13,16,3,3,3,2,10622,10655,17
Task 10622,Job 1,15,5,4,8,0,19,23,4,4,4,2,10622,10655,6
Task 10623,Job 0,9,10,2,8,0,11,17,6,2,1,2,10623,10657,19
Task 10623,Job 1,14,6,1,11,0,15,25,10,1,4,1,10623,10657,16
Task 10624,Job 0,1,9,3,7,0,4,8,4,3,4,0,10624,10657,8
Task 10624,Job 1,6,8,1,6,0,7,12,5,1,2,1,10624,10657,5
Task 10625,Job 0,2,10,3,8,0,5,10,5,3,1,0,10625,10658,16
Task 10625,Job 1,7,9,3,12,1,10,19,9,3,2,2,10625,10658,3
Task 10626,Job 0,7,4,3,6,1,10,13,3,3,1,0,10626,10659,2
Task 10626,Job 1,12,7,2,10,0,14,22,8,2,3,1,10626,10659,15
Task 10627,Job 0,8,7,4,11,0,12,19,7,4,1,1,10627,10660,15
Task 10627,Job 1,13,9,2,7,0,15,20,5,2,1,0,10627,10660,8
Task 10628,Job 0,2,10,3,11,0,5,13,8,3,4,1,10628,10661,19
Task 10628,Job 1,7,7,3,8,0,10,15,5,3,2,1,10628,10661,19
Task 10629,Job 0,10,4,3,9,1,13,19,6,3,2,0,10629,10662,10
Task 10629,Job 1,15,4,3,9,0,18,24,6,3,1,2,10629,10662,11
Task 10630,Job 0,8,8,2,12,0,10,20,10,2,3,1,10630,10664,18
Task 10630,Job 1,13,6,4,7,0,17,20,3,4,4,0,10630,10664,20
Task 10631,Job 0,10,6,2,6,1,12,16,4,2,3,1,10631,10665,3
Task 10631,Job 1,15,9,1,10,0,16,25,9,1,3,2,10631,10665,4
Task 10632,Job 0,2,5,2,7,1,4,9,5,2,2,1,10632,10666,19
Task 10632,Job 1,7,7,3,6,0,10,13,3,3,2,0,10632,10666,20
Task 10633,Job 0,6,5,4,8,0,10,14,4,4,3,1,10633,10666,10
Task 10633,Job 1,11,8,3,10,0,14,21,7,3,1,1,10633,10666,19
Task 10634,Job 0,10,6,3,12,0,13,22,9,3,2,0,10634,10668,15
Task 10634,Job 1,15,10,1,11,0,16,26,10,1,2,1,10634,10668,17
Task 10635,Job 0,9,10,2,6,0,11,15,4,2,2,0,10635,10669,15
Task 10635,Job 1,14,4,4,12,0,18,26,8,4,1,1,10635,10669,5
Task 10636,Job 0,3,5,2,9,1,5,12,7,2,3,0,10636,10669,20
Task 10636,Job 1,8,7,4,8,0,12,16,4,4,4,0,10636,10669,19
Task 10637,Job 0,7,7,2,10,0,9,17,8,2,3,0,10637,10671,5
Task 10637,Job 1,12,4,1,12,0,13,24,11,1,4,1,10637,10671,11
Task 10638,Job 0,9,5,2,12,0,11,21,10,2,1,1,10638,10671,2
Task 10638,Job 1,14,6,1,9,0,15,23,8,1,1,0,10638,10671,20
Task 10639,Job 0,5,5,1,9,0,6,14,8,1,3,0,10639,10673,17
Task 10639,Job 1,10,7,2,12,0,12,22,10,2,1,0,10639,10673,4
Task 10640,Job 0,6,5,2,8,0,8,14,6,2,4,1,10640,10674,4
Task 10640,Job 1,11,9,1,12,0,12,23,11,1,2,2,10640,10674,15
Task 10641,Job 0,4,6,4,12,0,8,16,8,4,3,2,10641,10675,16
Task 10641,Job 1,9,9,3,7,1,12,16,4,3,1,0,10641,10675,4
Task 10642,Job 0,1,9,2,9,0,3,10,7,2,1,0,10642,10676,16
Task 10642,Job 1,6,8,4,10,1,10,16,6,4,2,1,10642,10676,13
Task 10643,Job 0,1,6,4,9,0,5,10,5,4,3,0,10643,10677,10
Task 10643,Job 1,6,9,1,7,1,7,13,6,1,4,0,10643,10677,4
Task 10644,Job 0,2,8,2,7,1,4,9,5,2,2,0,10644,10677,12
Task 10644,Job 1,7,9,1,10,0,8,17,9,1,1,2,10644,10677,7
Task 10645,Job 0,8,7,4,7,1,12,15,3,4,3,2,10645,10679,4
Task 10645,Job 1,13,5,1,10,0,14,23,9,1,4,0,10645,10679,7
Task 10646,Job 0,6,4,2,12,1,8,18,10,2,1,2,10646,10679,2
Task 10646,Job 1,11,7,1,12,0,12,23,11,1,1,1,10646,10679,3
Task 10647,Job 0,9,5,4,11,0,13,20,7,4,4,0,10647,10680,16
Task 10647,Job 1,14,6,2,10,1,16,24,8,2,4,1,10647,10680,8
Task 10648,Job 0,8,7,3,6,1,11,14,3,3,1,0,10648,10682,4
Task 10648,Job 1,13,7,2,6,0,15,19,4,2,1,0,10648,10682,8
Task 10649,Job 0,9,4,4,9,0,13,18,5,4,3,2,10649,10683,15
Task 10649,Job 1,14,9,3,9,0,17,23,6,3,4,1,10649,10683,17
Task 10650,Job 0,10,4,3,8,0,13,18,5,3,3,1,10650,10684,19
Task 10650,Job 1,15,8,1,9,0,16,24,8,1,1,1,10650,10684,17
Task 10651,Job 0,1,8,2,7,0,3,8,5,2,4,2,10651,10684,9
Task 10651,Job 1,6,4,3,8,0,9,14,5,3,3,2,10651,10684,12
Task 10652,Job 0,3,6,1,6,0,4,9,5,1,3,1,10652,10686,19
Task 10652,Job 1,8,6,2,6,0,10,14,4,2,4,1,10652,10686,6
Task 10653,Job 0,10,7,3,6,0,13,16,3,3,2,0,10653,10687,19
Task 10653,Job 1,15,8,2,11,0,17,26,9,2,3,0,10653,10687,11
Task 10654,Job 0,8,9,3,12,1,11,20,9,3,2,1,10654,10687,15
Task 10654,Job 1,13,7,2,6,0,15,19,4,2,1,0,10654,10687,15
Task 10655,Job 0,4,7,3,10,0,7,14,7,3,3,1,10655,10688,9
Task 10655,Job 1,9,8,4,8,0,13,17,4,4,3,2,10655,10688,11
Task 10656,Job 0,5,8,2,12,0,7,17,10,2,1,1,10656,10689,16
Task 10656,Job 1,10,6,2,12,0,12,22,10,2,2,2,10656,10689,14
Task 10657,Job 0,7,7,4,12,1,11,19,8,4,4,2,10657,10690,20
Task 10657,Job 1,12,5,3,9,1,15,21,6,3,3,2,10657,10690,12
Task 10658,Job 0,3,9,3,10,0,6,13,7,3,4,0,10658,10692,13
Task 10658,Job 1,8,5,1,11,0,9,19,10,1,2,0,10658,10692,5
Task 10659,Job 0,1,6,2,9,0,3,10,7,2,4,0,10659,10692,16
Task 10659,Job 1,6,6,2,11,0,8,17,9,2,4,2,10659,10692,2
Task 10660,Job 0,3,8,1,12,0,4,15,11,1,2,1,10660,10694,15
Task 10660,Job 1,8,9,3,12,0,11,20,9,3,3,2,10660,10694,15
Task 10661,Job 0,2,6,1,9,0,3,11,8,1,4,1,10661,10694,2
Task 10661,Job 1,7,6,1,10,0,8,17,9,1,3,1,10661,10694,11
Task 10662,Job 0,7,5,2,12,0,9,19,10,2,2,2,10662,10695,12
Task 10662,Job 1,12,7,4,10,0,16,22,6,4,2,2,10662,10695,11
Task 10663,Job 0,3,8,1,11,0,4,14,10,1,3,2,10663,10697,11
Task 10663,Job 1,8,7,4,6,0,12,14,2,4,3,1,10663,10697,9
Task 10664,Job 0,9,7,2,11,0,11,20,9,2,3,2,10664,10697,18
Task 10664,Job 1,14,7,4,7,0,18,21,3,4,1,0,10664,10697,17
Task 10665,Job 0,6,9,3,9,1,9,15,6,3,3,1,10665,10698,19
Task 10665,Job 1,11,4,2,8,0,13,19,6,2,3,1,10665,10698,20
Task 10666,Job 0,9,7,4,6,1,13,15,2,4,4,2,10666,10700,12
Task 10666,Job 1,14,4,1,8,0,15,22,7,1,3,2,10666,10700,13
Task 10667,Job 0,5,7,4,10,0,9,15,6,4,1,1,10667,10700,9
Task 10667,Job 1,10,6,3,9,0,13,19,6,3,1,0,10667,10700,20
Task 10668,Job 0,2,7,4,12,1,6,14,8,4,1,2,10668,10701,5
Task 10668,Job 1,7,7,1,8,0,8,15,7,1,3,1,10668,10701,6
Task 10669,Job 0,6,5,2,8,0,8,14,6,2,4,0,10669,10703,12
Task 10669,Job 1,11,4,3,10,1,14,21,7,3,1,2,10669,10703,9
Task 10670,Job 0,10,6,4,11,0,14,21,7,4,3,1,10670,10704,8
Task 10670,Job 1,15,8,3,12,1,18,27,9,3,2,1,10670,10704,18
Task 10671,Job 0,9,8,2,12,0,11,21,10,2,4,1,10671,10704,6
Task 10671,Job 1,14,7,3,7,0,17,21,4,3,3,1,10671,10704,19
Task 10672,Job 0,4,8,2,8,0,6,12,6,2,3,0,10672,10706,14
Task 10672,Job 1,9,5,2,6,0,11,15,4,2,2,0,10672,10706,15
Task 10673,Job 0,4,8,4,7,0,8,11,3,4,2,0,10673,10707,6
Task 10673,Job 1,9,7,3,10,1,12,19,7,3,4,1,10673,10707,13
Task 10674,Job 0,5,8,1,9,1,6,14,8,1,1,0,10674,10708,18
Task 10674,Job 1,10,4,4,6,0,14,16,2,4,1,0,10674,10708,5
Task 10675,Job 0,6,9,1,9,1,7,15,8,1,4,1,10675,10709,9
Task 10675,Job 1,11,7,3,11,0,14,22,8,3,1,2,10675,10709,15
Task 10676,Job 0,9,4,2,12,1,11,21,10,2,1,0,10676,10710,6
Task 10676,Job 1,14,5,4,9,0,18,23,5,4,2,2,10676,10710,4
Task 10677,Job 0,1,10,4,12,0,5,13,8,4,4,1,10677,10710,13
Task 10677,Job 1,6,5,3,11,0,9,17,8,3,3,0,10677,10710,10
Task 10678,Job 0,3,6,3,9,1,6,12,6,3,3,0,10678,10712,16
Task 10678,Job 1,8,7,2,12,1,10,20,10,2,4,1,10678,10712,15
Task 10679,Job 0,6,7,4,7,0,10,13,3,4,1,0,10679,10713,2
Task 10679,Job 1,11,7,2,11,1,13,22,9,2,1,0,10679,10713,16
Task 10680,Job 0,9,10,1,8,0,10,17,7,1,3,2,10680,10714,10
Task 10680,Job 1,14,9,3,12,0,17,26,9,3,2,0,10680,10714,6
Task 10681,Job 0,7,5,2,11,0,9,18,9,2,3,0,10681,10714,20
Task 10681,Job 1,12,10,1,8,0,13,20,7,1,3,2,10681,10714,7
Task 10682,Job 0,7,4,4,8,0,11,15,4,4,2,1,10682,10715,16
Task 10682,Job 1,12,9,3,9,0,15,21,6,3,3,1,10682,10715,7
Task 10683,Job 0,10,8,2,11,0,12,21,9,2,1,2,10683,10717,12
Task 10683,Job 1,15,7,3,6,0,18,21,3,3,2,1,10683,10717,19
Task 10684,Job 0,3,7,4,8,0,7,11,4,4,2,2,10684,10718,15
Task 10684,Job 1,8,5,4,11,0,12,19,7,4,1,1,10684,10718,9
Task 10685,Job 0,8,10,1,6,0,9,14,5,1,3,2,10685,10719,12
Task 10685,Job 1,13,10,2,12,1,15,25,10,2,2,0,10685,10719,11
Task 10686,Job 0,1,8,1,9,0,2,10,8,1,4,1,10686,10719,18
Task 10686,Job 1,6,8,3,8,0,9,14,5,3,3,1,10686,10719,10
Task 10687,Job 0,2,9,1,8,0,3,10,7,1,1,0,10687,10721,18
Task 10687,Job 1,7,6,2,9,1,9,16,7,2,2,1,10687,10721,8
Task 10688,Job 0,7,7,2,6,0,9,13,4,2,4,1,10688,10722,9
Task 10688,Job 1,12,10,2,7,0,14,19,5,2,2,0,10688,10722,17
Task 10689,Job 0,8,6,3,11,0,11,19,8,3,2,1,10689,10723,6
Task 10689,Job 1,13,4,2,12,0,15,25,10,2,4,0,10689,10723,17
Task 10690,Job 0,4,4,2,10,0,6,14,8,2,1,2,10690,10724,9
Task 10690,Job 1,9,5,1,7,0,10,16,6,1,4,2,10690,10724,18
Task 10691,Job 0,7,8,2,10,0,9,17,8,2,2,0,10691,10725,3
Task 10691,Job 1,12,10,3,6,1,15,18,3,3,3,2,10691,10725,10
Task 10692,Job 0,3,4,2,7,0,5,10,5,2,4,0,10692,10725,4
Task 10692,Job 1,8,5,2,8,0,10,16,6,2,1,1,10692,10725,10
Task 10693,Job 0,2,5,3,7,1,5,9,4,3,1,1,10693,10726,3
Task 10693,Job 1,7,5,2,6,0,9,13,4,2,4,0,10693,10726,7
Task 10694,Job 0,1,5,2,11,0,3,12,9,2,2,0,10694,10727,15
Task 10694,Job 1,6,9,1,10,1,7,16,9,1,3,2,10694,10727,18
Task 10695,Job 0,2,5,4,7,0,6,9,3,4,2,1,10695,10729,13
Task 10695,Job 1,7,5,3,7,0,10,14,4,3,1,0,10695,10729,19
Task 10696,Job 0,4,10,4,9,0,8,13,5,4,1,0,10696,10729,3
Task 10696,Job 1,9,7,3,7,0,12,16,4,3,1,1,10696,10729,15
Task 10697,Job 0,2,10,1,6,0,3,8,5,1,4,1,10697,10730,6
Task 10697,Job 1,7,4,4,10,0,11,17,6,4,3,0,10697,10730,4
Task 10698,Job 0,1,5,2,10,0,3,11,8,2,4,0,10698,10731,13
Task 10698,Job 1,6,9,4,10,0,10,16,6,4,2,0,10698,10731,8
Task 10699,Job 0,2,7,1,12,1,3,14,11,1,3,2,10699,10732,13
Task 10699,Job 1,7,4,1,6,0,8,13,5,1,3,0,10699,10732,6
Task 10700,Job 0,4,9,4,11,1,8,15,7,4,1,2,10700,10734,16
Task 10700,Job 1,9,4,1,11,0,10,20,10,1,1,2,10700,10734,19
Task 10701,Job 0,6,10,4,9,1,10,15,5,4,4,2,10701,10735,6
Task 10701,Job 1,11,6,3,6,0,14,17,3,3,2,0,10701,10735,7
Task 10702,Job 0,8,10,1,9,1,9,17,8,1,1,2,10702,10735,2
Task 10702,Job 1,13,8,2,12,0,15,25,10,2,3,0,10702,10735,14
Task 10703,Job 0,5,8,2,8,0,7,13,6,2,4,0,10703,10737,19
Task 10703,Job 1,10,10,2,8,1,12,18,6,2,2,0,10703,10737,10
Task 10704,Job 0,4,4,4,7,0,8,11,3,4,2,0,10704,10737,3
Task 10704,Job 1,9,10,4,8,1,13,17,4,4,4,0,10704,10737,8
Task 10705,Job 0,5,4,4,12,0,9,17,8,4,2,0,10705,10738,3
Task 10705,Job 1,10,7,2,11,0,12,21,9,2,1,1,10705,10738,20
Task 10706,Job 0,4,4,2,7,0,6,11,5,2,4,2,10706,10739,4
Task 10706,Job 1,9,8,1,12,0,10,21,11,1,2,0,10706,10739,5
Task 10707,Job 0,4,5,3,6,0,7,10,3,3,4,0,10707,10740,10
Task 10707,Job 1,9,6,3,8,0,12,17,5,3,4,2,10707,10740,2
Task 10708,Job 0,4,8,4,6,0,8,10,2,4,4,2,10708,10741,7
Task 10708,Job 1,9,10,1,11,0,10,20,10,1,3,2,10708,10741,2
Task 10709,Job 0,2,4,1,7,1,3,9,6,1,3,2,10709,10742,3
Task 10709,Job 1,7,5,1,6,0,8,13,5,1,4,2,10709,10742,11
Task 10710,Job 0,3,8,1,10,0,4,13,9,1,4,0,10710,10744,7
Task 10710,Job 1,8,10,4,8,0,12,16,4,4,1,2,10710,10744,8
Task 10711,Job 0,9,9,4,12,1,13,21,8,4,2,2,10711,10745,8
Task 10711,Job 1,14,5,4,9,1,18,23,5,4,4,1,10711,10745,15
Task 10712,Job 0,2,5,4,9,0,6,11,5,4,2,2,10712,10746,7
Task 10712,Job 1,7,5,2,11,0,9,18,9,2,4,1,10712,10746,11
Task 10713,Job 0,8,10,2,12,0,10,20,10,2,2,1,10713,10746,9
Task 10713,Job 1,13,7,3,12,0,16,25,9,3,2,1,10713,10746,2
Task 10714,Job 0,8,8,1,8,0,9,16,7,1,1,2,10714,10747,5
Task 10714,Job 1,13,5,3,6,0,16,19,3,3,3,1,10714,10747,5
Task 10715,Job 0,5,10,2,11,0,7,16,9,2,2,1,10715,10748,10
Task 10715,Job 1,10,10,3,10,0,13,20,7,3,2,0,10715,10748,18
Task 10716,Job 0,8,6,3,11,1,11,19,8,3,1,2,10716,10750,20
Task 10716,Job 1,13,8,3,8,0,16,21,5,3,2,0,10716,10750,12
Task 10717,Job 0,8,4,1,6,0,9,14,5,1,4,0,10717,10750,8
Task 10717,Job 1,13,4,4,8,0,17,21,4,4,1,2,10717,10750,18
Task 10718,Job 0,6,7,4,12,0,10,18,8,4,3,2,10718,10751,16
Task 10718,Job 1,11,8,2,8,0,13,19,6,2,1,0,10718,10751,6
Task 10719,Job 0,5,8,3,7,0,8,12,4,3,1,2,10719,10752,17
Task 10719,Job 1,10,10,2,12,0,12,22,10,2,3,0,10719,10752,16
Task 10720,Job 0,4,9,1,12,1,5,16,11,1,1,1,10720,10754,13
Task 10720,Job 1,9,10,1,10,1,10,19,9,1,3,1,10720,10754,10
Task 10721,Job 0,8,6,1,7,0,9,15,6,1,2,2,10721,10755,16
Task 10721,Job 1,13,8,3,8,0,16,21,5,3,3,2,10721,10755,9
Task 10722,Job 0,6,7,2,7,0,8,13,5,2,2,0,10722,10755,3
Task 10722,Job 1,11,4,2,7,0,13,18,5,2,1,1,10722,10755,17
Task 10723,Job 0,2,5,2,12,0,4,14,10,2,4,1,10723,10756,11
Task 10723,Job 1,7,10,1,11,0,8,18,10,1,3,1,10723,10756,5
Task 10724,Job 0,1,10,4,8,0,5,9,4,4,2,0,10724,10757,11
Task 10724,Job 1,6,6,1,7,1,7,13,6,1,4,2,10724,10757,17
Task 10725,Job 0,6,7,3,11,1,9,17,8,3,2,2,10725,10758,17
Task 10725,Job 1,11,10,1,7,0,12,18,6,1,2,1,10725,10758,11
Task 10726,Job 0,6,5,4,11,1,10,17,7,4,1,2,10726,10759,5
Task 10726,Job 1,11,7,1,10,1,12,21,9,1,3,0,10726,10759,8
Task 10727,Job 0,8,8,2,12,1,10,20,10,2,2,2,10727,10760,10
Task 10727,Job 1,13,8,4,9,0,17,22,5,4,3,0,10727,10760,16
Task 10728,Job 0,10,5,3,7,0,13,17,4,3,3,1,10728,10761,13
Task 10728,Job 1,15,9,4,11,1,19,26,7,4,2,0,10728,10761,9
Task 10729,Job 0,6,7,4,7,1,10,13,3,4,3,2,10729,10762,8
Task 10729,Job 1,11,8,1,9,0,12,20,8,1,1,2,10729,10762,20
Task 10730,Job 0,9,7,3,11,0,12,20,8,3,3,2,10730,10763,9
Task 10730,Job 1,14,10,1,6,0,15,20,5,1,2,2,10730,10763,17
Task 10731,Job 0,10,4,3,11,0,13,21,8,3,3,2,10731,10765,9
Task 10731,Job 1,15,5,4,9,1,19,24,5,4,2,1,10731,10765,14
Task 10732,Job 0,7,4,1,12,0,8,19,11,1,1,0,10732,10765,14
Task 10732,Job 1,12,7,4,6,0,16,18,2,4,2,1,10732,10765,19
Task 10733,Job 0,1,9,1,7,1,2,8,6,1,2,2,10733,10767,6
Task 10733,Job 1,6,10,2,7,1,8,13,5,2,3,2,10733,10767,18
Task 10734,Job 0,8,7,2,12,0,10,20,10,2,1,0,10734,10768,9
Task 10734,Job 1,13,6,3,7,0,16,20,4,3,4,0,10734,10768,13
Task 10735,Job 0,3,10,3,7,0,6,10,4,3,2,1,10735,10769,11
Task 10735,Job 1,8,6,1,12,0,9,20,11,1,1,2,10735,10769,10
Task 10736,Job 0,7,8,3,6,0,10,13,3,3,2,2,10736,10769,7
Task 10736,Job 1,12,7,4,6,0,16,18,2,4,3,0,10736,10769,9
Task 10737,Job 0,7,8,2,7,1,9,14,5,2,2,2,10737,10771,4
Task 10737,Job 1,12,5,3,11,1,15,23,8,3,3,0,10737,10771,9
Task 10738,Job 0,5,5,1,7,0,6,12,6,1,4,0,10738,10772,19
Task 10738,Job 1,10,8,1,7,1,11,17,6,1,1,0,10738,10772,19
Task 10739,Job 0,7,4,2,10,0,9,17,8,2,4,2,10739,10772,14
Task 10739,Job 1,12,8,2,6,0,14,18,4,2,2,0,10739,10772,3
Task 10740,Job 0,3,9,1,11,0,4,14,10,1,4,0,10740,10774,17
Task 10740,Job 1,8,4,2,11,0,10,19,9,2,4,1,10740,10774,3
Task 10741,Job 0,10,7,2,10,0,12,20,8,2,4,1,10741,10774,7
Task 10741,Job 1,15,6,4,9,0,19,24,5,4,1,0,10741,10774,5
Task 10742,Job 0,7,10,3,11,0,10,18,8,3,1,2,10742,10776,16
Task 10742,Job 1,12,7,1,10,0,13,22,9,1,4,2,10742,10776,8
Task 10743,Job 0,2,10,4,6,0,6,8,2,4,3,0,10743,10776,9
Task 10743,Job 1,7,6,2,7,0,9,14,5,2,3,1,10743,10776,3
Task 10744,Job 0,2,5,1,8,0,3,10,7,1,3,1,10744,10777,15
Task 10744,Job 1,7,9,4,8,1,11,15,4,4,1,2,10744,10777,5
Task 10745,Job 0,3,5,3,7,0,6,10,4,3,4,0,10745,10779,9
Task 10745,Job 1,8,6,4,12,0,12,20,8,4,2,1,10745,10779,11
Task 10746,Job 0,6,9,1,12,0,7,18,11,1,2,1,10746,10779,16
Task 10746,Job 1,11,5,2,11,0,13,22,9,2,1,2,10746,10779,2
Task 10747,Job 0,8,6,3,6,0,11,14,3,3,2,2,10747,10781,19
Task 10747,Job 1,13,5,2,8,0,15,21,6,2,3,1,10747,10781,17
Task 10748,Job 0,5,10,3,11,0,8,16,8,3,1,2,10748,10781,11
Task 10748,Job 1,10,4,3,9,1,13,19,6,3,3,2,10748,10781,9
Task 10749,Job 0,10,6,2,12,0,12,22,10,2,3,0,10749,10783,13
Task 10749,Job 1,15,5,2,8,1,17,23,6,2,1,2,10749,10783,19
Task 10750,Job 0,2,9,3,6,1,5,8,3,3,1,2,10750,10784,16
Task 10750,Job 1,7,4,4,10,0,11,17,6,4,3,0,10750,10784,17
Task 10751,Job 0,10,5,3,8,0,13,18,5,3,4,1,10751,10784,16
Task 10751,Job 1,15,6,3,6,0,18,21,3,3,1,2,10751,10784,6
Task 10752,Job 0,3,8,2,11,0,5,14,9,2,3,1,10752,10786,14
Task 10752,Job 1,8,7,4,11,0,12,19,7,4,1,0,10752,10786,10
Task 10753,Job 0,4,7,3,8,0,7,12,5,3,1,2,10753,10786,4
Task 10753,Job 1,9,4,4,8,0,13,17,4,4,1,1,10753,10786,14
Task 10754,Job 0,4,6,1,11,1,5,15,10,1,4,2,10754,10787,19
Task 10754,Job 1,9,8,2,6,0,11,15,4,2,1,2,10754,10787,8
Task 10755,Job 0,9,7,1,12,0,10,21,11,1,2,1,10755,10789,9
Task 10755,Job 1,14,10,4,9,0,18,23,5,4,3,0,10755,10789,5
Task 10756,Job 0,2,5,3,12,0,5,14,9,3,3,2,10756,10789,5
Task 10756,Job 1,7,4,4,10,0,11,17,6,4,4,1,10756,10789,8
Task 10757,Job 0,5,6,3,11,0,8,16,8,3,3,1,10757,10790,7
Task 10757,Job 1,10,8,3,9,1,13,19,6,3,3,2,10757,10790,5
Task 10758,Job 0,6,8,1,9,0,7,15,8,1,2,0,10758,10791,8
Task 10758,Job 1,11,9,3,10,1,14,21,7,3,3,0,10758,10791,11
Task 10759,Job 0,4,7,2,7,0,6,11,5,2,4,0,10759,10793,18
Task 10759,Job 1,9,4,4,10,1,13,19,6,4,4,0,10759,10793,17
Task 10760,Job 0,7,4,2,6,0,9,13,4,2,4,0,10760,10794,14
Task 10760,Job 1,12,5,3,12,0,15,24,9,3,1,2,10760,10794,6
Task 10761,Job 0,2,8,3,10,0,5,12,7,3,3,1,10761,10794,6
Task 10761,Job 1,7,9,4,12,0,11,19,8,4,1,2,10761,10794,19
Task 10762,Job 0,2,8,2,8,0,4,10,6,2,2,1,10762,10795,19
Task 10762,Job 1,7,7,3,11,0,10,18,8,3,4,0,10762,10795,13
Task 10763,Job 0,1,9,2,8,1,3,9,6,2,3,0,10763,10796,5
Task 10763,Job 1,6,7,4,10,1,10,16,6,4,2,1,10763,10796,3
Task 10764,Job 0,6,5,3,8,1,9,14,5,3,2,1,10764,10797,19
Task 10764,Job 1,11,8,3,6,0,14,17,3,3,1,1,10764,10797,2
Task 10765,Job 0,2,4,4,8,1,6,10,4,4,4,0,10765,10799,8
Task 10765,Job 1,7,4,1,10,0,8,17,9,1,2,1,10765,10799,16
Task 10766,Job 0,1,10,2,9,0,3,10,7,2,2,2,10766,10800,2
Task 10766,Job 1,6,4,2,12,1,8,18,10,2,4,1,10766,10800,14
Task 10767,Job 0,6,8,2,9,0,8,15,7,2,1,2,10767,10800,18
Task 10767,Job 1,11,7,4,11,0,15,22,7,4,2,0,10767,10800,14
Task 10768,Job 0,5,6,2,6,0,7,11,4,2,3,0,10768,10801,11
Task 10768,Job 1,10,9,1,9,0,11,19,8,1,2,2,10768,10801,13
Task 10769,Job 0,4,7,4,6,0,8,10,2,4,1,2,10769,10802,3
Task 10769,Job 1,9,4,1,11,0,10,20,10,1,4,0,10769,10802,19
Task 10770,Job 0,5,6,3,6,0,8,11,3,3,3,1,10770,10803,17
Task 10770,Job 1,10,8,4,11,1,14,21,7,4,1,2,10770,10803,5
Task 10771,Job 0,10,6,4,6,0,14,16,2,4,2,1,10771,10804,17
Task 10771,Job 1,15,8,1,6,0,16,21,5,1,1,0,10771,10804,16
Task 10772,Job 0,3,10,3,11,1,6,14,8,3,2,0,10772,10806,5
Task 10772,Job 1,8,7,1,10,0,9,18,9,1,1,1,10772,10806,9
Task 10773,Job 0,3,5,4,6,0,7,9,2,4,2,1,10773,10807,9
Task 10773,Job 1,8,4,1,8,0,9,16,7,1,3,2,10773,10807,17
Task 10774,Job 0,1,8,2,6,1,3,7,4,2,2,0,10774,10808,6
Task 10774,Job 1,6,8,1,9,0,7,15,8,1,4,2,10774,10808,3
Task 10775,Job 0,7,9,4,12,0,11,19,8,4,4,1,10775,10808,8
Task 10775,Job 1,12,5,3,12,0,15,24,9,3,3,1,10775,10808,15
Task 10776,Job 0,3,8,4,12,0,7,15,8,4,3,0,10776,10809,8
Task 10776,Job 1,8,8,2,12,0,10,20,10,2,3,0,10776,10809,9
Task 10777,Job 0,4,9,3,9,0,7,13,6,3,4,1,10777,10811,9
Task 10777,Job 1,9,7,1,12,0,10,21,11,1,2,2,10777,10811,4
Task 10778,Job 0,10,4,3,7,0,13,17,4,3,4,2,10778,10811,16
Task 10778,Job 1,15,4,3,6,1,18,21,3,3,3,1,10778,10811,10
Task 10779,Job 0,5,5,2,7,0,7,12,5,2,4,2,10779,10813,18
Task 10779,Job 1,10,4,2,6,0,12,16,4,2,2,2,10779,10813,18
Task 10780,Job 0,10,4,3,11,1,13,21,8,3,3,0,10780,10814,13
Task 10780,Job 1,15,9,3,9,0,18,24,6,3,3,0,10780,10814,7
Task 10781,Job 0,8,5,2,11,0,10,19,9,2,1,1,10781,10814,17
Task 10781,Job 1,13,10,1,12,0,14,25,11,1,4,1,10781,10814,5
Task 10782,Job 0,7,8,4,9,0,11,16,5,4,2,2,10782,10816,8
Task 10782,Job 1,12,10,2,11,0,14,23,9,2,1,2,10782,10816,10
Task 10783,Job 0,5,6,3,9,1,8,14,6,3,3,0,10783,10817,10
Task 10783,Job 1,10,9,3,8,0,13,18,5,3,1,2,10783,10817,9
Task 10784,Job 0,10,8,3,9,1,13,19,6,3,3,0,10784,10818,10
Task 10784,Job 1,15,9,4,6,1,19,21,2,4,1,0,10784,10818,9
Task 10785,Job 0,6,9,3,8,0,9,14,5,3,2,1,10785,10818,12
Task 10785,Job 1,11,9,2,7,0,13,18,5,2,4,2,10785,10818,7
Task 10786,Job 0,1,9,1,6,0,2,7,5,1,1,2,10786,10820,7
Task 10786,Job 1,6,8,1,12,1,7,18,11,1,4,1,10786,10820,17
Task 10787,Job 0,7,10,4,10,0,11,17,6,4,1,2,10787,10820,15
Task 10787,Job 1,12,5,2,7,0,14,19,5,2,4,1,10787,10820,18
Task 10788,Job 0,7,9,2,10,0,9,17,8,2,1,1,10788,10822,11
Task 10788,Job 1,12,9,1,9,0,13,21,8,1,2,2,10788,10822,8
Task 10789,Job 0,8,5,3,6,0,11,14,3,3,3,0,10789,10822,2
Task 10789,Job 1,13,6,1,9,1,14,22,8,1,4,1,10789,10822,5
Task 10790,Job 0,2,7,3,9,0,5,11,6,3,2,0,10790,10823,9
Task 10790,Job 1,7,5,1,9,0,8,16,8,1,4,2,10790,10823,5
Task 10791,Job 0,10,7,2,11,0,12,21,9,2,1,2,10791,10825,4
Task 10791,Job 1,15,8,1,8,1,16,23,7,1,3,0,10791,10825,8
Task 10792,Job 0,8,10,1,6,0,9,14,5,1,4,2,10792,10825,13
Task 10792,Job 1,13,6,4,9,0,17,22,5,4,1,0,10792,10825,8
Task 10793,Job 0,1,5,2,11,0,3,12,9,2,3,2,10793,10827,20
Task 10793,Job 1,6,10,2,9,0,8,15,7,2,3,1,10793,10827,3
Task 10794,Job 0,3,6,3,12,1,6,15,9,3,4,1,10794,10828,18
Task 10794,Job 1,8,4,2,10,0,10,18,8,2,1,1,10794,10828,10
Task 10795,Job 0,7,7,2,10,0,9,17,8,2,4,0,10795,10829,15
Task 10795,Job 1,12,6,2,7,0,14,19,5,2,2,1,10795,10829,5
Task 10796,Job 0,5,9,4,8,0,9,13,4,4,4,2,10796,10830,13
Task 10796,Job 1,10,6,4,11,0,14,21,7,4,4,1,10796,10830,10
Task 10797,Job 0,1,8,3,6,0,4,7,3,3,2,0,10797,10831,8
Task 10797,Job 1,6,8,2,12,1,8,18,10,2,1,1,10797,10831,20
Task 10798,Job 0,8,6,1,11,0,9,19,10,1,3,1,10798,10832,10
Task 10798,Job 1,13,6,2,8,0,15,21,6,2,3,0,10798,10832,19
Task 10799,Job 0,9,5,2,12,0,11,21,10,2,1,0,10799,10832,11
Task 10799,Job 1,14,7,3,8,0,17,22,5,3,3,1,10799,10832,6
Task 10800,Job 0,9,10,1,7,1,10,16,6,1,2,1,10800,10834,2
Task 10800,Job 1,14,10,3,12,0,17,26,9,3,4,1,10800,10834,6
Task 10801,Job 0,4,10,1,11,1,5,15,10,1,2,2,10801,10835,5
Task 10801,Job 1,9,7,3,12,0,12,21,9,3,3,1,10801,10835,20
Task 10802,Job 0,4,6,3,10,0,7,14,7,3,2,0,10802,10835,16
Task 10802,Job 1,9,6,3,9,0,12,18,6,3,1,2,10802,10835,6
Task 10803,Job 0,5,6,3,7,0,8,12,4,3,3,2,10803,10837,11
Task 10803,Job 1,10,6,3,6,0,13,16,3,3,2,0,10803,10837,16
Task 10804,Job 0,10,4,4,10,0,14,20,6,4,2,2,10804,10837,16
Task 10804,Job 1,15,7,4,12,0,19,27,8,4,4,2,10804,10837,13
Task 10805,Job 0,9,7,3,6,1,12,15,3,3,4,0,10805,10839,11
Task 10805,Job 1,14,5,4,10,1,18,24,6,4,4,2,10805,10839,12
Task 10806,Job 0,7,5,1,7,1,8,14,6,1,3,1,10806,10840,18
Task 10806,Job 1,12,9,1,11,1,13,23,10,1,4,2,10806,10840,20
Task 10807,Job 0,6,10,1,7,0,7,13,6,1,2,2,10807,10840,14
Task 10807,Job 1,11,8,4,6,0,15,17,2,4,1,1,10807,10840,8
Task 10808,Job 0,8,9,4,10,0,12,18,6,4,2,0,10808,10842,6
Task 10808,Job 1,13,10,4,10,0,17,23,6,4,2,0,10808,10842,9
Task 10809,Job 0,2,9,1,6,0,3,8,5,1,3,0,10809,10843,2
Task 10809,Job 1,7,5,4,12,1,11,19,8,4,1,2,10809,10843,13
Task 10810,Job 0,6,9,1,10,0,7,16,9,1,2,0,10810,10844,12
Task 10810,Job 1,11,5,4,8,0,15,19,4,4,2,1,10810,10844,16
Task 10811,Job 0,6,10,1,10,1,7,16,9,1,1,2,10811,10845,16
Task 10811,Job 1,11,5,1,9,0,12,20,8,1,4,1,10811,10845,10
Task 10812,Job 0,9,7,1,9,1,10,18,8,1,1,2,10812,10845,8
Task 10812,Job 1,14,8,3,7,0,17,21,4,3,4,2,10812,10845,12
Task 10813,Job 0,7,6,4,6,0,11,13,2,4,2,0,10813,10847,5
Task 10813,Job 1,12,8,2,12,1,14,24,10,2,1,1,10813,10847,5
Task 10814,Job 0,2,6,4,6,0,6,8,2,4,4,0,10814,10847,12
Task 10814,Job 1,7,8,2,7,0,9,14,5,2,3,1,10814,10847,3
Task 10815,Job 0,6,7,4,10,0,10,16,6,4,4,0,10815,10849,6
Task 10815,Job 1,11,4,3,8,0,14,19,5,3,1,0,10815,10849,4
Task 10816,Job 0,2,8,1,6,1,3,8,5,1,4,0,10816,10849,2
Task 10816,Job 1,7,4,3,8,0,10,15,5,3,3,1,10816,10849,11
Task 10817,Job 0,1,5,4,8,1,5,9,4,4,2,1,10817,10850,9
Task 10817,Job 1,6,7,4,7,1,10,13,3,4,2,0,10817,10850,12
Task 10818,Job 0,5,5,1,12,0,6,17,11,1,4,2,10818,10852,17
Task 10818,Job 1,10,9,4,8,0,14,18,4,4,3,2,10818,10852,8
Task 10819,Job 0,3,6,3,9,1,6,12,6,3,3,2,10819,10853,2
Task 10819,Job 1,8,9,3,6,1,11,14,3,3,4,1,10819,10853,3
Task 10820,Job 0,10,8,4,10,0,14,20,6,4,3,2,10820,10854,2
Task 10820,Job 1,15,9,1,11,1,16,26,10,1,1,1,10820,10854,11
Task 10821,Job 0,2,10,3,9,0,5,11,6,3,3,2,10821,10855,4
Task 10821,Job 1,7,4,2,10,1,9,17,8,2,1,0,10821,10855,18
Task 10822,Job 0,5,9,4,6,0,9,11,2,4,3,1,10822,10856,4
Task 10822,Job 1,10,5,3,12,1,13,22,9,3,2,2,10822,10856,13
Task 10823,Job 0,3,7,2,6,0,5,9,4,2,3,1,10823,10856,9
Task 10823,Job 1,8,10,4,12,0,12,20,8,4,3,1,10823,10856,20
Task 10824,Job 0,10,7,4,12,0,14,22,8,4,2,1,10824,10858,11
Task 10824,Job 1,15,5,4,11,0,19,26,7,4,3,1,10824,10858,5
Task 10825,Job 0,8,8,1,9,0,9,17,8,1,2,2,10825,10859,19
Task 10825,Job 1,13,10,1,6,0,14,19,5,1,1,0,10825,10859,11
Task 10826,Job 0,2,10,1,9,0,3,11,8,1,1,0,10826,10859,12
Task 10826,Job 1,7,4,4,10,0,11,17,6,4,3,0,10826,10859,6
Task 10827,Job 0,6,6,2,12,0,8,18,10,2,1,0,10827,10860,15
Task 10827,Job 1,11,7,4,6,1,15,17,2,4,2,2,10827,10860,20
Task 10828,Job 0,3,4,1,9,0,4,12,8,1,1,0,10828,10861,2
Task 10828,Job 1,8,7,3,9,1,11,17,6,3,1,1,10828,10861,7
Task 10829,Job 0,6,9,4,12,0,10,18,8,4,1,1,10829,10863,9
Task 10829,Job 1,11,7,2,6,1,13,17,4,2,2,1,10829,10863,19
Task 10830,Job 0,10,4,3,12,0,13,22,9,3,2,2,10830,10863,20
Task 10830,Job 1,15,9,4,9,0,19,24,5,4,4,0,10830,10863,9
Task 10831,Job 0,5,7,2,7,1,7,12,5,2,2,2,10831,10864,2
Task 10831,Job 1,10,5,2,12,1,12,22,10,2,4,1,10831,10864,14
Task 10832,Job 0,3,4,3,6,0,6,9,3,3,2,1,10832,10865,11
Task 10832,Job 1,8,7,1,8,1,9,16,7,1,2,0,10832,10865,12
Task 10833,Job 0,2,5,1,7,0,3,9,6,1,2,2,10833,10867,20
Task 10833,Job 1,7,8,1,7,1,8,14,6,1,4,2,10833,10867,18
Task 10834,Job 0,5,7,3,10,0,8,15,7,3,3,2,10834,10867,16
Task 10834,Job 1,10,5,1,9,0,11,19,8,1,3,2,10834,10867,8
Task 10835,Job 0,2,10,1,10,1,3,12,9,1,2,1,10835,10868,10
Task 10835,Job 1,7,7,1,8,1,8,15,7,1,3,0,10835,10868,17
Task 10836,Job 0,4,5,1,8,0,5,12,7,1,4,2,10836,10870,16
Task 10836,Job 1,9,5,3,10,1,12,19,7,3,2,1,10836,10870,15
Task 10837,Job 0,10,7,1,6,0,11,16,5,1,1,2,10837,10871,13
Task 10837,Job 1,15,6,3,8,1,18,23,5,3,1,1,10837,10871,12
Task 10838,Job 0,7,4,3,11,0,10,18,8,3,1,2,10838,10871,6
Task 10838,Job 1,12,8,4,8,0,16,20,4,4,1,0,10838,10871,14
Task 10839,Job 0,5,8,4,7,0,9,12,3,4,2,1,10839,10872,11
Task 10839,Job 1,10,8,1,12,0,11,22,11,1,3,2,10839,10872,9
Task 10840,Job 0,1,7,3,7,0,4,8,4,3,3,1,10840,10873,18
Task 10840,Job 1,6,8,2,11,1,8,17,9,2,3,2,10840,10873,9
Task 10841,Job 0,10,6,4,12,0,14,22,8,4,3,1,10841,10874,6
Task 10841,Job 1,15,6,4,11,1,19,26,7,4,1,2,10841,10874,8
Task 10842,Job 0,3,10,2,9,1,5,12,7,2,1,1,10842,10875,13
Task 10842,Job 1,8,9,1,10,0,9,18,9,1,2,2,10842,10875,15
Task 10843,Job 0,8,5,3,9,1,11,17,6,3,2,2,10843,10877,3
Task 10843,Job 1,13,5,2,7,0,15,20,5,2,2,0,10843,10877,19
Task 10844,Job 0,6,9,3,12,0,9,18,9,3,1,2,10844,10877,18
Task 10844,Job 1,11,6,1,12,0,12,23,11,1,4,0,10844,10877,11
Task 10845,Job 0,9,10,4,9,1,13,18,5,4,1,2,10845,10878,18
Task 10845,Job 1,14,6,2,10,0,16,24,8,2,1,0,10845,10878,10
Task 10846,Job 0,2,8,4,12,1,6,14,8,4,4,0,10846,10879,14
Task 10846,Job 1,7,6,4,6,0,11,13,2,4,1,0,10846,10879,13
Task 10847,Job 0,6,10,1,6,1,7,12,5,1,4,2,10847,10881,11
Task 10847,Job 1,11,6,1,9,0,12,20,8,1,2,1,10847,10881,16
Task 10848,Job 0,8,8,3,11,1,11,19,8,3,2,2,10848,10882,8
Task 10848,Job 1,13,5,2,11,0,15,24,9,2,4,2,10848,10882,17
Task 10849,Job 0,3,7,3,9,0,6,12,6,3,2,2,10849,10882,14
Task 10849,Job 1,8,8,2,11,1,10,19,9,2,1,1,10849,10882,19
Task 10850,Job 0,5,4,3,9,1,8,14,6,3,1,2,10850,10884,3
Task 10850,Job 1,10,6,3,9,1,13,19,6,3,3,0,10850,10884,20
Task 10851,Job 0,6,5,3,9,1,9,15,6,3,2,1,10851,10885,17
Task 10851,Job 1,11,5,1,6,1,12,17,5,1,2,1,10851,10885,19
Task 10852,Job 0,10,5,2,12,0,12,22,10,2,4,0,10852,10885,11
Task 10852,Job 1,15,6,2,11,0,17,26,9,2,3,1,10852,10885,10
Task 10853,Job 0,6,5,3,6,0,9,12,3,3,3,2,10853,10886,8
Task 10853,Job 1,11,5,2,6,0,13,17,4,2,2,2,10853,10886,19
Task 10854,Job 0,9,9,1,8,0,10,17,7,1,2,2,10854,10888,20
Task 10854,Job 1,14,4,3,10,1,17,24,7,3,1,0,10854,10888,12
Task 10855,Job 0,6,5,1,12,1,7,18,11,1,3,0,10855,10889,8
Task 10855,Job 1,11,9,2,10,0,13,21,8,2,4,1,10855,10889,14
Task 10856,Job 0,2,6,4,8,0,6,10,4,4,3,0,10856,10890,3
Task 10856,Job 1,7,6,1,12,0,8,19,11,1,2,2,10856,10890,4
Task 10857,Job 0,10,7,2,6,0,12,16,4,2,1,2,10857,10891,15
Task 10857,Job 1,15,7,2,8,1,17,23,6,2,2,1,10857,10891,2
Task 10858,Job 0,9,5,1,8,1,10,17,7,1,1,1,10858,10891,2
Task 10858,Job 1,14,5,3,7,1,17,21,4,3,4,0,10858,10891,20
Task 10859,Job 0,4,7,1,12,0,5,16,11,1,1,0,10859,10893,9
Task 10859,Job 1,9,8,1,7,1,10,16,6,1,3,1,10859,10893,11
Task 10860,Job 0,10,5,2,7,0,12,17,5,2,4,1,10860,10893,2
Task 10860,Job 1,15,4,2,6,1,17,21,4,2,4,0,10860,10893,17
Task 10861,Job 0,10,5,2,7,1,12,17,5,2,1,1,10861,10894,9
Task 10861,Job 1,15,8,2,9,0,17,24,7,2,3,0,10861,10894,18
Task 10862,Job 0,7,9,4,11,1,11,18,7,4,4,2,10862,10896,12
Task 10862,Job 1,12,4,1,8,0,13,20,7,1,3,2,10862,10896,8
Task 10863,Job 0,4,8,1,10,0,5,14,9,1,4,1,10863,10897,12
Task 10863,Job 1,9,4,2,9,1,11,18,7,2,4,0,10863,10897,9
Task 10864,Job 0,6,5,2,8,0,8,14,6,2,4,2,10864,10897,16
Task 10864,Job 1,11,9,1,9,1,12,20,8,1,1,1,10864,10897,2
Task 10865,Job 0,3,9,3,12,1,6,15,9,3,3,2,10865,10898,5
Task 10865,Job 1,8,7,1,10,0,9,18,9,1,2,0,10865,10898,7
Task 10866,Job 0,7,6,4,10,1,11,17,6,4,4,1,10866,10900,15
Task 10866,Job 1,12,7,4,7,0,16,19,3,4,1,1,10866,10900,17
Task 10867,Job 0,1,7,4,8,0,5,9,4,4,4,2,10867,10901,6
Task 10867,Job 1,6,8,3,10,0,9,16,7,3,2,2,10867,10901,17
Task 10868,Job 0,9,7,1,8,0,10,17,7,1,1,2,10868,10902,13
Task 10868,Job 1,14,8,2,12,0,16,26,10,2,4,1,10868,10902,2
Task 10869,Job 0,6,9,2,11,0,8,17,9,2,2,0,10869,10903,18
Task 10869,Job 1,11,5,1,8,0,12,19,7,1,1,1,10869,10903,15
Task 10870,Job 0,8,5,1,9,1,9,17,8,1,2,0,10870,10903,19
Task 10870,Job 1,13,7,1,10,0,14,23,9,1,4,0,10870,10903,8
Task 10871,Job 0,9,5,3,6,0,12,15,3,3,1,2,10871,10904,3
Task 10871,Job 1,14,9,3,12,0,17,26,9,3,4,2,10871,10904,9
Task 10872,Job 0,3,4,1,7,1,4,10,6,1,4,0,10872,10906,18
Task 10872,Job 1,8,9,4,12,1,12,20,8,4,3,2,10872,10906,13
Task 10873,Job 0,1,10,4,10,0,5,11,6,4,4,2,10873,10906,20
Task 10873,Job 1,6,5,4,8,0,10,14,4,4,2,1,10873,10906,19
Task 10874,Job 0,2,9,3,7,1,5,9,4,3,4,2,10874,10907,4
Task 10874,Job 1,7,9,1,9,0,8,16,8,1,4,0,10874,10907,11
Task 10875,Job 0,6,8,1,6,1,7,12,5,1,4,2,10875,10908,11
Task 10875,Job 1,11,6,4,11,1,15,22,7,4,3,2,10875,10908,20
Task 10876,Job 0,10,7,4,12,0,14,22,8,4,2,0,10876,10909,12
Task 10876,Job 1,15,4,4,8,0,19,23,4,4,2,2,10876,10909,9
Task 10877,Job 0,5,8,2,11,0,7,16,9,2,1,0,10877,10911,4
Task 10877,Job 1,10,10,4,8,0,14,18,4,4,4,1,10877,10911,13
Task 10878,Job 0,4,9,4,7,0,8,11,3,4,2,2,10878,10911,14
Task 10878,Job 1,9,4,4,9,0,13,18,5,4,2,2,10878,10911,19
Task 10879,Job 0,4,10,4,10,0,8,14,6,4,3,1,10879,10913,11
Task 10879,Job 1,9,6,3,6,0,12,15,3,3,1,2,10879,10913,4
Task 10880,Job 0,4,9,2,11,0,6,15,9,2,2,0,10880,10914,8
Task 10880,Job 1,9,7,1,9,1,10,18,8,1,3,0,10880,10914,8
Task 10881,Job 0,8,6,1,9,0,9,17,8,1,3,0,10881,10914,10
Task 10881,Job 1,13,7,4,6,0,17,19,2,4,2,1,10881,10914,6
Task 10882,Job 0,10,8,2,8,0,12,18,6,2,4,0,10882,10915,15
Task 10882,Job 1,15,10,4,11,0,19,26,7,4,1,2,10882,10915,6
Task 10883,Job 0,2,6,1,9,0,3,11,8,1,4,2,10883,10917,14
Task 10883,Job 1,7,10,2,6,1,9,13,4,2,4,0,10883,10917,19
Task 10884,Job 0,2,6,3,8,0,5,10,5,3,3,2,10884,10918,17
Task 10884,Job 1,7,5,2,9,0,9,16,7,2,1,2,10884,10918,3
Task 10885,Job 0,7,6,4,9,0,11,16,5,4,3,2,10885,10918,8
Task 10885,Job 1,12,10,1,6,0,13,18,5,1,1,2,10885,10918,4
Task 10886,Job 0,10,4,4,6,1,14,16,2,4,3,2,10886,10919,3
Task 10886,Job 1,15,9,2,11,0,17,26,9,2,2,2,10886,10919,2
Task 10887,Job 0,8,7,4,8,0,12,16,4,4,1,2,10887,10920,17
Task 10887,Job 1,13,9,3,7,1,16,20,4,3,4,0,10887,10920,15
Task 10888,Job 0,8,4,1,9,0,9,17,8,1,4,0,10888,10922,7
Task 10888,Job 1,13,5,3,11,0,16,24,8,3,2,2,10888,10922,5
Task 10889,Job 0,4,4,3,6,0,7,10,3,3,3,0,10889,10922,13
Task 10889,Job 1,9,7,1,8,1,10,17,7,1,2,2,10889,10922,12
Task 10890,Job 0,7,4,1,9,0,8,16,8,1,3,1,10890,10924,11
Task 10890,Job 1,12,4,4,7,1,16,19,3,4,3,2,10890,10924,11
Task 10891,Job 0,1,6,4,11,0,5,12,7,4,3,1,10891,10924,3
Task 10891,Job 1,6,9,2,10,0,8,16,8,2,3,2,10891,10924,6
Task 10892,Job 0,2,7,2,12,0,4,14,10,2,1,2,10892,10925,4
Task 10892,Job 1,7,9,1,11,0,8,18,10,1,3,0,10892,10925,3
Task 10893,Job 0,1,9,1,9,0,2,10,8,1,2,0,10893,10927,16
Task 10893,Job 1,6,7,1,9,0,7,15,8,1,3,0,10893,10927,13
Task 10894,Job 0,2,8,2,6,0,4,8,4,2,3,0,10894,10927,20
Task 10894,Job 1,7,10,4,11,0,11,18,7,4,1,0,10894,10927,6
Task 10895,Job 0,10,4,2,7,0,12,17,5,2,1,2,10895,10928,12
Task 10895,Job 1,15,10,1,7,0,16,22,6,1,3,0,10895,10928,13
Task 10896,Job 0,4,8,2,10,1,6,14,8,2,4,0,10896,10929,6
Task 10896,Job 1,9,8,1,6,0,10,15,5,1,4,1,10896,10929,13
Task 10897,Job 0,3,10,4,10,0,7,13,6,4,2,1,10897,10930,15
Task 10897,Job 1,8,8,4,10,0,12,18,6,4,3,2,10897,10930,2
Task 10898,Job 0,2,9,3,9,0,5,11,6,3,3,0,10898,10932,13
Task 10898,Job 1,7,4,3,11,0,10,18,8,3,4,0,10898,10932,10
Task 10899,Job 0,7,8,4,12,0,11,19,8,4,2,0,10899,10933,10
Task 10899,Job 1,12,4,1,8,1,13,20,7,1,3,0,10899,10933,11
Task 10900,Job 0,6,7,2,12,0,8,18,10,2,2,2,10900,10934,14
Task 10900,Job 1,11,4,3,6,0,14,17,3,3,4,0,10900,10934,3
Task 10901,Job 0,3,8,1,6,0,4,9,5,1,1,0,10901,10934,4
Task 10901,Job 1,8,5,3,7,0,11,15,4,3,2,1,10901,10934,11
Task 10902,Job 0,2,7,1,12,0,3,14,11,1,3,0,10902,10935,5
Task 10902,Job 1,7,8,3,12,0,10,19,9,3,1,1,10902,10935,7
Task 10903,Job 0,6,8,4,6,0,10,12,2,4,4,0,10903,10937,18
Task 10903,Job 1,11,5,1,10,0,12,21,9,1,4,1,10903,10937,7
Task 10904,Job 0,9,4,1,8,0,10,17,7,1,1,0,10904,10937,16
Task 10904,Job 1,14,9,2,12,0,16,26,10,2,3,0,10904,10937,2
Task 10905,Job 0,6,9,1,6,0,7,12,5,1,4,1,10905,10939,17
Task 10905,Job 1,11,10,3,6,0,14,17,3,3,3,0,10905,10939,5
Task 10906,Job 0,7,5,1,12,0,8,19,11,1,4,1,10906,10939,6
Task 10906,Job 1,12,10,1,7,0,13,19,6,1,3,1,10906,10939,6
Task 10907,Job 0,10,4,3,8,1,13,18,5,3,4,1,10907,10940,11
Task 10907,Job 1,15,5,3,7,0,18,22,4,3,2,0,10907,10940,15
Task 10908,Job 0,10,8,2,7,0,12,17,5,2,2,1,10908,10941,6
Task 10908,Job 1,15,9,1,12,0,16,27,11,1,3,0,10908,10941,19
Task 10909,Job 0,9,8,1,11,0,10,20,10,1,1,1,10909,10943,18
Task 10909,Job 1,14,10,1,12,1,15,26,11,1,1,0,10909,10943,17
Task 10910,Job 0,5,5,1,12,0,6,17,11,1,4,0,10910,10944,7
Task 10910,Job 1,10,4,3,7,0,13,17,4,3,2,1,10910,10944,6
Task 10911,Job 0,1,9,4,6,1,5,7,2,4,4,0,10911,10944,11
Task 10911,Job 1,6,8,3,9,0,9,15,6,3,4,1,10911,10944,4
Task 10912,Job 0,8,5,1,12,0,9,20,11,1,3,2,10912,10945,14
Task 10912,Job 1,13,6,4,6,1,17,19,2,4,4,2,10912,10945,4
Task 10913,Job 0,2,9,1,9,0,3,11,8,1,1,1,10913,10947,19
Task 10913,Job 1,7,5,4,6,0,11,13,2,4,4,1,10913,10947,7
Task 10914,Job 0,3,7,4,12,0,7,15,8,4,4,0,10914,10948,6
Task 10914,Job 1,8,8,2,9,1,10,17,7,2,1,2,10914,10948,11
Task 10915,Job 0,4,8,2,10,0,6,14,8,2,3,0,10915,10948,4
Task 10915,Job 1,9,10,2,6,1,11,15,4,2,4,0,10915,10948,17
Task 10916,Job 0,6,9,1,10,0,7,16,9,1,3,1,10916,10950,8
Task 10916,Job 1,11,4,2,7,0,13,18,5,2,2,0,10916,10950,3
Task 10917,Job 0,1,9,2,12,0,3,13,10,2,4,1,10917,10951,17
Task 10917,Job 1,6,10,2,7,0,8,13,5,2,2,1,10917,10951,10
Task 10918,Job 0,10,4,4,8,0,14,18,4,4,1,0,10918,10952,17
Task 10918,Job 1,15,9,4,11,0,19,26,7,4,3,1,10918,10952,7
Task 10919,Job 0,8,9,3,12,1,11,20,9,3,1,2,10919,10952,13
Task 10919,Job 1,13,8,4,6,0,17,19,2,4,2,1,10919,10952,13
Task 10920,Job 0,1,8,3,7,0,4,8,4,3,4,0,10920,10954,20
Task 10920,Job 1,6,5,3,12,1,9,18,9,3,3,1,10920,10954,3
Task 10921,Job 0,2,9,4,6,1,6,8,2,4,1,2,10921,10955,5
Task 10921,Job 1,7,6,4,7,1,11,14,3,4,2,2,10921,10955,13
Task 10922,Job 0,8,8,2,6,0,10,14,4,2,3,2,10922,10956,18
Task 10922,Job 1,13,4,3,10,0,16,23,7,3,3,2,10922,10956,19
Task 10923,Job 0,3,8,3,6,0,6,9,3,3,4,0,10923,10957,16
Task 10923,Job 1,8,7,4,9,0,12,17,5,4,3,0,10923,10957,15
Task 10924,Job 0,6,10,4,8,0,10,14,4,4,3,1,10924,10957,18
Task 10924,Job 1,11,7,4,10,0,15,21,6,4,4,2,10924,10957,11
Task 10925,Job 0,7,10,4,8,1,11,15,4,4,4,2,10925,10959,2
Task 10925,Job 1,12,7,2,12,0,14,24,10,2,4,0,10925,10959,7
Task 10926,Job 0,10,9,1,8,0,11,18,7,1,4,2,10926,10960,16
Task 10926,Job 1,15,4,1,12,0,16,27,11,1,4,0,10926,10960,14
Task 10927,Job 0,5,7,4,7,0,9,12,3,4,1,0,10927,10960,13
Task 10927,Job 1,10,9,2,9,0,12,19,7,2,3,1,10927,10960,10
Task 10928,Job 0,3,10,2,11,0,5,14,9,2,3,0,10928,10962,2
Task 10928,Job 1,8,10,4,8,0,12,16,4,4,1,0,10928,10962,12
Task 10929,Job 0,5,6,3,6,0,8,11,3,3,2,1,10929,10962,11
Task 10929,Job 1,10,10,4,9,0,14,19,5,4,2,1,10929,10962,14
Task 10930,Job 0,7,6,4,11,0,11,18,7,4,2,1,10930,10963,16
Task 10930,Job 1,12,4,4,10,0,16,22,6,4,3,2,10930,10963,17
Task 10931,Job 0,6,8,1,9,1,7,15,8,1,1,0,10931,10965,8
Task 10931,Job 1,11,6,1,9,0,12,20,8,1,2,1,10931,10965,2
Task 10932,Job 0,9,6,3,11,1,12,20,8,3,1,0,10932,10965,14
Task 10932,Job 1,14,8,3,6,1,17,20,3,3,3,0,10932,10965,12
Task 10933,Job 0,6,8,2,10,0,8,16,8,2,1,0,10933,10966,4
Task 10933,Job 1,11,9,4,12,1,15,23,8,4,3,2,10933,10966,20
Task 10934,Job 0,6,5,1,11,1,7,17,10,1,3,2,10934,10967,13
Task 10934,Job 1,11,10,1,6,0,12,17,5,1,2,1,10934,10967,5
Task 10935,Job 0,10,5,1,9,0,11,19,8,1,4,0,10935,10969,8
Task 10935,Job 1,15,5,4,9,0,19,24,5,4,4,1,10935,10969,13
Task 10936,Job 0,6,5,4,6,0,10,12,2,4,2,1,10936,10969,2
Task 10936,Job 1,11,7,3,6,1,14,17,3,3,3,0,10936,10969,17
Task 10937,Job 0,10,4,1,11,0,11,21,10,1,3,1,10937,10971,19
Task 10937,Job 1,15,4,3,8,0,18,23,5,3,2,1,10937,10971,9
Task 10938,Job 0,8,8,3,7,0,11,15,4,3,3,0,10938,10971,13
Task 10938,Job 1,13,4,4,10,0,17,23,6,4,3,1,10938,10971,13
Task 10939,Job 0,2,5,4,12,0,6,14,8,4,4,2,10939,10972,18
Task 10939,Job 1,7,6,1,10,0,8,17,9,1,3,2,10939,10972,3
Task 10940,Job 0,8,7,3,12,0,11,20,9,3,1,2,10940,10974,3
Task 10940,Job 1,13,4,4,10,0,17,23,6,4,4,2,10940,10974,15
Task 10941,Job 0,5,8,1,11,0,6,16,10,1,1,2,10941,10975,16
Task 10941,Job 1,10,6,3,11,1,13,21,8,3,2,1,10941,10975,13
Task 10942,Job 0,3,6,4,11,1,7,14,7,4,3,0,10942,10976,7
Task 10942,Job 1,8,8,2,12,0,10,20,10,2,2,1,10942,10976,6
Task 10943,Job 0,6,7,2,10,0,8,16,8,2,3,0,10943,10976,5
Task 10943,Job 1,11,9,3,10,0,14,21,7,3,4,1,10943,10976,16
Task 10944,Job 0,1,6,3,8,0,4,9,5,3,1,2,10944,10977,13
Task 10944,Job 1,6,10,3,8,0,9,14,5,3,4,2,10944,10977,8
Task 10945,Job 0,4,4,3,10,0,7,14,7,3,3,2,10945,10978,18
Task 10945,Job 1,9,6,3,7,0,12,16,4,3,3,0,10945,10978,20
Task 10946,Job 0,7,8,1,8,0,8,15,7,1,4,0,10946,10979,4
Task 10946,Job 1,12,4,1,11,0,13,23,10,1,3,0,10946,10979,3
Task 10947,Job 0,4,6,4,6,0,8,10,2,4,3,1,10947,10980,18
Task 10947,Job 1,9,10,2,10,0,11,19,8,2,2,1,10947,10980,15
Task 10948,Job 0,7,4,3,10,0,10,17,7,3,2,0,10948,10982,6
Task 10948,Job 1,12,7,3,7,1,15,19,4,3,2,2,10948,10982,13
Task 10949,Job 0,3,6,2,10,0,5,13,8,2,4,0,10949,10983,16
Task 10949,Job 1,8,6,1,7,0,9,15,6,1,1,0,10949,10983,16
Task 10950,Job 0,2,10,1,8,0,3,10,7,1,4,1,10950,10983,3
Task 10950,Job 1,7,7,1,11,0,8,18,10,1,1,0,10950,10983,2
Task 10951,Job 0,3,8,2,7,0,5,10,5,2,1,1,10951,10985,17
Task 10951,Job 1,8,10,2,11,0,10,19,9,2,3,0,10951,10985,7
Task 10952,Job 0,6,4,3,10,0,9,16,7,3,4,1,10952,10986,10
Task 10952,Job 1,11,4,3,11,0,14,22,8,3,1,2,10952,10986,17
Task 10953,Job 0,9,7,3,8,1,12,17,5,3,1,2,10953,10987,2
Task 10953,Job 1,14,5,3,6,0,17,20,3,3,3,1,10953,10987,3
Task 10954,Job 0,9,6,2,11,0,11,20,9,2,4,0,10954,10988,15
Task 10954,Job 1,14,6,3,12,0,17,26,9,3,3,1,10954,10988,18
Task 10955,Job 0,5,10,2,9,1,7,14,7,2,1,0,10955,10988,3
Task 10955,Job 1,10,9,1,8,1,11,18,7,1,1,0,10955,10988,15
Task 10956,Job 0,4,4,1,10,0,5,14,9,1,4,0,10956,10989,10
Task 10956,Job 1,9,4,1,12,0,10,21,11,1,1,2,10956,10989,11
Task 10957,Job 0,5,10,4,6,0,9,11,2,4,4,1,10957,10990,7
Task 10957,Job 1,10,8,2,10,0,12,20,8,2,2,1,10957,10990,7
Task 10958,Job 0,2,7,2,7,0,4,9,5,2,1,0,10958,10991,6
Task 10958,Job 1,7,4,2,7,0,9,14,5,2,1,1,10958,10991,9
Task 10959,Job 0,7,4,2,7,0,9,14,5,2,4,0,10959,10993,14
Task 10959,Job 1,12,6,1,10,0,13,22,9,1,1,2,10959,10993,4
Task 10960,Job 0,4,10,4,6,0,8,10,2,4,3,2,10960,10993,7
Task 10960,Job 1,9,4,4,11,0,13,20,7,4,3,1,10960,10993,17
Task 10961,Job 0,2,8,1,10,0,3,12,9,1,2,0,10961,10995,18
Task 10961,Job 1,7,4,3,8,0,10,15,5,3,3,1,10961,10995,11
Task 10962,Job 0,5,8,1,11,0,6,16,10,1,3,2,10962,10996,19
Task 10962,Job 1,10,6,2,11,0,12,21,9,2,4,0,10962,10996,16
Task 10963,Job 0,4,5,1,10,0,5,14,9,1,1,2,10963,10996,2
Task 10963,Job 1,9,7,4,6,1,13,15,2,4,3,0,10963,10996,11
Task 10964,Job 0,1,8,1,12,1,2,13,11,1,4,0,10964,10998,4
Task 10964,Job 1,6,5,3,11,0,9,17,8,3,4,2,10964,10998,3
Task 10965,Job 0,6,6,1,8,0,7,14,7,1,4,2,10965,10999,7
Task 10965,Job 1,11,4,1,6,0,12,17,5,1,3,1,10965,10999,20
Task 10966,Job 0,1,6,2,7,0,3,8,5,2,4,1,10966,10999,7
Task 10966,Job 1,6,7,3,7,0,9,13,4,3,3,1,10966,10999,18
Task 10967,Job 0,7,10,3,8,0,10,15,5,3,3,1,10967,11001,9
Task 10967,Job 1,12,10,2,7,0,14,19,5,2,2,0,10967,11001,2
Task 10968,Job 0,10,9,4,9,0,14,19,5,4,3,2,10968,11001,8
Task 10968,Job 1,15,6,1,12,0,16,27,11,1,3,2,10968,11001,8
Task 10969,Job 0,1,6,2,7,1,3,8,5,2,1,2,10969,11003,13
Task 10969,Job 1,6,8,3,12,0,9,18,9,3,4,2,10969,11003,19
Task 10970,Job 0,9,10,3,11,0,12,20,8,3,3,1,10970,11004,12
Task 10970,Job 1,14,7,1,11,0,15,25,10,1,3,1,10970,11004,15
Task 10971,Job 0,9,8,4,9,0,13,18,5,4,4,2,10971,11005,8
Task 10971,Job 1,14,5,4,10,0,18,24,6,4,4,2,10971,11005,2
Task 10972,Job 0,6,8,2,7,0,8,13,5,2,2,2,10972,11006,7
Task 10972,Job 1,11,6,3,7,0,14,18,4,3,2,1,10972,11006,3
Task 10973,Job 0,7,7,2,10,0,9,17,8,2,1,2,10973,11006,7
Task 10973,Job 1,12,4,3,8,0,15,20,5,3,3,1,10973,11006,2
Task 10974,Job 0,10,6,3,12,1,13,22,9,3,2,2,10974,11008,14
Task 10974,Job 1,15,7,3,10,0,18,25,7,3,2,2,10974,11008,3
Task 10975,Job 0,9,8,1,7,0,10,16,6,1,2,0,10975,11009,14
Task 10975,Job 1,14,9,3,7,0,17,21,4,3,3,1,10975,11009,8
Task 10976,Job 0,6,10,1,9,0,7,15,8,1,4,1,10976,11010,18
Task 10976,Job 1,11,8,1,11,1,12,22,10,1,3,2,10976,11010,16
Task 10977,Job 0,1,4,4,7,1,5,8,3,4,4,2,10977,11011,17
Task 10977,Job 1,6,7,3,11,0,9,17,8,3,4,0,10977,11011,10
Task 10978,Job 0,10,10,4,7,0,14,17,3,4,4,2,10978,11012,5
Task 10978,Job 1,15,8,4,12,0,19,27,8,4,2,0,10978,11012,12
Task 10979,Job 0,4,6,4,10,0,8,14,6,4,4,0,10979,11013,16
Task 10979,Job 1,9,10,3,7,0,12,16,4,3,2,1,10979,11013,4
Task 10980,Job 0,1,4,2,12,1,3,13,10,2,3,0,10980,11014,17
Task 10980,Job 1,6,9,2,6,0,8,12,4,2,2,2,10980,11014,17
Task 10981,Job 0,5,4,1,12,0,6,17,11,1,3,1,10981,11014,2
Task 10981,Job 1,10,8,3,8,0,13,18,5,3,1,1,10981,11014,13
Task 10982,Job 0,10,4,2,7,1,12,17,5,2,4,0,10982,11016,15
Task 10982,Job 1,15,8,1,8,0,16,23,7,1,2,1,10982,11016,6
Task 10983,Job 0,4,8,2,10,0,6,14,8,2,2,1,10983,11017,8
Task 10983,Job 1,9,4,2,10,0,11,19,8,2,2,0,10983,11017,11
Task 10984,Job 0,1,9,4,9,0,5,10,5,4,1,1,10984,11017,9
Task 10984,Job 1,6,9,1,6,0,7,12,5,1,4,0,10984,11017,12
Task 10985,Job 0,7,10,4,10,0,11,17,6,4,1,1,10985,11018,18
Task 10985,Job 1,12,6,2,6,0,14,18,4,2,2,0,10985,11018,4
Task 10986,Job 0,3,4,4,8,1,7,11,4,4,4,2,10986,11019,13
Task 10986,Job 1,8,8,3,10,1,11,18,7,3,4,0,10986,11019,2
Task 10987,Job 0,3,4,2,8,0,5,11,6,2,4,0,10987,11021,17
Task 10987,Job 1,8,9,2,10,0,10,18,8,2,1,2,10987,11021,18
Task 10988,Job 0,4,6,3,8,1,7,12,5,3,3,0,10988,11022,12
Task 10988,Job 1,9,8,1,9,1,10,18,8,1,1,2,10988,11022,2
Task 10989,Job 0,2,8,3,12,0,5,14,9,3,1,0,10989,11023,9
Task 10989,Job 1,7,4,2,6,0,9,13,4,2,4,0,10989,11023,8
Task 10990,Job 0,10,8,1,7,0,11,17,6,1,4,2,10990,11024,14
Task 10990,Job 1,15,6,1,12,1,16,27,11,1,3,1,10990,11024,8
Task 10991,Job 0,5,7,2,11,0,7,16,9,2,1,1,10991,11024,11
Task 10991,Job 1,10,8,3,6,0,13,16,3,3,2,0,10991,11024,20
Task 10992,Job 0,5,6,3,11,0,8,16,8,3,3,2,10992,11025,16
Task 10992,Job 1,10,4,1,12,0,11,22,11,1,3,2,10992,11025,16
Task 10993,Job 0,6,5,3,6,0,9,12,3,3,2,0,10993,11026,4
Task 10993,Job 1,11,10,1,9,0,12,20,8,1,4,2,10993,11026,16
Task 10994,Job 0,9,8,1,7,0,10,16,6,1,4,2,10994,11027,8
Task 10994,Job 1,14,10,2,7,0,16,21,5,2,3,0,10994,11027,2
Task 10995,Job 0,6,5,1,12,0,7,18,11,1,3,0,10995,11029,6
Task 10995,Job 1,11,8,4,10,0,15,21,6,4,1,0,10995,11029,3
Task 10996,Job 0,5,7,4,12,1,9,17,8,4,2,0,10996,11029,13
Task 10996,Job 1,10,7,2,12,0,12,22,10,2,1,1,10996,11029,6
Task 10997,Job 0,9,7,4,9,0,13,18,5,4,1,2,10997,11031,4
Task 10997,Job 1,14,8,3,11,1,17,25,8,3,1,0,10997,11031,9
Task 10998,Job 0,10,8,1,7,0,11,17,6,1,4,0,10998,11031,11
Task 10998,Job 1,15,6,1,10,0,16,25,9,1,2,0,10998,11031,18
Task 10999,Job 0,5,6,4,8,0,9,13,4,4,4,0,10999,11032,4
Task 10999,Job 1,10,5,1,6,0,11,16,5,1,4,1,10999,11032,6
Task 11000,Job 0,9,9,1,9,0,10,18,8,1,4,1,11000,11033,16
Task 11000,Job 1,14,6,4,8,0,18,22,4,4,1,2,11000,11033,8
Task 11001,Job 0,9,4,1,10,0,10,19,9,1,1,2,11001,11035,8
Task 11001,Job 1,14,8,1,10,0,15,24,9,1,3,2,11001,11035,16
Task 11002,Job 0,1,8,4,10,1,5,11,6,4,2,1,11002,11036,14
Task 11002,Job 1,6,8,3,6,0,9,12,3,3,3,2,11002,11036,16
Task 11003,Job 0,6,5,4,12,0,10,18,8,4,1,0,11003,11037,5
Task 11003,Job 1,11,7,3,8,0,14,19,5,3,2,2,11003,11037,8
Task 11004,Job 0,2,8,1,9,1,3,11,8,1,4,1,11004,11037,17
Task 11004,Job 1,7,8,3,8,1,10,15,5,3,2,2,11004,11037,5
Task 11005,Job 0,3,5,3,10,0,6,13,7,3,3,2,11005,11039,6
Task 11005,Job 1,8,5,4,8,1,12,16,4,4,1,0,11005,11039,4
Task 11006,Job 0,5,9,1,11,0,6,16,10,1,2,0,11006,11039,7
Task 11006,Job 1,10,4,4,9,0,14,19,5,4,1,2,11006,11039,5
Task 11007,Job 0,2,5,2,7,0,4,9,5,2,3,1,11007,11040,18
Task 11007,Job 1,7,5,4,11,0,11,18,7,4,2,2,11007,11040,11
Task 11008,Job 0,4,7,4,12,0,8,16,8,4,2,0,11008,11041,17
Task 11008,Job 1,9,10,2,10,0,11,19,8,2,2,1,11008,11041,14
Task 11009,Job 0,6,10,1,8,0,7,14,7,1,2,2,11009,11043,16
Task 11009,Job 1,11,7,4,8,0,15,19,4,4,4,2,11009,11043,2
Task 11010,Job 0,8,4,2,10,1,10,18,8,2,3,2,11010,11044,18
Task 11010,Job 1,13,6,1,9,0,14,22,8,1,2,2,11010,11044,7
Task 11011,Job 0,1,4,3,10,0,4,11,7,3,3,0,11011,11044,6
Task 11011,Job 1,6,4,3,8,0,9,14,5,3,1,1,11011,11044,9
Task 11012,Job 0,3,5,3,9,1,6,12,6,3,4,0,11012,11045,5
Task 11012,Job 1,8,6,1,11,0,9,19,10,1,3,0,11012,11045,4
Task 11013,Job 0,10,5,3,8,1,13,18,5,3,4,0,11013,11046,19
Task 11013,Job 1,15,10,3,9,0,18,24,6,3,3,1,11013,11046,17
Task 11014,Job 0,1,5,3,6,1,4,7,3,3,4,1,11014,11047,5
Task 11014,Job 1,6,9,2,8,0,8,14,6,2,4,2,11014,11047,14
Task 11015,Job 0,6,4,2,9,0,8,15,7,2,1,2,11015,11048,6
Task 11015,Job 1,11,10,1,9,0,12,20,8,1,4,1,11015,11048,18
Task 11016,Job 0,8,10,2,10,1,10,18,8,2,4,0,11016,11049,19
Task 11016,Job 1,13,7,1,12,0,14,25,11,1,1,2,11016,11049,17
Task 11017,Job 0,4,7,2,8,0,6,12,6,2,1,1,11017,11050,10
Task 11017,Job 1,9,10,4,12,0,13,21,8,4,2,0,11017,11050,17
Task 11018,Job 0,5,9,4,8,0,9,13,4,4,2,2,11018,11052,2
Task 11018,Job 1,10,10,2,7,0,12,17,5,2,1,1,11018,11052,17
Task 11019,Job 0,5,8,2,7,0,7,12,5,2,1,1,11019,11053,16
Task 11019,Job 1,10,8,3,8,0,13,18,5,3,2,2,11019,11053,12
Task 11020,Job 0,10,6,2,8,0,12,18,6,2,2,0,11020,11053,8
Task 11020,Job 1,15,7,3,8,0,18,23,5,3,2,1,11020,11053,18
Task 11021,Job 0,2,9,3,12,0,5,14,9,3,3,1,11021,11054,17
Task 11021,Job 1,7,8,1,10,0,8,17,9,1,2,0,11021,11054,15
Task 11022,Job 0,6,10,1,9,0,7,15,8,1,1,0,11022,11055,9
Task 11022,Job 1,11,10,2,12,0,13,23,10,2,2,0,11022,11055,5
Task 11023,Job 0,10,4,4,7,0,14,17,3,4,4,1,11023,11056,14
Task 11023,Job 1,15,8,4,6,0,19,21,2,4,3,2,11023,11056,13
Task 11024,Job 0,5,9,2,9,0,7,14,7,2,4,1,11024,11057,19
Task 11024,Job 1,10,6,3,11,1,13,21,8,3,2,0,11024,11057,3
Task 11025,Job 0,3,9,2,8,0,5,11,6,2,3,0,11025,11059,9
Task 11025,Job 1,8,7,2,12,1,10,20,10,2,3,0,11025,11059,9
Task 11026,Job 0,2,6,1,8,1,3,10,7,1,2,2,11026,11060,13
Task 11026,Job 1,7,10,3,11,1,10,18,8,3,2,2,11026,11060,13
Task 11027,Job 0,6,4,1,9,0,7,15,8,1,4,1,11027,11061,15
Task 11027,Job 1,11,6,1,12,0,12,23,11,1,2,0,11027,11061,13
Task 11028,Job 0,9,4,4,8,1,13,17,4,4,1,0,11028,11062,20
Task 11028,Job 1,14,10,3,11,0,17,25,8,3,2,0,11028,11062,9
Task 11029,Job 0,8,6,4,9,0,12,17,5,4,1,0,11029,11063,4
Task 11029,Job 1,13,9,4,10,0,17,23,6,4,3,1,11029,11063,2
Task 11030,Job 0,4,4,2,6,0,6,10,4,2,1,0,11030,11063,10
Task 11030,Job 1,9,8,4,10,0,13,19,6,4,1,2,11030,11063,13
Task 11031,Job 0,3,7,4,11,1,7,14,7,4,1,2,11031,11065,6
Task 11031,Job 1,8,5,3,10,0,11,18,7,3,2,1,11031,11065,12
Task 11032,Job 0,6,9,2,12,0,8,18,10,2,2,2,11032,11066,6
Task 11032,Job 1,11,5,4,8,0,15,19,4,4,2,2,11032,11066,18
Task 11033,Job 0,6,8,1,10,1,7,16,9,1,3,0,11033,11067,6
Task 11033,Job 1,11,7,2,10,1,13,21,8,2,3,2,11033,11067,7
Task 11034,Job 0,5,8,1,6,0,6,11,5,1,1,2,11034,11067,11
Task 11034,Job 1,10,5,4,6,0,14,16,2,4,2,2,11034,11067,11
Task 11035,Job 0,10,8,1,8,0,11,18,7,1,1,0,11035,11068,2
Task 11035,Job 1,15,6,2,10,0,17,25,8,2,3,2,11035,11068,19
Task 11036,Job 0,10,4,2,10,0,12,20,8,2,4,0,11036,11070,12
Task 11036,Job 1,15,7,1,9,0,16,24,8,1,1,0,11036,11070,7
Task 11037,Job 0,7,4,2,11,0,9,18,9,2,4,2,11037,11070,11
Task 11037,Job 1,12,9,3,9,0,15,21,6,3,2,1,11037,11070,2
Task 11038,Job 0,7,10,1,9,1,8,16,8,1,1,0,11038,11072,2
Task 11038,Job 1,12,6,1,10,1,13,22,9,1,1,2,11038,11072,6
Task 11039,Job 0,9,7,4,6,0,13,15,2,4,1,0,11039,11073,2
Task 11039,Job 1,14,9,3,12,0,17,26,9,3,2,2,11039,11073,8
Task 11040,Job 0,8,5,2,9,0,10,17,7,2,1,2,11040,11074,18
Task 11040,Job 1,13,9,1,10,0,14,23,9,1,3,2,11040,11074,2
Task 11041,Job 0,6,9,3,8,0,9,14,5,3,1,1,11041,11074,17
Task 11041,Job 1,11,8,2,10,1,13,21,8,2,4,0,11041,11074,12
Task 11042,Job 0,9,9,3,11,0,12,20,8,3,1,1,11042,11075,12
Task 11042,Job 1,14,6,1,7,0,15,21,6,1,1,1,11042,11075,10
Task 11043,Job 0,7,4,4,9,1,11,16,5,4,4,0,11043,11076,7
Task 11043,Job 1,12,5,3,12,0,15,24,9,3,2,2,11043,11076,9
Task 11044,Job 0,4,10,1,12,0,5,16,11,1,4,2,11044,11077,6
Task 11044,Job 1,9,8,2,9,0,11,18,7,2,2,2,11044,11077,12
Task 11045,Job 0,4,10,3,10,0,7,14,7,3,1,2,11045,11079,17
Task 11045,Job 1,9,8,2,6,0,11,15,4,2,2,1,11045,11079,6
Task 11046,Job 0,1,6,2,12,0,3,13,10,2,2,1,11046,11080,7
Task 11046,Job 1,6,6,2,11,0,8,17,9,2,3,0,11046,11080,16
Task 11047,Job 0,2,5,3,10,0,5,12,7,3,4,2,11047,11080,9
Task 11047,Job 1,7,10,2,6,0,9,13,4,2,2,2,11047,11080,10
Task 11048,Job 0,7,5,3,6,0,10,13,3,3,1,1,11048,11081,12
Task 11048,Job 1,12,4,3,10,0,15,22,7,3,3,1,11048,11081,19
Task 11049,Job 0,5,8,2,10,0,7,15,8,2,4,1,11049,11083,3
Task 11049,Job 1,10,7,4,12,1,14,22,8,4,4,0,11049,11083,11
Task 11050,Job 0,4,4,1,8,1,5,12,7,1,2,2,11050,11084,20
Task 11050,Job 1,9,4,2,6,0,11,15,4,2,3,0,11050,11084,14
Task 11051,Job 0,5,8,1,9,0,6,14,8,1,4,1,11051,11084,4
Task 11051,Job 1,10,6,2,10,0,12,20,8,2,1,1,11051,11084,7
Task 11052,Job 0,1,5,1,6,0,2,7,5,1,2,2,11052,11085,16
Task 11052,Job 1,6,8,2,7,0,8,13,5,2,4,0,11052,11085,16
Task 11053,Job 0,10,10,4,8,1,14,18,4,4,3,1,11053,11086,12
Task 11053,Job 1,15,9,2,8,0,17,23,6,2,4,0,11053,11086,13
Task 11054,Job 0,3,7,3,10,0,6,13,7,3,4,1,11054,11087,14
Task 11054,Job 1,8,6,4,8,0,12,16,4,4,4,0,11054,11087,14
Task 11055,Job 0,6,8,2,6,0,8,12,4,2,1,2,11055,11089,5
Task 11055,Job 1,11,10,2,11,0,13,22,9,2,3,0,11055,11089,17
Task 11056,Job 0,4,4,2,9,1,6,13,7,2,3,2,11056,11090,5
Task 11056,Job 1,9,6,2,7,0,11,16,5,2,2,0,11056,11090,18
Task 11057,Job 0,5,5,3,11,0,8,16,8,3,4,0,11057,11091,19
Task 11057,Job 1,10,5,3,7,0,13,17,4,3,3,2,11057,11091,18
Task 11058,Job 0,2,9,3,11,1,5,13,8,3,3,2,11058,11092,10
Task 11058,Job 1,7,4,4,8,0,11,15,4,4,2,2,11058,11092,11
Task 11059,Job 0,2,6,4,8,0,6,10,4,4,3,2,11059,11092,19
Task 11059,Job 1,7,10,3,11,1,10,18,8,3,3,2,11059,11092,11
Task 11060,Job 0,8,6,1,12,0,9,20,11,1,4,1,11060,11094,18
Task 11060,Job 1,13,10,2,11,1,15,24,9,2,3,2,11060,11094,9
Task 11061,Job 0,10,5,2,11,0,12,21,9,2,4,2,11061,11094,11
Task 11061,Job 1,15,5,3,9,0,18,24,6,3,2,1,11061,11094,2
Task 11062,Job 0,7,4,3,10,0,10,17,7,3,3,0,11062,11096,9
Task 11062,Job 1,12,8,4,7,0,16,19,3,4,3,1,11062,11096,12
Task 11063,Job 0,5,9,3,9,0,8,14,6,3,3,1,11063,11096,15
Task 11063,Job 1,10,10,1,12,1,11,22,11,1,4,1,11063,11096,18
Task 11064,Job 0,1,4,4,10,0,5,11,6,4,3,2,11064,11098,11
Task 11064,Job 1,6,5,2,7,0,8,13,5,2,1,0,11064,11098,3
Task 11065,Job 0,4,5,2,10,0,6,14,8,2,3,1,11065,11099,4
Task 11065,Job 1,9,10,1,7,0,10,16,6,1,4,0,11065,11099,14
Task 11066,Job 0,5,7,2,8,0,7,13,6,2,1,0,11066,11099,17
Task 11066,Job 1,10,6,4,12,0,14,22,8,4,4,1,11066,11099,16
Task 11067,Job 0,6,10,3,9,0,9,15,6,3,3,2,11067,11101,11
Task 11067,Job 1,11,4,1,8,0,12,19,7,1,2,0,11067,11101,16
Task 11068,Job 0,2,10,1,7,1,3,9,6,1,2,1,11068,11102,15
Task 11068,Job 1,7,4,4,11,0,11,18,7,4,2,1,11068,11102,15
Task 11069,Job 0,2,7,2,11,0,4,13,9,2,4,2,11069,11102,12
Task 11069,Job 1,7,5,4,12,0,11,19,8,4,1,0,11069,11102,13
Task 11070,Job 0,8,5,2,8,0,10,16,6,2,1,2,11070,11103,17
Task 11070,Job 1,13,10,4,8,0,17,21,4,4,4,0,11070,11103,17
Task 11071,Job 0,7,4,2,9,0,9,16,7,2,1,1,11071,11104,10
Task 11071,Job 1,12,10,3,11,0,15,23,8,3,2,1,11071,11104,17
Task 11072,Job 0,3,6,4,10,0,7,13,6,4,2,1,11072,11105,16
Task 11072,Job 1,8,4,1,8,0,9,16,7,1,4,0,11072,11105,7
Task 11073,Job 0,8,9,2,8,0,10,16,6,2,4,0,11073,11107,10
Task 11073,Job 1,13,8,3,12,1,16,25,9,3,3,1,11073,11107,5
Task 11074,Job 0,1,6,1,8,0,2,9,7,1,1,2,11074,11107,2
Task 11074,Job 1,6,10,3,6,0,9,12,3,3,3,0,11074,11107,5
Task 11075,Job 0,1,6,3,11,0,4,12,8,3,4,2,11075,11108,11
Task 11075,Job 1,6,5,1,12,0,7,18,11,1,3,0,11075,11108,14
Task 11076,Job 0,1,5,2,12,0,3,13,10,2,1,0,11076,11109,11
Task 11076,Job 1,6,9,1,10,1,7,16,9,1,3,1,11076,11109,10
Task 11077,Job 0,9,6,1,9,0,10,18,8,1,2,0,11077,11111,6
Task 11077,Job 1,14,10,2,6,1,16,20,4,2,3,1,11077,11111,13
Task 11078,Job 0,7,8,2,9,0,9,16,7,2,2,1,11078,11111,4
Task 11078,Job 1,12,5,3,7,0,15,19,4,3,3,1,11078,11111,9
Task 11079,Job 0,2,5,3,7,0,5,9,4,3,3,2,11079,11112,19
Task 11079,Job 1,7,10,4,9,1,11,16,5,4,4,1,11079,11112,12
Task 11080,Job 0,1,7,3,12,0,4,13,9,3,2,2,11080,11113,11
Task 11080,Job 1,6,7,1,12,1,7,18,11,1,4,0,11080,11113,16
Task 11081,Job 0,6,7,2,6,1,8,12,4,2,3,0,11081,11114,2
Task 11081,Job 1,11,6,4,7,0,15,18,3,4,1,2,11081,11114,17
Task 11082,Job 0,7,8,4,6,0,11,13,2,4,3,2,11082,11115,5
Task 11082,Job 1,12,10,3,7,0,15,19,4,3,4,1,11082,11115,17
Task 11083,Job 0,1,10,1,7,1,2,8,6,1,1,2,11083,11117,14
Task 11083,Job 1,6,5,2,12,1,8,18,10,2,1,2,11083,11117,20
Task 11084,Job 0,3,5,2,7,1,5,10,5,2,3,1,11084,11117,7
Task 11084,Job 1,8,6,4,10,0,12,18,6,4,2,2,11084,11117,12
Task 11085,Job 0,2,7,3,8,1,5,10,5,3,4,2,11085,11119,10
Task 11085,Job 1,7,9,2,7,0,9,14,5,2,3,1,11085,11119,18
Task 11086,Job 0,5,10,4,12,0,9,17,8,4,3,2,11086,11120,9
Task 11086,Job 1,10,6,1,8,0,11,18,7,1,3,0,11086,11120,8
Task 11087,Job 0,7,8,4,6,0,11,13,2,4,1,2,11087,11120,3
Task 11087,Job 1,12,6,3,9,1,15,21,6,3,3,1,11087,11120,12
Task 11088,Job 0,9,4,2,8,0,11,17,6,2,1,2,11088,11121,12
Task 11088,Job 1,14,7,1,8,1,15,22,7,1,1,1,11088,11121,14
Task 11089,Job 0,7,8,2,8,1,9,15,6,2,3,0,11089,11123,13
Task 11089,Job 1,12,10,2,6,0,14,18,4,2,1,1,11089,11123,15
Task 11090,Job 0,4,8,2,8,0,6,12,6,2,3,1,11090,11123,20
Task 11090,Job 1,9,6,4,9,0,13,18,5,4,3,0,11090,11123,18
Task 11091,Job 0,7,4,3,9,0,10,16,6,3,2,1,11091,11125,7
Task 11091,Job 1,12,9,3,11,0,15,23,8,3,3,1,11091,11125,12
Task 11092,Job 0,1,5,3,9,0,4,10,6,3,4,2,11092,11125,15
Task 11092,Job 1,6,10,3,7,0,9,13,4,3,3,0,11092,11125,7
Task 11093,Job 0,4,8,3,9,0,7,13,6,3,4,0,11093,11127,19
Task 11093,Job 1,9,4,3,7,1,12,16,4,3,1,1,11093,11127,19
Task 11094,Job 0,6,6,3,7,0,9,13,4,3,3,1,11094,11127,17
Task 11094,Job 1,11,7,3,7,0,14,18,4,3,2,1,11094,11127,5
Task 11095,Job 0,7,6,2,7,0,9,14,5,2,2,0,11095,11128,20
Task 11095,Job 1,12,5,3,12,0,15,24,9,3,3,1,11095,11128,12
Task 11096,Job 0,2,4,3,12,0,5,14,9,3,4,0,11096,11130,9
Task 11096,Job 1,7,10,2,10,0,9,17,8,2,3,1,11096,11130,8
Task 11097,Job 0,3,5,3,12,1,6,15,9,3,1,0,11097,11131,4
Task 11097,Job 1,8,10,3,9,1,11,17,6,3,4,2,11097,11131,16
Task 11098,Job 0,2,8,3,8,0,5,10,5,3,2,2,11098,11132,12
Task 11098,Job 1,7,5,4,8,0,11,15,4,4,1,0,11098,11132,17
Task 11099,Job 0,5,5,4,12,0,9,17,8,4,4,1,11099,11132,13
Task 11099,Job 1,10,4,4,8,1,14,18,4,4,2,2,11099,11132,5
Task 11100,Job 0,8,4,4,8,1,12,16,4,4,1,1,11100,11133,15
Task 11100,Job 1,13,5,2,12,1,15,25,10,2,1,0,11100,11133,14
Task 11101,Job 0,2,7,3,8,1,5,10,5,3,3,2,11101,11135,6
Task 11101,Job 1,7,5,2,12,0,9,19,10,2,1,2,11101,11135,8
Task 11102,Job 0,4,7,3,11,0,7,15,8,3,4,2,11102,11135,2
Task 11102,Job 1,9,7,3,8,0,12,17,5,3,1,1,11102,11135,6
Task 11103,Job 0,3,6,4,10,0,7,13,6,4,2,1,11103,11136,15
Task 11103,Job 1,8,10,3,8,0,11,16,5,3,2,0,11103,11136,3
Task 11104,Job 0,2,5,4,9,0,6,11,5,4,2,1,11104,11137,17
Task 11104,Job 1,7,10,2,7,0,9,14,5,2,4,2,11104,11137,6
Task 11105,Job 0,10,10,2,6,1,12,16,4,2,2,2,11105,11138,10
Task 11105,Job 1,15,5,2,9,0,17,24,7,2,4,0,11105,11138,19
Task 11106,Job 0,5,7,1,10,1,6,15,9,1,3,1,11106,11140,3
Task 11106,Job 1,10,6,2,7,1,12,17,5,2,3,0,11106,11140,20
Task 11107,Job 0,6,5,1,7,1,7,13,6,1,2,1,11107,11140,6
Task 11107,Job 1,11,6,2,7,0,13,18,5,2,2,1,11107,11140,13
Task 11108,Job 0,8,7,3,8,0,11,16,5,3,2,2,11108,11141,16
Task 11108,Job 1,13,7,3,11,0,16,24,8,3,1,0,11108,11141,9
Task 11109,Job 0,6,10,1,12,0,7,18,11,1,2,1,11109,11142,16
Task 11109,Job 1,11,9,3,11,0,14,22,8,3,2,1,11109,11142,4
Task 11110,Job 0,7,7,2,9,0,9,16,7,2,3,0,11110,11143,4
Task 11110,Job 1,12,8,2,10,1,14,22,8,2,1,2,11110,11143,8
Task 11111,Job 0,5,9,1,8,0,6,13,7,1,1,2,11111,11145,7
Task 11111,Job 1,10,6,2,7,0,12,17,5,2,1,1,11111,11145,9
Task 11112,Job 0,2,7,1,12,0,3,14,11,1,2,1,11112,11145,9
Task 11112,Job 1,7,10,1,10,0,8,17,9,1,4,2,11112,11145,13
Task 11113,Job 0,5,10,4,10,0,9,15,6,4,3,0,11113,11147,15
Task 11113,Job 1,10,6,1,6,0,11,16,5,1,1,1,11113,11147,16
Task 11114,Job 0,2,6,3,7,1,5,9,4,3,3,0,11114,11147,13
Task 11114,Job 1,7,10,4,11,0,11,18,7,4,2,0,11114,11147,8
Task 11115,Job 0,7,9,1,10,0,8,17,9,1,1,2,11115,11148,8
Task 11115,Job 1,12,6,1,12,0,13,24,11,1,4,2,11115,11148,9
Task 11116,Job 0,4,7,1,11,0,5,15,10,1,4,1,11116,11150,6
Task 11116,Job 1,9,8,4,10,0,13,19,6,4,2,2,11116,11150,7
Task 11117,Job 0,3,6,1,11,0,4,14,10,1,2,0,11117,11150,8
Task 11117,Job 1,8,4,4,11,1,12,19,7,4,3,1,11117,11150,5
Task 11118,Job 0,1,5,3,11,0,4,12,8,3,1,2,11118,11152,12
Task 11118,Job 1,6,6,1,12,0,7,18,11,1,2,0,11118,11152,3
Task 11119,Job 0,5,4,1,6,0,6,11,5,1,2,0,11119,11152,4
Task 11119,Job 1,10,9,4,6,0,14,16,2,4,3,2,11119,11152,4
Task 11120,Job 0,3,5,3,7,0,6,10,4,3,3,1,11120,11154,3
Task 11120,Job 1,8,5,3,8,1,11,16,5,3,1,0,11120,11154,7
Task 11121,Job 0,3,5,2,7,1,5,10,5,2,4,2,11121,11155,5
Task 11121,Job 1,8,8,3,12,0,11,20,9,3,2,1,11121,11155,3
Task 11122,Job 0,1,10,4,11,0,5,12,7,4,3,2,11122,11156,18
Task 11122,Job 1,6,9,1,10,0,7,16,9,1,3,0,11122,11156,11
Task 11123,Job 0,8,8,4,7,0,12,15,3,4,2,0,11123,11156,17
Task 11123,Job 1,13,9,3,8,1,16,21,5,3,3,2,11123,11156,19
Task 11124,Job 0,8,5,3,9,1,11,17,6,3,2,2,11124,11157,11
Task 11124,Job 1,13,8,4,8,0,17,21,4,4,1,1,11124,11157,13
Task 11125,Job 0,9,4,2,8,1,11,17,6,2,1,1,11125,11158,19
Task 11125,Job 1,14,6,4,6,0,18,20,2,4,1,0,11125,11158,3
Task 11126,Job 0,10,7,1,12,0,11,22,11,1,1,1,11126,11160,6
Task 11126,Job 1,15,6,4,7,0,19,22,3,4,1,1,11126,11160,19
Task 11127,Job 0,3,5,3,7,0,6,10,4,3,3,1,11127,11161,17
Task 11127,Job 1,8,4,3,10,0,11,18,7,3,3,0,11127,11161,17
Task 11128,Job 0,5,8,1,10,0,6,15,9,1,1,2,11128,11161,16
Task 11128,Job 1,10,6,2,9,0,12,19,7,2,4,0,11128,11161,8
Task 11129,Job 0,8,10,3,8,0,11,16,5,3,2,2,11129,11163,3
Task 11129,Job 1,13,4,3,8,0,16,21,5,3,4,2,11129,11163,4
Task 11130,Job 0,8,9,3,8,1,11,16,5,3,1,0,11130,11164,3
Task 11130,Job 1,13,4,1,10,1,14,23,9,1,1,1,11130,11164,20
Task 11131,Job 0,2,8,2,11,1,4,13,9,2,4,2,11131,11165,9
Task 11131,Job 1,7,8,1,7,0,8,14,6,1,1,2,11131,11165,6
Task 11132,Job 0,7,6,1,9,0,8,16,8,1,1,2,11132,11166,7
Task 11132,Job 1,12,6,2,9,0,14,21,7,2,4,0,11132,11166,15
Task 11133,Job 0,10,10,3,12,1,13,22,9,3,1,0,11133,11167,9
Task 11133,Job 1,15,6,2,11,0,17,26,9,2,2,0,11133,11167,9
Task 11134,Job 0,2,9,4,8,1,6,10,4,4,3,1,11134,11168,6
Task 11134,Job 1,7,9,2,7,0,9,14,5,2,3,1,11134,11168,16
Task 11135,Job 0,2,5,4,12,0,6,14,8,4,4,0,11135,11169,19
Task 11135,Job 1,7,6,2,8,0,9,15,6,2,1,0,11135,11169,18
Task 11136,Job 0,6,7,4,12,0,10,18,8,4,3,0,11136,11170,15
Task 11136,Job 1,11,7,4,6,1,15,17,2,4,3,2,11136,11170,6
Task 11137,Job 0,9,7,3,9,0,12,18,6,3,1,0,11137,11170,20
Task 11137,Job 1,14,6,4,10,0,18,24,6,4,3,2,11137,11170,12
Task 11138,Job 0,5,7,3,12,0,8,17,9,3,1,0,11138,11172,7
Task 11138,Job 1,10,7,2,7,0,12,17,5,2,1,1,11138,11172,9
Task 11139,Job 0,2,8,3,8,0,5,10,5,3,2,0,11139,11172,13
Task 11139,Job 1,7,5,4,10,0,11,17,6,4,2,2,11139,11172,8
Task 11140,Job 0,2,6,4,12,0,6,14,8,4,1,0,11140,11173,10
Task 11140,Job 1,7,9,1,6,0,8,13,5,1,1,1,11140,11173,19
Task 11141,Job 0,6,4,3,12,0,9,18,9,3,2,2,11141,11175,18
Task 11141,Job 1,11,5,4,10,0,15,21,6,4,2,1,11141,11175,17
Task 11142,Job 0,9,9,1,11,0,10,20,10,1,2,1,11142,11175,4
Task 11142,Job 1,14,7,2,12,0,16,26,10,2,1,1,11142,11175,3
Task 11143,Job 0,4,10,3,8,1,7,12,5,3,1,2,11143,11176,13
Task 11143,Job 1,9,5,3,10,0,12,19,7,3,1,2,11143,11176,7
Task 11144,Job 0,4,6,1,10,0,5,14,9,1,1,2,11144,11177,14
Task 11144,Job 1,9,7,1,12,0,10,21,11,1,1,2,11144,11177,16
Task 11145,Job 0,3,5,4,9,0,7,12,5,4,2,2,11145,11179,13
Task 11145,Job 1,8,4,2,7,0,10,15,5,2,1,0,11145,11179,20
Task 11146,Job 0,9,4,1,9,1,10,18,8,1,2,2,11146,11179,2
Task 11146,Job 1,14,6,1,8,0,15,22,7,1,4,0,11146,11179,7
Task 11147,Job 0,4,6,4,12,1,8,16,8,4,2,0,11147,11181,11
Task 11147,Job 1,9,4,2,8,1,11,17,6,2,3,2,11147,11181,3
Task 11148,Job 0,3,6,1,12,0,4,15,11,1,4,0,11148,11181,13
Task 11148,Job 1,8,9,2,11,0,10,19,9,2,1,0,11148,11181,3
Task 11149,Job 0,10,9,2,12,1,12,22,10,2,1,2,11149,11182,2
Task 11149,Job 1,15,6,4,8,0,19,23,4,4,2,1,11149,11182,11
Task 11150,Job 0,6,5,4,9,0,10,15,5,4,3,1,11150,11184,13
Task 11150,Job 1,11,9,3,9,0,14,20,6,3,3,2,11150,11184,11
Task 11151,Job 0,3,7,1,8,0,4,11,7,1,2,2,11151,11184,3
Task 11151,Job 1,8,7,3,11,0,11,19,8,3,1,0,11151,11184,19
Task 11152,Job 0,9,8,4,10,0,13,19,6,4,3,2,11152,11185,20
Task 11152,Job 1,14,10,2,8,0,16,22,6,2,3,2,11152,11185,19
Task 11153,Job 0,5,7,4,12,0,9,17,8,4,4,0,11153,11187,7
Task 11153,Job 1,10,6,3,12,0,13,22,9,3,2,1,11153,11187,2
Task 11154,Job 0,2,8,3,9,0,5,11,6,3,2,1,11154,11188,2
Task 11154,Job 1,7,8,4,10,0,11,17,6,4,1,1,11154,11188,13
Task 11155,Job 0,9,5,3,6,0,12,15,3,3,3,0,11155,11188,12
Task 11155,Job 1,14,6,3,7,0,17,21,4,3,1,1,11155,11188,5
Task 11156,Job 0,2,7,3,10,0,5,12,7,3,3,2,11156,11189,17
Task 11156,Job 1,7,5,4,9,1,11,16,5,4,1,2,11156,11189,18
Task 11157,Job 0,2,9,2,6,0,4,8,4,2,4,2,11157,11191,13
Task 11157,Job 1,7,8,3,11,1,10,18,8,3,3,1,11157,11191,12
Task 11158,Job 0,8,5,2,11,1,10,19,9,2,2,1,11158,11191,10
Task 11158,Job 1,13,9,2,7,0,15,20,5,2,1,0,11158,11191,15
Task 11159,Job 0,2,8,2,8,1,4,10,6,2,1,0,11159,11193,11
Task 11159,Job 1,7,8,2,12,0,9,19,10,2,3,1,11159,11193,16
Task 11160,Job 0,6,6,1,7,0,7,13,6,1,2,0,11160,11193,19
Task 11160,Job 1,11,8,2,6,0,13,17,4,2,2,0,11160,11193,12
Task 11161,Job 0,2,5,1,11,1,3,13,10,1,1,1,11161,11195,3
Task 11161,Job 1,7,4,1,6,0,8,13,5,1,4,1,11161,11195,8
Task 11162,Job 0,6,5,4,10,1,10,16,6,4,1,2,11162,11195,14
Task 11162,Job 1,11,5,1,6,0,12,17,5,1,2,0,11162,11195,7
Task 11163,Job 0,3,9,4,7,1,7,10,3,4,1,1,11163,11196,20
Task 11163,Job 1,8,8,3,9,0,11,17,6,3,4,0,11163,11196,10
Task 11164,Job 0,5,6,4,9,1,9,14,5,4,2,1,11164,11198,4
Task 11164,Job 1,10,5,4,12,0,14,22,8,4,3,1,11164,11198,20
Task 11165,Job 0,3,9,2,7,1,5,10,5,2,1,2,11165,11199,7
Task 11165,Job 1,8,9,1,6,0,9,14,5,1,2,1,11165,11199,5
Task 11166,Job 0,8,9,1,11,0,9,19,10,1,3,1,11166,11199,6
Task 11166,Job 1,13,7,3,6,0,16,19,3,3,1,2,11166,11199,4
Task 11167,Job 0,3,9,1,7,1,4,10,6,1,1,2,11167,11200,10
Task 11167,Job 1,8,10,3,6,0,11,14,3,3,1,2,11167,11200,3
Task 11168,Job 0,1,5,1,11,0,2,12,10,1,4,2,11168,11202,16
Task 11168,Job 1,6,5,4,6,0,10,12,2,4,4,2,11168,11202,8
Task 11169,Job 0,3,9,3,12,0,6,15,9,3,1,2,11169,11202,4
Task 11169,Job 1,8,5,1,9,0,9,17,8,1,3,2,11169,11202,11
Task 11170,Job 0,4,4,1,8,0,5,12,7,1,2,2,11170,11204,18
Task 11170,Job 1,9,7,3,12,0,12,21,9,3,3,1,11170,11204,15
Task 11171,Job 0,8,9,1,6,0,9,14,5,1,1,0,11171,11204,16
Task 11171,Job 1,13,6,3,8,0,16,21,5,3,2,0,11171,11204,11
Task 11172,Job 0,6,9,3,7,1,9,13,4,3,3,2,11172,11205,20
Task 11172,Job 1,11,4,4,11,0,15,22,7,4,2,2,11172,11205,7
Task 11173,Job 0,8,8,3,8,1,11,16,5,3,4,0,11173,11207,5
Task 11173,Job 1,13,7,1,11,0,14,24,10,1,3,1,11173,11207,18
Task 11174,Job 0,7,8,2,9,0,9,16,7,2,1,2,11174,11208,4
Task 11174,Job 1,12,8,3,9,1,15,21,6,3,2,2,11174,11208,4
Task 11175,Job 0,1,4,3,11,0,4,12,8,3,2,2,11175,11209,8
Task 11175,Job 1,6,7,3,11,1,9,17,8,3,4,1,11175,11209,8
Task 11176,Job 0,8,5,3,8,0,11,16,5,3,2,0,11176,11209,14
Task 11176,Job 1,13,9,4,10,0,17,23,6,4,4,2,11176,11209,10
Task 11177,Job 0,3,4,4,7,0,7,10,3,4,2,2,11177,11210,16
Task 11177,Job 1,8,9,4,12,1,12,20,8,4,1,1,11177,11210,15
Task 11178,Job 0,6,8,2,11,0,8,17,9,2,3,2,11178,11211,16
Task 11178,Job 1,11,9,2,10,0,13,21,8,2,3,1,11178,11211,13
Task 11179,Job 0,9,9,1,12,0,10,21,11,1,2,2,11179,11213,17
Task 11179,Job 1,14,10,3,8,0,17,22,5,3,2,1,11179,11213,15
Task 11180,Job 0,6,6,4,7,0,10,13,3,4,3,1,11180,11213,16
Task 11180,Job 1,11,6,3,7,0,14,18,4,3,1,2,11180,11213,9
Task 11181,Job 0,7,4,1,11,1,8,18,10,1,3,2,11181,11214,2
Task 11181,Job 1,12,6,3,7,0,15,19,4,3,1,0,11181,11214,2
Task 11182,Job 0,1,10,4,10,0,5,11,6,4,3,0,11182,11216,16
Task 11182,Job 1,6,4,3,9,1,9,15,6,3,3,2,11182,11216,14
Task 11183,Job 0,2,9,3,9,0,5,11,6,3,3,2,11183,11216,12
Task 11183,Job 1,7,8,4,8,0,11,15,4,4,3,2,11183,11216,9
Task 11184,Job 0,10,8,1,12,0,11,22,11,1,1,1,11184,11217,20
Task 11184,Job 1,15,8,4,6,0,19,21,2,4,1,1,11184,11217,3
Task 11185,Job 0,5,4,2,11,1,7,16,9,2,1,0,11185,11219,20
Task 11185,Job 1,10,9,2,6,1,12,16,4,2,3,0,11185,11219,14
Task 11186,Job 0,9,7,2,12,0,11,21,10,2,2,1,11186,11219,20
Task 11186,Job 1,14,4,1,8,0,15,22,7,1,4,0,11186,11219,11
Task 11187,Job 0,8,5,1,11,0,9,19,10,1,4,1,11187,11221,8
Task 11187,Job 1,13,5,3,7,0,16,20,4,3,2,0,11187,11221,5
Task 11188,Job 0,8,10,2,6,1,10,14,4,2,4,2,11188,11222,4
Task 11188,Job 1,13,4,4,12,0,17,25,8,4,2,0,11188,11222,13
Task 11189,Job 0,9,8,2,10,0,11,19,8,2,4,0,11189,11223,11
Task 11189,Job 1,14,6,3,9,0,17,23,6,3,3,2,11189,11223,8
Task 11190,Job 0,9,9,3,8,0,12,17,5,3,4,0,11190,11224,15
Task 11190,Job 1,14,4,3,7,0,17,21,4,3,1,1,11190,11224,9
Task 11191,Job 0,1,7,4,12,0,5,13,8,4,3,2,11191,11225,20
Task 11191,Job 1,6,9,4,7,0,10,13,3,4,2,0,11191,11225,11
Task 11192,Job 0,7,4,2,8,1,9,15,6,2,4,0,11192,11226,10
Task 11192,Job 1,12,5,3,9,0,15,21,6,3,1,0,11192,11226,16
Task 11193,Job 0,8,9,4,8,0,12,16,4,4,1,2,11193,11226,18
Task 11193,Job 1,13,8,1,11,0,14,24,10,1,2,2,11193,11226,5
Task 11194,Job 0,1,6,4,12,0,5,13,8,4,4,2,11194,11227,5
Task 11194,Job 1,6,7,2,11,0,8,17,9,2,3,1,11194,11227,4
Task 11195,Job 0,3,5,2,12,0,5,15,10,2,4,0,11195,11228,16
Task 11195,Job 1,8,8,4,6,0,12,14,2,4,2,0,11195,11228,17
Task 11196,Job 0,5,5,4,10,0,9,15,6,4,4,0,11196,11230,2
Task 11196,Job 1,10,4,2,9,0,12,19,7,2,2,2,11196,11230,19
Task 11197,Job 0,10,5,3,12,0,13,22,9,3,1,0,11197,11230,12
Task 11197,Job 1,15,6,1,7,1,16,22,6,1,2,0,11197,11230,9
Task 11198,Job 0,9,10,4,7,0,13,16,3,4,3,2,11198,11231,10
Task 11198,Job 1,14,6,1,7,0,15,21,6,1,3,1,11198,11231,3
Task 11199,Job 0,9,4,4,9,0,13,18,5,4,1,2,11199,11232,3
Task 11199,Job 1,14,9,3,10,1,17,24,7,3,4,0,11199,11232,4
Task 11200,Job 0,3,7,3,6,0,6,9,3,3,4,2,11200,11233,2
Task 11200,Job 1,8,6,1,6,0,9,14,5,1,3,2,11200,11233,4
Task 11201,Job 0,7,6,1,6,0,8,13,5,1,1,0,11201,11235,12
Task 11201,Job 1,12,7,4,7,0,16,19,3,4,2,0,11201,11235,19
Task 11202,Job 0,9,5,2,7,1,11,16,5,2,2,0,11202,11235,20
Task 11202,Job 1,14,4,4,7,0,18,21,3,4,3,1,11202,11235,13
Task 11203,Job 0,4,4,2,7,0,6,11,5,2,3,0,11203,11236,7
Task 11203,Job 1,9,9,1,6,0,10,15,5,1,4,1,11203,11236,8
Task 11204,Job 0,9,8,3,9,1,12,18,6,3,2,1,11204,11238,9
Task 11204,Job 1,14,6,2,11,0,16,25,9,2,4,2,11204,11238,20
Task 11205,Job 0,7,6,1,7,0,8,14,6,1,3,0,11205,11239,5
Task 11205,Job 1,12,10,3,7,0,15,19,4,3,4,1,11205,11239,18
Task 11206,Job 0,7,9,4,9,1,11,16,5,4,1,0,11206,11239,9
Task 11206,Job 1,12,8,2,9,0,14,21,7,2,2,2,11206,11239,16
Task 11207,Job 0,7,7,3,9,0,10,16,6,3,3,1,11207,11241,17
Task 11207,Job 1,12,7,2,10,1,14,22,8,2,3,2,11207,11241,17
Task 11208,Job 0,9,7,1,12,0,10,21,11,1,2,2,11208,11241,11
Task 11208,Job 1,14,8,2,11,0,16,25,9,2,1,1,11208,11241,20
Task 11209,Job 0,10,9,1,9,1,11,19,8,1,1,0,11209,11242,9
Task 11209,Job 1,15,9,1,12,0,16,27,11,1,2,0,11209,11242,6
Task 11210,Job 0,9,9,3,10,0,12,19,7,3,4,2,11210,11243,19
Task 11210,Job 1,14,5,1,7,0,15,21,6,1,2,0,11210,11243,8
Task 11211,Job 0,4,5,2,12,1,6,16,10,2,2,2,11211,11244,4
Task 11211,Job 1,9,6,4,7,0,13,16,3,4,3,2,11211,11244,17
Task 11212,Job 0,1,7,3,6,1,4,7,3,3,3,1,11212,11245,16
Task 11212,Job 1,6,8,3,6,0,9,12,3,3,3,0,11212,11245,7
Task 11213,Job 0,5,4,3,9,0,8,14,6,3,3,1,11213,11246,5
Task 11213,Job 1,10,4,4,6,0,14,16,2,4,3,1,11213,11246,9
Task 11214,Job 0,7,4,2,10,1,9,17,8,2,2,2,11214,11247,7
Task 11214,Job 1,12,10,1,8,0,13,20,7,1,2,1,11214,11247,18
Task 11215,Job 0,7,4,1,6,0,8,13,5,1,3,0,11215,11249,3
Task 11215,Job 1,12,9,3,8,0,15,20,5,3,1,2,11215,11249,9
Task 11216,Job 0,5,4,3,8,0,8,13,5,3,3,2,11216,11249,6
Task 11216,Job 1,10,6,4,10,0,14,20,6,4,3,0,11216,11249,2
Task 11217,Job 0,10,8,4,7,0,14,17,3,4,2,0,11217,11250,17
Task 11217,Job 1,15,9,3,10,1,18,25,7,3,2,1,11217,11250,15
Task 11218,Job 0,2,7,2,11,0,4,13,9,2,1,1,11218,11251,2
Task 11218,Job 1,7,9,3,10,0,10,17,7,3,1,1,11218,11251,12
Task 11219,Job 0,4,4,1,11,0,5,15,10,1,3,0,11219,11252,15
Task 11219,Job 1,9,5,1,6,0,10,15,5,1,4,0,11219,11252,7
Task 11220,Job 0,6,5,2,6,0,8,12,4,2,4,0,11220,11254,7
Task 11220,Job 1,11,5,2,8,0,13,19,6,2,4,2,11220,11254,4
Task 11221,Job 0,6,10,4,8,0,10,14,4,4,1,2,11221,11254,6
Task 11221,Job 1,11,6,1,11,0,12,22,10,1,3,0,11221,11254,5
Task 11222,Job 0,4,5,3,11,1,7,15,8,3,1,1,11222,11255,6
Task 11222,Job 1,9,6,3,7,0,12,16,4,3,2,0,11222,11255,9
Task 11223,Job 0,10,4,4,7,0,14,17,3,4,3,2,11223,11256,4
Task 11223,Job 1,15,5,3,12,0,18,27,9,3,2,1,11223,11256,11
Task 11224,Job 0,2,4,1,11,1,3,13,10,1,4,2,11224,11257,20
Task 11224,Job 1,7,5,3,8,0,10,15,5,3,4,0,11224,11257,13
Task 11225,Job 0,3,6,1,6,0,4,9,5,1,3,0,11225,11258,11
Task 11225,Job 1,8,8,4,12,0,12,20,8,4,1,1,11225,11258,11
Task 11226,Job 0,7,5,1,8,1,8,15,7,1,1,1,11226,11259,2
Task 11226,Job 1,12,6,1,10,0,13,22,9,1,2,0,11226,11259,14
Task 11227,Job 0,7,8,2,8,0,9,15,6,2,3,0,11227,11260,4
Task 11227,Job 1,12,8,2,9,0,14,21,7,2,4,1,11227,11260,18
Task 11228,Job 0,6,10,4,11,0,10,17,7,4,4,0,11228,11261,6
Task 11228,Job 1,11,9,4,6,0,15,17,2,4,3,2,11228,11261,8
Task 11229,Job 0,2,6,3,9,1,5,11,6,3,4,2,11229,11262,6
Task 11229,Job 1,7,4,3,11,0,10,18,8,3,1,0,11229,11262,13
Task 11230,Job 0,1,7,1,11,1,2,12,10,1,1,1,11230,11264,4
Task 11230,Job 1,6,5,2,7,1,8,13,5,2,2,1,11230,11264,19
Task 11231,Job 0,3,5,3,10,0,6,13,7,3,1,0,11231,11264,18
Task 11231,Job 1,8,6,1,8,1,9,16,7,1,3,2,11231,11264,5
Task 11232,Job 0,9,6,3,11,0,12,20,8,3,1,0,11232,11266,10
Task 11232,Job 1,14,5,1,7,1,15,21,6,1,3,0,11232,11266,2
Task 11233,Job 0,10,10,1,8,0,11,18,7,1,3,1,11233,11266,6
Task 11233,Job 1,15,7,2,11,0,17,26,9,2,4,1,11233,11266,19
Task 11234,Job 0,8,7,4,12,0,12,20,8,4,4,1,11234,11267,18
Task 11234,Job 1,13,9,2,11,0,15,24,9,2,3,0,11234,11267,20
Task 11235,Job 0,1,6,1,11,1,2,12,10,1,1,1,11235,11269,19
Task 11235,Job 1,6,7,2,12,0,8,18,10,2,4,2,11235,11269,6
Task 11236,Job 0,2,4,4,7,0,6,9,3,4,2,2,11236,11269,9
Task 11236,Job 1,7,4,3,9,0,10,16,6,3,1,1,11236,11269,13
Task 11237,Job 0,6,8,3,9,1,9,15,6,3,2,1,11237,11270,14
Task 11237,Job 1,11,4,1,9,1,12,20,8,1,3,1,11237,11270,16
Task 11238,Job 0,3,7,1,6,0,4,9,5,1,4,1,11238,11272,11
Task 11238,Job 1,8,9,1,8,0,9,16,7,1,2,0,11238,11272,2
Task 11239,Job 0,9,7,3,11,0,12,20,8,3,1,0,11239,11273,14
Task 11239,Job 1,14,10,3,11,1,17,25,8,3,2,2,11239,11273,5
Task 11240,Job 0,4,6,1,7,0,5,11,6,1,1,0,11240,11274,18
Task 11240,Job 1,9,8,3,12,0,12,21,9,3,1,1,11240,11274,20
Task 11241,Job 0,5,7,3,12,0,8,17,9,3,4,0,11241,11275,17
Task 11241,Job 1,10,6,4,10,0,14,20,6,4,1,2,11241,11275,20
Task 11242,Job 0,6,10,1,7,0,7,13,6,1,1,1,11242,11275,10
Task 11242,Job 1,11,8,3,6,0,14,17,3,3,2,2,11242,11275,16
Task 11243,Job 0,9,9,2,6,0,11,15,4,2,2,0,11243,11277,14
Task 11243,Job 1,14,7,4,10,1,18,24,6,4,3,1,11243,11277,2
Task 11244,Job 0,1,4,2,11,1,3,12,9,2,1,0,11244,11277,11
Task 11244,Job 1,6,10,3,10,1,9,16,7,3,3,1,11244,11277,4
Task 11245,Job 0,7,6,4,11,1,11,18,7,4,4,2,11245,11279,12
Task 11245,Job 1,12,9,2,7,0,14,19,5,2,4,1,11245,11279,15
Task 11246,Job 0,4,8,3,12,1,7,16,9,3,1,0,11246,11280,8
Task 11246,Job 1,9,4,1,7,0,10,16,6,1,1,1,11246,11280,16
Task 11247,Job 0,10,10,2,6,0,12,16,4,2,4,0,11247,11281,2
Task 11247,Job 1,15,8,2,8,0,17,23,6,2,1,1,11247,11281,18
Task 11248,Job 0,5,6,2,9,1,7,14,7,2,2,1,11248,11282,11
Task 11248,Job 1,10,7,4,12,0,14,22,8,4,2,1,11248,11282,9
Task 11249,Job 0,3,9,1,9,0,4,12,8,1,2,1,11249,11282,18
Task 11249,Job 1,8,7,1,7,1,9,15,6,1,4,1,11249,11282,2
Task 11250,Job 0,10,10,2,11,0,12,21,9,2,4,1,11250,11284,10
Task 11250,Job 1,15,9,3,8,0,18,23,5,3,4,2,11250,11284,8
Task 11251,Job 0,3,8,2,12,0,5,15,10,2,1,0,11251,11285,10
Task 11251,Job 1,8,9,2,11,0,10,19,9,2,2,0,11251,11285,12
Task 11252,Job 0,2,6,4,9,0,6,11,5,4,1,2,11252,11286,16
Task 11252,Job 1,7,9,3,9,0,10,16,6,3,3,0,11252,11286,12
Task 11253,Job 0,9,5,3,11,1,12,20,8,3,2,2,11253,11287,13
Task 11253,Job 1,14,9,3,8,1,17,22,5,3,2,1,11253,11287,14
Task 11254,Job 0,6,4,1,11,0,7,17,10,1,4,0,11254,11287,2
Task 11254,Job 1,11,6,3,11,1,14,22,8,3,4,1,11254,11287,18
Task 11255,Job 0,5,8,3,6,1,8,11,3,3,4,1,11255,11288,10
Task 11255,Job 1,10,4,3,7,0,13,17,4,3,4,1,11255,11288,10
Task 11256,Job 0,9,4,2,12,0,11,21,10,2,3,0,11256,11290,13
Task 11256,Job 1,14,9,3,10,0,17,24,7,3,2,0,11256,11290,7
Task 11257,Job 0,10,10,3,6,0,13,16,3,3,1,2,11257,11291,17
Task 11257,Job 1,15,4,4,9,0,19,24,5,4,1,2,11257,11291,13
Task 11258,Job 0,2,7,4,8,0,6,10,4,4,1,1,11258,11291,4
Task 11258,Job 1,7,10,3,7,1,10,14,4,3,2,1,11258,11291,9
Task 11259,Job 0,10,6,2,9,1,12,19,7,2,2,0,11259,11292,8
Task 11259,Job 1,15,9,1,9,0,16,24,8,1,3,1,11259,11292,17
Task 11260,Job 0,3,5,1,6,0,4,9,5,1,4,1,11260,11294,15
Task 11260,Job 1,8,7,3,7,0,11,15,4,3,4,0,11260,11294,5
Task 11261,Job 0,10,5,4,6,0,14,16,2,4,3,0,11261,11295,7
Task 11261,Job 1,15,7,2,6,1,17,21,4,2,2,1,11261,11295,3
Task 11262,Job 0,9,8,4,11,0,13,20,7,4,1,1,11262,11296,16
Task 11262,Job 1,14,9,2,12,0,16,26,10,2,1,1,11262,11296,14
Task 11263,Job 0,7,9,1,8,0,8,15,7,1,2,0,11263,11297,17
Task 11263,Job 1,12,5,3,8,1,15,20,5,3,2,1,11263,11297,9
Task 11264,Job 0,10,9,2,12,1,12,22,10,2,2,2,11264,11298,18
Task 11264,Job 1,15,8,4,9,0,19,24,5,4,2,1,11264,11298,20
Task 11265,Job 0,7,8,4,6,0,11,13,2,4,3,1,11265,11299,3
Task 11265,Job 1,12,4,4,9,1,16,21,5,4,2,0,11265,11299,19
Task 11266,Job 0,6,7,3,9,1,9,15,6,3,4,0,11266,11299,3
Task 11266,Job 1,11,7,3,11,0,14,22,8,3,2,2,11266,11299,15
Task 11267,Job 0,9,5,4,9,0,13,18,5,4,4,2,11267,11300,19
Task 11267,Job 1,14,8,3,10,1,17,24,7,3,4,0,11267,11300,16
Task 11268,Job 0,9,7,4,9,0,13,18,5,4,3,2,11268,11302,9
Task 11268,Job 1,14,7,3,12,0,17,26,9,3,2,1,11268,11302,2
Task 11269,Job 0,4,6,4,7,1,8,11,3,4,4,1,11269,11302,12
Task 11269,Job 1,9,10,4,9,0,13,18,5,4,2,2,11269,11302,20
Task 11270,Job 0,9,7,4,9,0,13,18,5,4,3,2,11270,11304,15
Task 11270,Job 1,14,4,2,8,1,16,22,6,2,4,1,11270,11304,8
Task 11271,Job 0,6,7,3,8,0,9,14,5,3,1,0,11271,11304,10
Task 11271,Job 1,11,7,1,9,0,12,20,8,1,2,1,11271,11304,4
Task 11272,Job 0,6,6,2,10,0,8,16,8,2,2,2,11272,11306,20
Task 11272,Job 1,11,4,1,7,1,12,18,6,1,3,0,11272,11306,5
Task 11273,Job 0,2,9,2,10,0,4,12,8,2,4,0,11273,11306,16
Task 11273,Job 1,7,9,3,12,0,10,19,9,3,1,0,11273,11306,19
Task 11274,Job 0,8,10,3,11,0,11,19,8,3,2,0,11274,11307,5
Task 11274,Job 1,13,4,4,10,0,17,23,6,4,2,2,11274,11307,6
Task 11275,Job 0,3,6,4,8,0,7,11,4,4,2,1,11275,11308,6
Task 11275,Job 1,8,5,3,6,0,11,14,3,3,2,1,11275,11308,20
Task 11276,Job 0,4,8,2,12,0,6,16,10,2,4,1,11276,11309,5
Task 11276,Job 1,9,10,2,9,1,11,18,7,2,3,1,11276,11309,14
Task 11277,Job 0,1,8,4,7,0,5,8,3,4,4,2,11277,11310,20
Task 11277,Job 1,6,7,3,10,0,9,16,7,3,3,0,11277,11310,8
Task 11278,Job 0,5,6,2,9,0,7,14,7,2,1,0,11278,11312,13
Task 11278,Job 1,10,4,1,12,0,11,22,11,1,2,2,11278,11312,18
Task 11279,Job 0,2,4,3,10,1,5,12,7,3,2,0,11279,11312,7
Task 11279,Job 1,7,9,2,7,0,9,14,5,2,1,2,11279,11312,19
Task 11280,Job 0,8,10,3,9,0,11,17,6,3,4,0,11280,11313,13
Task 11280,Job 1,13,7,3,12,1,16,25,9,3,3,0,11280,11313,8
Task 11281,Job 0,8,6,1,11,0,9,19,10,1,4,2,11281,11314,4
Task 11281,Job 1,13,6,2,10,0,15,23,8,2,4,1,11281,11314,15
Task 11282,Job 0,8,9,3,7,1,11,15,4,3,4,1,11282,11316,13
Task 11282,Job 1,13,6,4,8,0,17,21,4,4,4,1,11282,11316,16
Task 11283,Job 0,3,5,2,11,0,5,14,9,2,3,2,11283,11316,18
Task 11283,Job 1,8,10,4,7,1,12,15,3,4,4,1,11283,11316,5
Task 11284,Job 0,1,9,4,11,0,5,12,7,4,3,0,11284,11318,19
Task 11284,Job 1,6,9,4,8,0,10,14,4,4,2,0,11284,11318,18
Task 11285,Job 0,7,6,3,8,0,10,15,5,3,3,0,11285,11318,15
Task 11285,Job 1,12,5,2,10,1,14,22,8,2,1,1,11285,11318,13
Task 11286,Job 0,5,10,2,10,0,7,15,8,2,1,2,11286,11319,10
Task 11286,Job 1,10,6,3,12,0,13,22,9,3,2,2,11286,11319,11
Task 11287,Job 0,5,8,3,12,0,8,17,9,3,2,0,11287,11320,8
Task 11287,Job 1,10,9,1,9,0,11,19,8,1,4,0,11287,11320,8
Task 11288,Job 0,3,9,2,12,0,5,15,10,2,2,1,11288,11322,19
Task 11288,Job 1,8,10,4,12,0,12,20,8,4,2,2,11288,11322,7
Task 11289,Job 0,10,7,3,10,0,13,20,7,3,3,1,11289,11322,11
Task 11289,Job 1,15,8,4,7,0,19,22,3,4,1,0,11289,11322,19
Task 11290,Job 0,8,4,3,11,0,11,19,8,3,3,1,11290,11323,8
Task 11290,Job 1,13,8,3,8,0,16,21,5,3,2,0,11290,11323,6
Task 11291,Job 0,7,4,2,12,0,9,19,10,2,1,1,11291,11325,20
Task 11291,Job 1,12,8,3,12,0,15,24,9,3,1,0,11291,11325,18
Task 11292,Job 0,1,7,3,7,0,4,8,4,3,4,0,11292,11326,9
Task 11292,Job 1,6,10,2,12,1,8,18,10,2,2,1,11292,11326,18
Task 11293,Job 0,4,5,2,6,0,6,10,4,2,4,1,11293,11326,12
Task 11293,Job 1,9,8,3,8,0,12,17,5,3,1,1,11293,11326,18
Task 11294,Job 0,5,5,4,6,0,9,11,2,4,2,1,11294,11328,7
Task 11294,Job 1,10,7,4,9,0,14,19,5,4,3,0,11294,11328,15
Task 11295,Job 0,10,10,4,6,0,14,16,2,4,1,0,11295,11329,13
Task 11295,Job 1,15,5,3,8,0,18,23,5,3,2,1,11295,11329,11
Task 11296,Job 0,10,7,3,10,1,13,20,7,3,1,0,11296,11330,16
Task 11296,Job 1,15,9,1,8,0,16,23,7,1,4,0,11296,11330,20
Task 11297,Job 0,1,10,1,8,0,2,9,7,1,4,0,11297,11330,7
Task 11297,Job 1,6,5,4,11,0,10,17,7,4,4,2,11297,11330,8
Task 11298,Job 0,3,4,1,8,0,4,11,7,1,1,1,11298,11332,18
Task 11298,Job 1,8,5,1,8,1,9,16,7,1,3,1,11298,11332,7
Task 11299,Job 0,10,4,3,11,0,13,21,8,3,1,1,11299,11332,12
Task 11299,Job 1,15,8,1,9,0,16,24,8,1,3,1,11299,11332,3
Task 11300,Job 0,4,7,3,7,0,7,11,4,3,3,2,11300,11333,18
Task 11300,Job 1,9,9,4,9,0,13,18,5,4,1,0,11300,11333,14
Task 11301,Job 0,10,5,2,9,1,12,19,7,2,1,0,11301,11335,5
Task 11301,Job 1,15,7,4,12,0,19,27,8,4,3,2,11301,11335,11
Task 11302,Job 0,4,6,1,9,1,5,13,8,1,2,1,11302,11336,6
Task 11302,Job 1,9,7,3,10,0,12,19,7,3,3,0,11302,11336,14
Task 11303,Job 0,3,8,2,10,0,5,13,8,2,1,1,11303,11337,15
Task 11303,Job 1,8,7,2,9,0,10,17,7,2,3,1,11303,11337,9
Task 11304,Job 0,10,9,4,8,0,14,18,4,4,3,1,11304,11337,13
Task 11304,Job 1,15,4,4,10,0,19,25,6,4,1,1,11304,11337,15
Task 11305,Job 0,9,4,1,8,0,10,17,7,1,1,1,11305,11339,8
Task 11305,Job 1,14,4,3,6,0,17,20,3,3,2,0,11305,11339,4
Task 11306,Job 0,1,8,2,11,0,3,12,9,2,4,1,11306,11340,15
Task 11306,Job 1,6,7,4,12,0,10,18,8,4,4,0,11306,11340,14
Task 11307,Job 0,9,9,1,12,1,10,21,11,1,1,0,11307,11340,9
Task 11307,Job 1,14,8,1,9,1,15,23,8,1,4,1,11307,11340,7
Task 11308,Job 0,3,6,1,7,0,4,10,6,1,3,0,11308,11342,16
Task 11308,Job 1,8,8,2,8,0,10,16,6,2,2,2,11308,11342,3
Task 11309,Job 0,3,10,1,9,1,4,12,8,1,3,2,11309,11342,20
Task 11309,Job 1,8,8,3,11,1,11,19,8,3,3,2,11309,11342,9
Task 11310,Job 0,10,8,4,9,1,14,19,5,4,1,1,11310,11344,14
Task 11310,Job 1,15,7,1,7,0,16,22,6,1,1,1,11310,11344,10
Task 11311,Job 0,3,9,2,6,0,5,9,4,2,2,0,11311,11344,3
Task 11311,Job 1,8,8,3,6,0,11,14,3,3,2,2,11311,11344,9
Task 11312,Job 0,4,4,3,11,1,7,15,8,3,1,1,11312,11345,16
Task 11312,Job 1,9,6,1,9,0,10,18,8,1,1,2,11312,11345,6
Task 11313,Job 0,6,7,2,12,0,8,18,10,2,3,1,11313,11347,4
Task 11313,Job 1,11,5,2,12,0,13,23,10,2,1,0,11313,11347,5
Task 11314,Job 0,10,9,1,12,1,11,22,11,1,2,1,11314,11347,5
Task 11314,Job 1,15,10,1,11,1,16,26,10,1,3,0,11314,11347,8
Task 11315,Job 0,7,4,1,6,1,8,13,5,1,2,2,11315,11348,7
Task 11315,Job 1,12,9,2,10,1,14,22,8,2,2,0,11315,11348,20
Task 11316,Job 0,6,9,3,8,1,9,14,5,3,1,0,11316,11350,2
Task 11316,Job 1,11,4,4,12,0,15,23,8,4,2,2,11316,11350,2
Task 11317,Job 0,2,5,3,11,1,5,13,8,3,3,1,11317,11351,3
Task 11317,Job 1,7,7,4,10,0,11,17,6,4,4,0,11317,11351,3
Task 11318,Job 0,5,10,3,12,0,8,17,9,3,1,2,11318,11351,5
Task 11318,Job 1,10,4,1,7,0,11,17,6,1,4,2,11318,11351,17
Task 11319,Job 0,8,6,3,11,1,11,19,8,3,3,2,11319,11352,20
Task 11319,Job 1,13,9,3,9,0,16,22,6,3,2,1,11319,11352,5
Task 11320,Job 0,8,4,1,10,0,9,18,9,1,3,1,11320,11354,16
Task 11320,Job 1,13,6,2,8,0,15,21,6,2,3,2,11320,11354,16
Task 11321,Job 0,2,8,3,6,0,5,8,3,3,1,2,11321,11355,17
Task 11321,Job 1,7,9,1,10,1,8,17,9,1,2,0,11321,11355,19
Task 11322,Job 0,9,9,1,6,1,10,15,5,1,2,1,11322,11355,17
Task 11322,Job 1,14,5,2,9,0,16,23,7,2,3,1,11322,11355,19
Task 11323,Job 0,1,7,3,12,0,4,13,9,3,2,0,11323,11356,3
Task 11323,Job 1,6,9,2,6,0,8,12,4,2,4,0,11323,11356,10
Task 11324,Job 0,8,10,1,11,0,9,19,10,1,4,1,11324,11358,20
Task 11324,Job 1,13,4,1,6,0,14,19,5,1,1,2,11324,11358,5
Task 11325,Job 0,7,5,1,11,0,8,18,10,1,1,2,11325,11359,14
Task 11325,Job 1,12,5,3,11,0,15,23,8,3,2,2,11325,11359,2
Task 11326,Job 0,8,9,2,7,0,10,15,5,2,4,0,11326,11359,5
Task 11326,Job 1,13,8,4,12,0,17,25,8,4,2,2,11326,11359,18
Task 11327,Job 0,10,5,3,12,0,13,22,9,3,3,2,11327,11361,8
Task 11327,Job 1,15,4,3,11,0,18,26,8,3,1,0,11327,11361,18
Task 11328,Job 0,1,8,4,12,0,5,13,8,4,1,1,11328,11362,2
Task 11328,Job 1,6,10,1,8,0,7,14,7,1,2,1,11328,11362,7
Task 11329,Job 0,10,4,3,9,0,13,19,6,3,4,1,11329,11363,2
Task 11329,Job 1,15,8,1,9,0,16,24,8,1,4,2,11329,11363,11
Task 11330,Job 0,4,7,1,10,0,5,14,9,1,2,2,11330,11363,16
Task 11330,Job 1,9,4,4,8,0,13,17,4,4,2,1,11330,11363,15
Task 11331,Job 0,5,9,3,9,0,8,14,6,3,4,1,11331,11365,5
Task 11331,Job 1,10,8,1,9,0,11,19,8,1,1,0,11331,11365,6
Task 11332,Job 0,5,5,2,8,0,7,13,6,2,3,2,11332,11365,14
Task 11332,Job 1,10,8,2,6,0,12,16,4,2,1,1,11332,11365,15
Task 11333,Job 0,4,10,4,8,0,8,12,4,4,1,2,11333,11367,3
Task 11333,Job 1,9,7,3,8,0,12,17,5,3,3,1,11333,11367,16
Task 11334,Job 0,8,5,3,12,0,11,20,9,3,2,0,11334,11368,12
Task 11334,Job 1,13,8,1,10,1,14,23,9,1,1,0,11334,11368,14
Task 11335,Job 0,9,7,2,12,0,11,21,10,2,3,2,11335,11368,4
Task 11335,Job 1,14,9,1,7,0,15,21,6,1,1,1,11335,11368,7
Task 11336,Job 0,2,5,1,11,0,3,13,10,1,2,1,11336,11370,10
Task 11336,Job 1,7,4,2,6,0,9,13,4,2,2,0,11336,11370,12
Task 11337,Job 0,1,6,2,12,0,3,13,10,2,3,1,11337,11370,15
Task 11337,Job 1,6,6,4,9,0,10,15,5,4,1,0,11337,11370,18
Task 11338,Job 0,4,10,2,9,1,6,13,7,2,2,1,11338,11372,9
Task 11338,Job 1,9,8,3,8,0,12,17,5,3,3,1,11338,11372,16
Task 11339,Job 0,9,5,2,8,0,11,17,6,2,3,2,11339,11373,13
Task 11339,Job 1,14,5,2,7,0,16,21,5,2,2,2,11339,11373,20
Task 11340,Job 0,1,8,1,9,0,2,10,8,1,4,0,11340,11374,11
Task 11340,Job 1,6,8,4,7,1,10,13,3,4,2,1,11340,11374,13
Task 11341,Job 0,8,4,4,9,0,12,17,5,4,3,2,11341,11375,6
Task 11341,Job 1,13,8,3,9,1,16,22,6,3,2,0,11341,11375,5
Task 11342,Job 0,9,9,3,10,0,12,19,7,3,3,1,11342,11375,9
Task 11342,Job 1,14,4,1,7,0,15,21,6,1,2,2,11342,11375,19
Task 11343,Job 0,4,10,2,10,0,6,14,8,2,2,0,11343,11376,3
Task 11343,Job 1,9,6,2,12,0,11,21,10,2,2,1,11343,11376,13
Task 11344,Job 0,8,8,2,10,0,10,18,8,2,3,0,11344,11378,17
Task 11344,Job 1,13,10,2,8,0,15,21,6,2,4,1,11344,11378,12
Task 11345,Job 0,3,6,3,11,0,6,14,8,3,2,1,11345,11379,16
Task 11345,Job 1,8,8,3,6,0,11,14,3,3,3,1,11345,11379,6
Task 11346,Job 0,3,9,4,9,0,7,12,5,4,2,0,11346,11380,5
Task 11346,Job 1,8,8,2,6,0,10,14,4,2,4,1,11346,11380,3
Task 11347,Job 0,9,5,2,7,0,11,16,5,2,2,1,11347,11380,9
Task 11347,Job 1,14,9,2,11,0,16,25,9,2,1,2,11347,11380,3
Task 11348,Job 0,9,9,1,8,0,10,17,7,1,4,2,11348,11382,6
Task 11348,Job 1,14,8,3,12,0,17,26,9,3,3,2,11348,11382,8
Task 11349,Job 0,2,5,3,7,0,5,9,4,3,3,2,11349,11383,5
Task 11349,Job 1,7,9,1,6,0,8,13,5,1,4,0,11349,11383,11
Task 11350,Job 0,2,4,4,6,1,6,8,2,4,4,2,11350,11384,19
Task 11350,Job 1,7,10,3,7,1,10,14,4,3,3,2,11350,11384,11
Task 11351,Job 0,7,10,1,11,0,8,18,10,1,2,0,11351,11384,7
Task 11351,Job 1,12,6,4,7,0,16,19,3,4,2,2,11351,11384,6
Task 11352,Job 0,6,8,3,6,0,9,12,3,3,4,1,11352,11385,11
Task 11352,Job 1,11,4,1,8,1,12,19,7,1,3,0,11352,11385,2
Task 11353,Job 0,9,10,4,11,0,13,20,7,4,3,1,11353,11387,6
Task 11353,Job 1,14,10,1,8,0,15,22,7,1,2,0,11353,11387,10
Task 11354,Job 0,4,7,4,8,0,8,12,4,4,3,1,11354,11388,12
Task 11354,Job 1,9,9,3,7,1,12,16,4,3,1,2,11354,11388,14
Task 11355,Job 0,1,10,1,11,0,2,12,10,1,1,0,11355,11389,8
Task 11355,Job 1,6,8,3,8,1,9,14,5,3,3,1,11355,11389,2
Task 11356,Job 0,2,4,1,7,0,3,9,6,1,3,0,11356,11390,4
Task 11356,Job 1,7,10,1,12,0,8,19,11,1,1,1,11356,11390,13
Task 11357,Job 0,9,6,3,10,0,12,19,7,3,3,0,11357,11390,18
Task 11357,Job 1,14,10,3,12,1,17,26,9,3,3,2,11357,11390,12
Task 11358,Job 0,9,6,4,8,0,13,17,4,4,1,2,11358,11392,9
Task 11358,Job 1,14,4,1,9,1,15,23,8,1,1,1,11358,11392,9
Task 11359,Job 0,7,8,1,8,0,8,15,7,1,2,0,11359,11392,17
Task 11359,Job 1,12,10,3,9,0,15,21,6,3,4,0,11359,11392,8
Task 11360,Job 0,3,10,1,7,1,4,10,6,1,1,2,11360,11393,4
Task 11360,Job 1,8,7,2,10,0,10,18,8,2,2,1,11360,11393,15
Task 11361,Job 0,4,9,2,10,1,6,14,8,2,2,0,11361,11395,7
Task 11361,Job 1,9,7,4,6,0,13,15,2,4,4,1,11361,11395,8
Task 11362,Job 0,7,8,4,11,1,11,18,7,4,3,2,11362,11396,13
Task 11362,Job 1,12,4,1,10,1,13,22,9,1,1,2,11362,11396,17
Task 11363,Job 0,8,6,1,10,0,9,18,9,1,2,1,11363,11396,20
Task 11363,Job 1,13,5,2,11,0,15,24,9,2,3,0,11363,11396,5
Task 11364,Job 0,10,7,4,6,0,14,16,2,4,2,2,11364,11398,4
Task 11364,Job 1,15,10,2,6,1,17,21,4,2,3,0,11364,11398,18
Task 11365,Job 0,5,10,3,9,0,8,14,6,3,2,0,11365,11399,16
Task 11365,Job 1,10,5,2,6,1,12,16,4,2,2,2,11365,11399,18
Task 11366,Job 0,1,9,3,10,0,4,11,7,3,1,0,11366,11399,11
Task 11366,Job 1,6,5,3,10,1,9,16,7,3,1,2,11366,11399,20
Task 11367,Job 0,8,5,3,12,1,11,20,9,3,2,2,11367,11401,3
Task 11367,Job 1,13,7,2,8,0,15,21,6,2,1,1,11367,11401,8
Task 11368,Job 0,4,10,1,11,1,5,15,10,1,3,0,11368,11401,6
Task 11368,Job 1,9,5,2,12,0,11,21,10,2,3,0,11368,11401,2
Task 11369,Job 0,9,7,2,12,0,11,21,10,2,3,1,11369,11402,11
Task 11369,Job 1,14,8,2,11,0,16,25,9,2,3,2,11369,11402,5
Task 11370,Job 0,5,5,1,7,0,6,12,6,1,2,1,11370,11404,5
Task 11370,Job 1,10,4,3,9,0,13,19,6,3,1,2,11370,11404,3
Task 11371,Job 0,5,9,1,6,0,6,11,5,1,1,2,11371,11405,4
Task 11371,Job 1,10,8,1,12,0,11,22,11,1,2,0,11371,11405,3
Task 11372,Job 0,6,4,4,11,0,10,17,7,4,2,2,11372,11405,4
Task 11372,Job 1,11,9,3,9,0,14,20,6,3,3,1,11372,11405,3
Task 11373,Job 0,5,9,1,11,0,6,16,10,1,4,0,11373,11407,14
Task 11373,Job 1,10,4,4,8,1,14,18,4,4,2,2,11373,11407,18
Task 11374,Job 0,1,5,4,11,1,5,12,7,4,1,0,11374,11407,10
Task 11374,Job 1,6,5,2,11,0,8,17,9,2,3,2,11374,11407,6
Task 11375,Job 0,1,6,4,10,0,5,11,6,4,4,2,11375,11409,12
Task 11375,Job 1,6,10,4,9,0,10,15,5,4,1,0,11375,11409,20
Task 11376,Job 0,10,4,4,12,1,14,22,8,4,1,1,11376,11409,4
Task 11376,Job 1,15,10,4,9,0,19,24,5,4,3,2,11376,11409,19
Task 11377,Job 0,6,4,4,6,0,10,12,2,4,2,2,11377,11410,19
Task 11377,Job 1,11,7,4,10,0,15,21,6,4,2,2,11377,11410,14
Task 11378,Job 0,3,4,3,11,0,6,14,8,3,1,1,11378,11411,9
Task 11378,Job 1,8,5,1,8,0,9,16,7,1,1,2,11378,11411,2
Task 11379,Job 0,2,4,1,10,0,3,12,9,1,3,1,11379,11413,10
Task 11379,Job 1,7,8,1,9,1,8,16,8,1,4,2,11379,11413,14
Task 11380,Job 0,4,4,3,9,0,7,13,6,3,3,1,11380,11414,5
Task 11380,Job 1,9,4,3,6,0,12,15,3,3,2,1,11380,11414,12
Task 11381,Job 0,3,8,4,8,0,7,11,4,4,1,1,11381,11414,7
Task 11381,Job 1,8,10,3,12,1,11,20,9,3,2,0,11381,11414,13
Task 11382,Job 0,10,8,4,10,0,14,20,6,4,3,1,11382,11416,5
Task 11382,Job 1,15,9,4,7,0,19,22,3,4,3,2,11382,11416,19
Task 11383,Job 0,9,10,1,10,0,10,19,9,1,3,0,11383,11416,2
Task 11383,Job 1,14,5,1,11,0,15,25,10,1,4,1,11383,11416,9
Task 11384,Job 0,2,7,2,11,0,4,13,9,2,2,0,11384,11418,8
Task 11384,Job 1,7,8,4,12,1,11,19,8,4,4,1,11384,11418,2
Task 11385,Job 0,7,8,4,12,1,11,19,8,4,4,0,11385,11419,19
Task 11385,Job 1,12,6,4,10,0,16,22,6,4,3,2,11385,11419,3
Task 11386,Job 0,4,6,2,9,0,6,13,7,2,3,0,11386,11420,12
Task 11386,Job 1,9,4,1,10,1,10,19,9,1,4,0,11386,11420,4
Task 11387,Job 0,7,9,4,10,0,11,17,6,4,2,1,11387,11420,11
Task 11387,Job 1,12,4,1,6,0,13,18,5,1,4,2,11387,11420,5
Task 11388,Job 0,6,4,4,7,0,10,13,3,4,3,1,11388,11422,10
Task 11388,Job 1,11,8,2,10,0,13,21,8,2,2,1,11388,11422,11
Task 11389,Job 0,4,9,2,10,1,6,14,8,2,3,0,11389,11423,2
Task 11389,Job 1,9,6,2,6,0,11,15,4,2,4,2,11389,11423,15
Task 11390,Job 0,9,5,4,8,0,13,17,4,4,3,0,11390,11423,14
Task 11390,Job 1,14,6,1,9,0,15,23,8,1,4,1,11390,11423,5
Task 11391,Job 0,6,5,4,7,0,10,13,3,4,4,0,11391,11424,16
Task 11391,Job 1,11,5,1,12,0,12,23,11,1,1,0,11391,11424,5
Task 11392,Job 0,6,9,3,7,0,9,13,4,3,1,2,11392,11425,4
Task 11392,Job 1,11,10,2,9,0,13,20,7,2,1,1,11392,11425,8
Task 11393,Job 0,1,4,1,11,1,2,12,10,1,2,2,11393,11426,9
Task 11393,Job 1,6,9,3,6,0,9,12,3,3,3,1,11393,11426,16
Task 11394,Job 0,8,8,2,12,0,10,20,10,2,1,2,11394,11427,4
Task 11394,Job 1,13,8,1,6,0,14,19,5,1,2,1,11394,11427,7
Task 11395,Job 0,2,10,3,11,0,5,13,8,3,3,1,11395,11428,11
Task 11395,Job 1,7,8,2,10,0,9,17,8,2,2,0,11395,11428,2
Task 11396,Job 0,4,4,1,7,0,5,11,6,1,1,0,11396,11430,15
Task 11396,Job 1,9,5,2,12,0,11,21,10,2,4,1,11396,11430,13
Task 11397,Job 0,5,10,1,12,0,6,17,11,1,2,0,11397,11431,19
Task 11397,Job 1,10,4,3,12,1,13,22,9,3,2,2,11397,11431,15
Task 11398,Job 0,10,7,2,7,0,12,17,5,2,3,2,11398,11431,20
Task 11398,Job 1,15,9,4,6,0,19,21,2,4,3,0,11398,11431,17
Task 11399,Job 0,8,8,4,9,0,12,17,5,4,2,1,11399,11433,3
Task 11399,Job 1,13,4,4,10,0,17,23,6,4,4,2,11399,11433,2
Task 11400,Job 0,9,9,2,6,0,11,15,4,2,1,1,11400,11433,16
Task 11400,Job 1,14,8,1,9,0,15,23,8,1,4,0,11400,11433,12
Task 11401,Job 0,4,10,4,8,0,8,12,4,4,1,2,11401,11434,18
Task 11401,Job 1,9,7,4,9,0,13,18,5,4,4,1,11401,11434,16
Task 11402,Job 0,9,10,4,11,1,13,20,7,4,2,2,11402,11435,10
Task 11402,Job 1,14,8,2,6,0,16,20,4,2,3,1,11402,11435,6
Task 11403,Job 0,6,5,4,11,1,10,17,7,4,3,2,11403,11436,8
Task 11403,Job 1,11,4,1,12,1,12,23,11,1,4,1,11403,11436,3
Task 11404,Job 0,3,7,2,8,1,5,11,6,2,1,2,11404,11437,20
Task 11404,Job 1,8,4,1,9,0,9,17,8,1,4,0,11404,11437,20
Task 11405,Job 0,2,8,4,7,0,6,9,3,4,4,0,11405,11438,15
Task 11405,Job 1,7,8,1,9,0,8,16,8,1,2,0,11405,11438,11
Task 11406,Job 0,8,9,3,6,0,11,14,3,3,3,0,11406,11440,14
Task 11406,Job 1,13,10,4,7,0,17,20,3,4,2,1,11406,11440,14
Task 11407,Job 0,3,5,4,8,1,7,11,4,4,2,2,11407,11440,9
Task 11407,Job 1,8,8,4,11,1,12,19,7,4,1,2,11407,11440,15
Task 11408,Job 0,6,4,3,12,0,9,18,9,3,4,0,11408,11442,4
Task 11408,Job 1,11,10,4,7,1,15,18,3,4,2,1,11408,11442,12
Task 11409,Job 0,10,6,1,8,0,11,18,7,1,4,0,11409,11443,14
Task 11409,Job 1,15,9,1,11,0,16,26,10,1,3,2,11409,11443,2
Task 11410,Job 0,8,8,1,12,0,9,20,11,1,2,1,11410,11444,18
Task 11410,Job 1,13,6,4,9,0,17,22,5,4,2,2,11410,11444,14
Task 11411,Job 0,6,4,4,9,0,10,15,5,4,3,0,11411,11445,10
Task 11411,Job 1,11,5,3,9,0,14,20,6,3,3,2,11411,11445,16
Task 11412,Job 0,3,10,2,9,1,5,12,7,2,1,1,11412,11445,6
Task 11412,Job 1,8,5,3,8,0,11,16,5,3,3,2,11412,11445,17
Task 11413,Job 0,6,9,3,12,0,9,18,9,3,4,1,11413,11447,13
Task 11413,Job 1,11,7,1,6,0,12,17,5,1,2,2,11413,11447,12
Task 11414,Job 0,4,10,3,9,0,7,13,6,3,3,0,11414,11447,9
Task 11414,Job 1,9,6,2,7,0,11,16,5,2,4,1,11414,11447,8
Task 11415,Job 0,6,4,4,10,1,10,16,6,4,1,0,11415,11448,11
Task 11415,Job 1,11,10,2,12,0,13,23,10,2,4,1,11415,11448,6
Task 11416,Job 0,1,4,3,6,1,4,7,3,3,1,0,11416,11449,20
Task 11416,Job 1,6,4,1,9,0,7,15,8,1,3,0,11416,11449,2
Task 11417,Job 0,5,9,2,10,0,7,15,8,2,1,0,11417,11450,7
Task 11417,Job 1,10,8,3,9,0,13,19,6,3,4,2,11417,11450,17
Task 11418,Job 0,9,4,1,6,0,10,15,5,1,2,1,11418,11452,8
Task 11418,Job 1,14,9,4,6,0,18,20,2,4,3,1,11418,11452,16
Task 11419,Job 0,8,6,1,7,0,9,15,6,1,3,0,11419,11452,13
Task 11419,Job 1,13,8,2,6,0,15,19,4,2,1,0,11419,11452,10
Task 11420,Job 0,8,9,3,8,1,11,16,5,3,3,1,11420,11453,3
Task 11420,Job 1,13,10,1,12,0,14,25,11,1,1,0,11420,11453,6
Task 11421,Job 0,8,8,4,12,0,12,20,8,4,2,2,11421,11455,15
Task 11421,Job 1,13,9,4,10,0,17,23,6,4,3,0,11421,11455,7
Task 11422,Job 0,1,9,4,7,0,5,8,3,4,1,1,11422,11456,13
Task 11422,Job 1,6,6,2,6,0,8,12,4,2,2,0,11422,11456,12
Task 11423,Job 0,7,6,2,10,0,9,17,8,2,2,0,11423,11456,20
Task 11423,Job 1,12,10,4,11,0,16,23,7,4,3,2,11423,11456,17
Task 11424,Job 0,4,5,3,8,1,7,12,5,3,3,2,11424,11457,3
Task 11424,Job 1,9,9,1,10,0,10,19,9,1,2,0,11424,11457,11
Task 11425,Job 0,10,4,3,7,0,13,17,4,3,2,0,11425,11458,15
Task 11425,Job 1,15,6,3,7,0,18,22,4,3,1,1,11425,11458,12
Task 11426,Job 0,1,4,4,6,0,5,7,2,4,4,1,11426,11459,18
Task 11426,Job 1,6,10,4,11,1,10,17,7,4,1,1,11426,11459,13
Task 11427,Job 0,6,8,4,11,0,10,17,7,4,3,1,11427,11460,13
Task 11427,Job 1,11,6,1,12,0,12,23,11,1,2,2,11427,11460,13
Task 11428,Job 0,3,4,2,10,0,5,13,8,2,4,1,11428,11461,17
Task 11428,Job 1,8,9,1,11,0,9,19,10,1,1,0,11428,11461,19
Task 11429,Job 0,3,7,1,9,0,4,12,8,1,2,2,11429,11463,14
Task 11429,Job 1,8,5,2,12,0,10,20,10,2,2,1,11429,11463,15
Task 11430,Job 0,8,5,4,7,0,12,15,3,4,1,0,11430,11463,7
Task 11430,Job 1,13,10,2,7,0,15,20,5,2,1,1,11430,11463,18
Task 11431,Job 0,1,4,3,6,0,4,7,3,3,3,1,11431,11464,11
Task 11431,Job 1,6,10,3,9,1,9,15,6,3,4,0,11431,11464,20
Task 11432,Job 0,6,7,1,11,0,7,17,10,1,2,0,11432,11466,19
Task 11432,Job 1,11,4,3,6,1,14,17,3,3,4,2,11432,11466,7
Task 11433,Job 0,9,7,4,7,0,13,16,3,4,4,0,11433,11466,12
Task 11433,Job 1,14,6,1,6,1,15,20,5,1,3,2,11433,11466,20
Task 11434,Job 0,2,9,2,7,0,4,9,5,2,2,0,11434,11467,10
Task 11434,Job 1,7,7,3,10,0,10,17,7,3,1,1,11434,11467,12
Task 11435,Job 0,10,9,3,11,0,13,21,8,3,3,1,11435,11469,13
Task 11435,Job 1,15,8,4,8,0,19,23,4,4,2,0,11435,11469,7
Task 11436,Job 0,2,7,2,8,0,4,10,6,2,4,2,11436,11470,3
Task 11436,Job 1,7,7,1,11,0,8,18,10,1,3,1,11436,11470,16
Task 11437,Job 0,5,4,4,10,0,9,15,6,4,1,0,11437,11471,8
Task 11437,Job 1,10,9,4,8,0,14,18,4,4,4,0,11437,11471,20
Task 11438,Job 0,8,9,2,11,0,10,19,9,2,4,1,11438,11471,14
Task 11438,Job 1,13,10,2,7,0,15,20,5,2,2,1,11438,11471,6
Task 11439,Job 0,7,5,4,10,0,11,17,6,4,2,2,11439,11472,9
Task 11439,Job 1,12,7,4,12,0,16,24,8,4,1,1,11439,11472,4
Task 11440,Job 0,3,6,4,8,0,7,11,4,4,2,0,11440,11473,7
Task 11440,Job 1,8,5,2,8,1,10,16,6,2,2,1,11440,11473,19
Task 11441,Job 0,9,6,4,9,1,13,18,5,4,1,1,11441,11474,6
Task 11441,Job 1,14,7,3,12,0,17,26,9,3,3,1,11441,11474,7
Task 11442,Job 0,1,9,1,10,0,2,11,9,1,3,2,11442,11476,10
Task 11442,Job 1,6,7,1,12,0,7,18,11,1,4,2,11442,11476,13
Task 11443,Job 0,7,9,4,11,0,11,18,7,4,3,0,11443,11476,20
Task 11443,Job 1,12,8,3,8,1,15,20,5,3,3,2,11443,11476,11
Task 11444,Job 0,10,7,3,10,1,13,20,7,3,4,0,11444,11477,18
Task 11444,Job 1,15,10,2,11,0,17,26,9,2,3,1,11444,11477,18
Task 11445,Job 0,3,6,4,6,1,7,9,2,4,2,1,11445,11478,8
Task 11445,Job 1,8,9,4,9,0,12,17,5,4,4,0,11445,11478,11
Task 11446,Job 0,6,4,1,7,0,7,13,6,1,4,0,11446,11480,16
Task 11446,Job 1,11,4,2,8,0,13,19,6,2,4,1,11446,11480,18
Task 11447,Job 0,9,5,4,6,0,13,15,2,4,2,0,11447,11481,4
Task 11447,Job 1,14,4,2,10,0,16,24,8,2,3,1,11447,11481,7
Task 11448,Job 0,4,5,3,8,0,7,12,5,3,4,1,11448,11482,10
Task 11448,Job 1,9,7,2,10,1,11,19,8,2,2,0,11448,11482,5
Task 11449,Job 0,3,4,4,7,0,7,10,3,4,3,0,11449,11483,6
Task 11449,Job 1,8,9,2,8,0,10,16,6,2,2,2,11449,11483,18
Task 11450,Job 0,2,4,4,12,0,6,14,8,4,3,2,11450,11483,19
Task 11450,Job 1,7,6,4,7,1,11,14,3,4,2,2,11450,11483,20
Task 11451,Job 0,3,8,1,11,0,4,14,10,1,2,1,11451,11485,5
Task 11451,Job 1,8,7,2,10,0,10,18,8,2,4,1,11451,11485,18
Task 11452,Job 0,8,5,3,12,0,11,20,9,3,3,1,11452,11485,16
Task 11452,Job 1,13,9,1,11,0,14,24,10,1,1,1,11452,11485,16
Task 11453,Job 0,3,8,4,10,0,7,13,6,4,1,2,11453,11486,8
Task 11453,Job 1,8,7,3,11,0,11,19,8,3,1,0,11453,11486,11
Task 11454,Job 0,1,4,3,7,0,4,8,4,3,2,1,11454,11487,12
Task 11454,Job 1,6,9,1,10,1,7,16,9,1,4,1,11454,11487,17
Task 11455,Job 0,6,6,2,10,0,8,16,8,2,1,2,11455,11488,11
Task 11455,Job 1,11,10,2,7,1,13,18,5,2,3,0,11455,11488,2
Task 11456,Job 0,5,6,4,9,1,9,14,5,4,4,2,11456,11490,16
Task 11456,Job 1,10,5,4,12,1,14,22,8,4,4,2,11456,11490,8
Task 11457,Job 0,5,6,1,11,0,6,16,10,1,2,2,11457,11490,9
Task 11457,Job 1,10,7,1,7,0,11,17,6,1,2,1,11457,11490,18
Task 11458,Job 0,8,6,2,6,1,10,14,4,2,1,0,11458,11492,5
Task 11458,Job 1,13,5,4,7,1,17,20,3,4,2,2,11458,11492,8
Task 11459,Job 0,2,4,4,6,1,6,8,2,4,1,1,11459,11493,16
Task 11459,Job 1,7,7,4,7,0,11,14,3,4,4,1,11459,11493,3
Task 11460,Job 0,2,4,4,8,1,6,10,4,4,2,0,11460,11494,14
Task 11460,Job 1,7,7,1,7,0,8,14,6,1,3,1,11460,11494,7
Task 11461,Job 0,8,8,3,6,0,11,14,3,3,2,1,11461,11495,10
Task 11461,Job 1,13,8,4,6,0,17,19,2,4,2,2,11461,11495,18
Task 11462,Job 0,1,5,2,9,0,3,10,7,2,3,0,11462,11496,6
Task 11462,Job 1,6,6,1,9,0,7,15,8,1,1,0,11462,11496,18
Task 11463,Job 0,2,8,1,10,0,3,12,9,1,2,1,11463,11496,3
Task 11463,Job 1,7,9,2,9,0,9,16,7,2,1,0,11463,11496,4
Task 11464,Job 0,6,4,2,7,1,8,13,5,2,4,1,11464,11497,18
Task 11464,Job 1,11,6,1,11,0,12,22,10,1,2,2,11464,11497,10
Task 11465,Job 0,8,10,3,11,0,11,19,8,3,4,2,11465,11498,2
Task 11465,Job 1,13,8,3,9,0,16,22,6,3,3,0,11465,11498,5
Task 11466,Job 0,1,10,3,6,1,4,7,3,3,4,1,11466,11500,17
Task 11466,Job 1,6,10,3,8,0,9,14,5,3,4,2,11466,11500,11
Task 11467,Job 0,10,6,1,9,0,11,19,8,1,3,0,11467,11501,20
Task 11467,Job 1,15,8,3,6,1,18,21,3,3,1,2,11467,11501,19
Task 11468,Job 0,7,5,3,9,1,10,16,6,3,3,1,11468,11502,13
Task 11468,Job 1,12,7,4,8,1,16,20,4,4,1,0,11468,11502,15
Task 11469,Job 0,3,8,2,6,0,5,9,4,2,3,2,11469,11502,7
Task 11469,Job 1,8,5,3,7,0,11,15,4,3,1,2,11469,11502,11
Task 11470,Job 0,8,10,4,10,0,12,18,6,4,4,0,11470,11503,13
Task 11470,Job 1,13,10,4,11,0,17,24,7,4,1,0,11470,11503,17
Task 11471,Job 0,8,4,1,6,0,9,14,5,1,1,1,11471,11504,18
Task 11471,Job 1,13,4,2,8,0,15,21,6,2,4,0,11471,11504,17
Task 11472,Job 0,6,8,1,10,0,7,16,9,1,1,1,11472,11505,15
Task 11472,Job 1,11,4,2,10,0,13,21,8,2,1,0,11472,11505,17
Task 11473,Job 0,6,5,4,8,0,10,14,4,4,3,2,11473,11506,12
Task 11473,Job 1,11,6,4,10,0,15,21,6,4,2,1,11473,11506,2
Task 11474,Job 0,5,5,4,12,1,9,17,8,4,2,0,11474,11508,6
Task 11474,Job 1,10,8,3,9,0,13,19,6,3,2,1,11474,11508,10
Task 11475,Job 0,4,9,1,7,0,5,11,6,1,3,2,11475,11509,12
Task 11475,Job 1,9,4,3,6,0,12,15,3,3,2,1,11475,11509,18
Task 11476,Job 0,5,4,1,6,0,6,11,5,1,4,1,11476,11509,19
Task 11476,Job 1,10,7,1,12,0,11,22,11,1,1,1,11476,11509,3
Task 11477,Job 0,1,4,1,12,0,2,13,11,1,4,1,11477,11510,13
Task 11477,Job 1,6,5,3,6,0,9,12,3,3,3,1,11477,11510,4
Task 11478,Job 0,7,9,4,6,0,11,13,2,4,1,0,11478,11511,15
Task 11478,Job 1,12,6,4,9,0,16,21,5,4,2,0,11478,11511,4
Task 11479,Job 0,7,4,4,11,1,11,18,7,4,3,2,11479,11513,14
Task 11479,Job 1,12,4,3,12,0,15,24,9,3,4,1,11479,11513,14
Task 11480,Job 0,1,7,4,9,1,5,10,5,4,1,0,11480,11513,18
Task 11480,Job 1,6,10,2,12,0,8,18,10,2,3,1,11480,11513,3
Task 11481,Job 0,4,5,2,7,1,6,11,5,2,2,2,11481,11515,16
Task 11481,Job 1,9,10,4,7,1,13,16,3,4,1,2,11481,11515,3
Task 11482,Job 0,4,5,2,9,1,6,13,7,2,1,1,11482,11516,9
Task 11482,Job 1,9,8,1,11,1,10,20,10,1,2,2,11482,11516,6
Task 11483,Job 0,10,9,4,12,0,14,22,8,4,1,2,11483,11517,20
Task 11483,Job 1,15,9,3,7,0,18,22,4,3,1,0,11483,11517,10
Task 11484,Job 0,9,6,4,10,0,13,19,6,4,1,1,11484,11518,10
Task 11484,Job 1,14,10,3,8,0,17,22,5,3,2,2,11484,11518,3
Task 11485,Job 0,10,8,4,7,1,14,17,3,4,1,1,11485,11518,10
Task 11485,Job 1,15,9,4,8,1,19,23,4,4,3,2,11485,11518,19
Task 11486,Job 0,10,10,1,11,0,11,21,10,1,1,1,11486,11519,19
Task 11486,Job 1,15,9,3,12,1,18,27,9,3,2,1,11486,11519,11
Task 11487,Job 0,1,7,2,12,0,3,13,10,2,2,0,11487,11521,2
Task 11487,Job 1,6,5,2,10,0,8,16,8,2,4,2,11487,11521,2
Task 11488,Job 0,7,9,3,12,0,10,19,9,3,4,1,11488,11522,11
Task 11488,Job 1,12,7,1,10,0,13,22,9,1,4,1,11488,11522,14
Task 11489,Job 0,9,4,2,6,0,11,15,4,2,2,2,11489,11523,19
Task 11489,Job 1,14,10,4,6,0,18,20,2,4,1,1,11489,11523,15
Task 11490,Job 0,8,6,1,12,1,9,20,11,1,2,2,11490,11524,10
Task 11490,Job 1,13,5,2,12,0,15,25,10,2,2,0,11490,11524,7
Task 11491,Job 0,5,9,3,11,0,8,16,8,3,1,0,11491,11525,10
Task 11491,Job 1,10,10,3,8,1,13,18,5,3,4,1,11491,11525,6
Task 11492,Job 0,9,9,4,6,0,13,15,2,4,3,0,11492,11526,14
Task 11492,Job 1,14,7,2,10,1,16,24,8,2,4,2,11492,11526,9
Task 11493,Job 0,6,9,1,10,0,7,16,9,1,4,1,11493,11527,12
Task 11493,Job 1,11,6,4,7,0,15,18,3,4,2,1,11493,11527,4
Task 11494,Job 0,8,10,4,10,0,12,18,6,4,1,1,11494,11528,16
Task 11494,Job 1,13,5,2,10,0,15,23,8,2,1,0,11494,11528,14
Task 11495,Job 0,6,9,3,8,1,9,14,5,3,3,1,11495,11529,10
Task 11495,Job 1,11,9,3,8,0,14,19,5,3,4,2,11495,11529,17
Task 11496,Job 0,5,6,1,12,0,6,17,11,1,3,2,11496,11529,20
Task 11496,Job 1,10,10,4,9,0,14,19,5,4,3,1,11496,11529,12
Task 11497,Job 0,10,4,4,7,0,14,17,3,4,2,2,11497,11531,18
Task 11497,Job 1,15,6,1,12,0,16,27,11,1,1,1,11497,11531,19
Task 11498,Job 0,5,6,4,6,0,9,11,2,4,1,1,11498,11531,13
Task 11498,Job 1,10,10,3,8,0,13,18,5,3,2,1,11498,11531,3
Task 11499,Job 0,8,6,1,12,1,9,20,11,1,1,1,11499,11532,17
Task 11499,Job 1,13,10,2,7,0,15,20,5,2,4,1,11499,11532,14
Task 11500,Job 0,9,4,2,6,0,11,15,4,2,4,0,11500,11534,5
Task 11500,Job 1,14,10,3,7,0,17,21,4,3,2,2,11500,11534,11
Task 11501,Job 0,5,5,4,7,1,9,12,3,4,2,2,11501,11534,14
Task 11501,Job 1,10,4,2,6,0,12,16,4,2,4,2,11501,11534,19
Task 11502,Job 0,3,9,1,10,0,4,13,9,1,4,0,11502,11535,12
Task 11502,Job 1,8,9,3,12,0,11,20,9,3,1,0,11502,11535,3
Task 11503,Job 0,10,5,1,8,0,11,18,7,1,1,0,11503,11536,11
Task 11503,Job 1,15,9,1,8,1,16,23,7,1,4,1,11503,11536,5
Task 11504,Job 0,4,9,3,7,0,7,11,4,3,3,1,11504,11537,20
Task 11504,Job 1,9,6,3,9,1,12,18,6,3,1,0,11504,11537,2
Task 11505,Job 0,6,10,1,9,0,7,15,8,1,1,0,11505,11539,8
Task 11505,Job 1,11,8,1,11,1,12,22,10,1,3,2,11505,11539,2
Task 11506,Job 0,7,8,4,8,0,11,15,4,4,3,1,11506,11540,7
Task 11506,Job 1,12,7,4,7,1,16,19,3,4,3,0,11506,11540,17
Task 11507,Job 0,6,6,4,6,1,10,12,2,4,2,0,11507,11540,7
Task 11507,Job 1,11,6,3,8,0,14,19,5,3,2,2,11507,11540,19
Task 11508,Job 0,8,8,4,6,0,12,14,2,4,2,1,11508,11542,15
Task 11508,Job 1,13,9,3,10,0,16,23,7,3,4,0,11508,11542,6
Task 11509,Job 0,10,8,2,7,0,12,17,5,2,4,2,11509,11542,10
Task 11509,Job 1,15,10,4,9,0,19,24,5,4,4,0,11509,11542,2
Task 11510,Job 0,9,9,4,10,0,13,19,6,4,2,0,11510,11543,4
Task 11510,Job 1,14,5,1,6,1,15,20,5,1,2,1,11510,11543,20
Task 11511,Job 0,2,10,3,10,1,5,12,7,3,3,1,11511,11544,16
Task 11511,Job 1,7,5,3,7,0,10,14,4,3,4,2,11511,11544,17
Task 11512,Job 0,5,6,3,7,0,8,12,4,3,3,2,11512,11546,6
Task 11512,Job 1,10,6,1,6,1,11,16,5,1,1,2,11512,11546,19
Task 11513,Job 0,7,9,4,7,1,11,14,3,4,2,1,11513,11546,4
Task 11513,Job 1,12,10,4,6,0,16,18,2,4,4,2,11513,11546,19
Task 11514,Job 0,10,5,1,6,0,11,16,5,1,2,2,11514,11548,19
Task 11514,Job 1,15,6,2,8,0,17,23,6,2,1,1,11514,11548,2
Task 11515,Job 0,9,9,2,12,0,11,21,10,2,4,0,11515,11548,3
Task 11515,Job 1,14,10,4,6,1,18,20,2,4,3,1,11515,11548,5
Task 11516,Job 0,5,9,3,8,0,8,13,5,3,3,1,11516,11550,20
Task 11516,Job 1,10,10,4,10,0,14,20,6,4,4,2,11516,11550,15
Task 11517,Job 0,6,5,3,6,0,9,12,3,3,1,1,11517,11550,16
Task 11517,Job 1,11,5,3,8,0,14,19,5,3,2,2,11517,11550,6
Task 11518,Job 0,7,10,4,9,1,11,16,5,4,3,1,11518,11551,19
Task 11518,Job 1,12,4,1,9,0,13,21,8,1,4,1,11518,11551,20
Task 11519,Job 0,4,8,1,6,0,5,10,5,1,4,2,11519,11552,14
Task 11519,Job 1,9,8,2,9,0,11,18,7,2,4,1,11519,11552,11
Task 11520,Job 0,8,4,2,11,0,10,19,9,2,2,0,11520,11554,10
Task 11520,Job 1,13,10,4,7,0,17,20,3,4,4,2,11520,11554,10
Task 11521,Job 0,10,9,2,9,1,12,19,7,2,2,2,11521,11555,8
Task 11521,Job 1,15,8,1,7,0,16,22,6,1,3,0,11521,11555,12
Task 11522,Job 0,5,10,3,7,0,8,12,4,3,2,0,11522,11555,15
Task 11522,Job 1,10,4,1,7,0,11,17,6,1,1,1,11522,11555,11
Task 11523,Job 0,7,9,1,11,1,8,18,10,1,2,2,11523,11557,18
Task 11523,Job 1,12,9,1,10,1,13,22,9,1,4,2,11523,11557,3
Task 11524,Job 0,4,9,4,10,0,8,14,6,4,1,1,11524,11557,17
Task 11524,Job 1,9,4,2,6,0,11,15,4,2,2,2,11524,11557,13
Task 11525,Job 0,1,10,3,12,0,4,13,9,3,2,2,11525,11559,7
Task 11525,Job 1,6,6,4,7,0,10,13,3,4,4,2,11525,11559,4
Task 11526,Job 0,3,4,2,10,0,5,13,8,2,4,2,11526,11559,14
Task 11526,Job 1,8,4,4,9,1,12,17,5,4,2,0,11526,11559,18
Task 11527,Job 0,2,8,4,12,1,6,14,8,4,1,0,11527,11560,18
Task 11527,Job 1,7,6,3,8,0,10,15,5,3,4,0,11527,11560,18
Task 11528,Job 0,7,4,3,11,1,10,18,8,3,3,2,11528,11562,5
Task 11528,Job 1,12,9,1,11,1,13,23,10,1,3,1,11528,11562,5
Task 11529,Job 0,6,5,4,6,1,10,12,2,4,4,0,11529,11562,19
Task 11529,Job 1,11,8,4,8,1,15,19,4,4,1,1,11529,11562,13
Task 11530,Job 0,10,4,1,11,0,11,21,10,1,3,2,11530,11564,13
Task 11530,Job 1,15,9,4,11,0,19,26,7,4,4,0,11530,11564,7
Task 11531,Job 0,6,9,2,11,0,8,17,9,2,4,1,11531,11564,5
Task 11531,Job 1,11,8,3,8,0,14,19,5,3,4,2,11531,11564,17
Task 11532,Job 0,5,8,2,7,0,7,12,5,2,4,2,11532,11566,11
Task 11532,Job 1,10,5,3,10,0,13,20,7,3,1,0,11532,11566,6
Task 11533,Job 0,4,10,2,6,0,6,10,4,2,1,1,11533,11567,7
Task 11533,Job 1,9,8,1,12,0,10,21,11,1,1,0,11533,11567,19
Task 11534,Job 0,10,10,3,6,0,13,16,3,3,4,2,11534,11568,10
Task 11534,Job 1,15,6,1,8,0,16,23,7,1,2,1,11534,11568,18
Task 11535,Job 0,3,7,2,7,0,5,10,5,2,3,0,11535,11568,6
Task 11535,Job 1,8,10,1,12,0,9,20,11,1,1,1,11535,11568,2
Task 11536,Job 0,1,5,1,8,0,2,9,7,1,4,0,11536,11570,9
Task 11536,Job 1,6,6,4,9,0,10,15,5,4,1,2,11536,11570,12
Task 11537,Job 0,3,5,1,9,0,4,12,8,1,4,1,11537,11570,17
Task 11537,Job 1,8,8,2,8,0,10,16,6,2,1,1,11537,11570,12
Task 11538,Job 0,2,10,1,8,0,3,10,7,1,1,0,11538,11571,13
Task 11538,Job 1,7,5,1,7,0,8,14,6,1,4,1,11538,11571,6
Task 11539,Job 0,3,4,1,8,1,4,11,7,1,2,0,11539,11573,6
Task 11539,Job 1,8,4,3,6,0,11,14,3,3,3,0,11539,11573,13
Task 11540,Job 0,2,10,3,8,0,5,10,5,3,3,1,11540,11573,14
Task 11540,Job 1,7,7,4,8,0,11,15,4,4,1,0,11540,11573,18
Task 11541,Job 0,4,5,4,8,1,8,12,4,4,4,2,11541,11574,2
Task 11541,Job 1,9,10,3,10,0,12,19,7,3,2,2,11541,11574,13
Task 11542,Job 0,2,7,2,12,0,4,14,10,2,2,0,11542,11575,13
Task 11542,Job 1,7,6,4,11,0,11,18,7,4,4,1,11542,11575,16
Task 11543,Job 0,9,4,3,11,1,12,20,8,3,3,2,11543,11577,16
Task 11543,Job 1,14,7,2,12,0,16,26,10,2,1,2,11543,11577,9
Task 11544,Job 0,5,4,4,7,0,9,12,3,4,3,1,11544,11577,10
Task 11544,Job 1,10,4,2,10,1,12,20,8,2,1,2,11544,11577,4
Task 11545,Job 0,3,6,4,10,0,7,13,6,4,4,1,11545,11579,17
Task 11545,Job 1,8,7,3,12,0,11,20,9,3,1,0,11545,11579,6
Task 11546,Job 0,9,10,3,9,1,12,18,6,3,2,1,11546,11579,3
Task 11546,Job 1,14,6,4,8,0,18,22,4,4,2,2,11546,11579,18
Task 11547,Job 0,5,4,2,7,0,7,12,5,2,1,2,11547,11581,5
Task 11547,Job 1,10,6,1,10,0,11,20,9,1,4,2,11547,11581,12
Task 11548,Job 0,9,10,3,12,0,12,21,9,3,4,1,11548,11582,12
Task 11548,Job 1,14,4,4,7,0,18,21,3,4,1,1,11548,11582,5
Task 11549,Job 0,2,8,2,7,0,4,9,5,2,1,1,11549,11583,17
Task 11549,Job 1,7,7,4,9,1,11,16,5,4,4,2,11549,11583,5
Task 11550,Job 0,8,7,2,11,0,10,19,9,2,3,2,11550,11583,19
Task 11550,Job 1,13,8,4,9,0,17,22,5,4,4,0,11550,11583,4
Task 11551,Job 0,8,4,4,10,0,12,18,6,4,3,1,11551,11584,14
Task 11551,Job 1,13,8,2,8,0,15,21,6,2,4,0,11551,11584,10
Task 11552,Job 0,9,4,2,12,0,11,21,10,2,3,1,11552,11585,8
Task 11552,Job 1,14,8,4,11,0,18,25,7,4,2,1,11552,11585,9
Task 11553,Job 0,8,6,3,9,0,11,17,6,3,1,1,11553,11587,9
Task 11553,Job 1,13,10,3,8,0,16,21,5,3,4,2,11553,11587,10
Task 11554,Job 0,9,4,4,6,1,13,15,2,4,2,2,11554,11587,13
Task 11554,Job 1,14,4,2,9,0,16,23,7,2,4,2,11554,11587,17
Task 11555,Job 0,10,10,1,10,0,11,20,9,1,2,2,11555,11589,18
Task 11555,Job 1,15,5,3,12,0,18,27,9,3,4,0,11555,11589,16
Task 11556,Job 0,1,9,4,10,0,5,11,6,4,1,1,11556,11590,10
Task 11556,Job 1,6,7,3,10,0,9,16,7,3,1,2,11556,11590,13
Task 11557,Job 0,3,5,3,8,0,6,11,5,3,3,0,11557,11591,17
Task 11557,Job 1,8,5,4,6,0,12,14,2,4,4,0,11557,11591,20
Task 11558,Job 0,5,10,2,11,0,7,16,9,2,4,2,11558,11591,10
Task 11558,Job 1,10,9,1,7,0,11,17,6,1,3,1,11558,11591,20
Task 11559,Job 0,2,7,3,11,0,5,13,8,3,4,0,11559,11592,3
Task 11559,Job 1,7,10,3,11,1,10,18,8,3,2,1,11559,11592,9
Task 11560,Job 0,5,4,1,12,0,6,17,11,1,3,0,11560,11593,20
Task 11560,Job 1,10,6,3,10,1,13,20,7,3,3,0,11560,11593,19
Task 11561,Job 0,2,10,3,9,0,5,11,6,3,2,1,11561,11594,8
Task 11561,Job 1,7,8,3,8,0,10,15,5,3,4,0,11561,11594,17
Task 11562,Job 0,6,9,1,6,0,7,12,5,1,2,1,11562,11595,17
Task 11562,Job 1,11,5,2,6,0,13,17,4,2,3,1,11562,11595,20
Task 11563,Job 0,9,4,1,8,0,10,17,7,1,2,0,11563,11596,13
Task 11563,Job 1,14,8,2,9,0,16,23,7,2,3,2,11563,11596,16
Task 11564,Job 0,2,6,4,7,1,6,9,3,4,3,2,11564,11598,16
Task 11564,Job 1,7,6,2,9,0,9,16,7,2,2,1,11564,11598,12
Task 11565,Job 0,3,5,2,6,0,5,9,4,2,3,1,11565,11599,8
Task 11565,Job 1,8,4,3,12,0,11,20,9,3,3,0,11565,11599,14
Task 11566,Job 0,2,8,1,11,0,3,13,10,1,4,0,11566,11599,10
Task 11566,Job 1,7,7,4,7,0,11,14,3,4,1,1,11566,11599,13
Task 11567,Job 0,10,6,2,6,1,12,16,4,2,3,0,11567,11600,15
Task 11567,Job 1,15,6,4,9,0,19,24,5,4,2,0,11567,11600,16
Task 11568,Job 0,7,9,3,11,0,10,18,8,3,4,0,11568,11602,10
Task 11568,Job 1,12,9,4,12,0,16,24,8,4,3,0,11568,11602,10
Task 11569,Job 0,6,7,2,12,1,8,18,10,2,2,2,11569,11603,20
Task 11569,Job 1,11,5,2,10,0,13,21,8,2,3,0,11569,11603,17
Task 11570,Job 0,9,4,2,7,0,11,16,5,2,2,1,11570,11603,16
Task 11570,Job 1,14,6,2,11,0,16,25,9,2,1,2,11570,11603,10
Task 11571,Job 0,10,7,4,9,0,14,19,5,4,2,0,11571,11605,18
Task 11571,Job 1,15,7,1,6,0,16,21,5,1,2,1,11571,11605,18
Task 11572,Job 0,1,8,2,7,1,3,8,5,2,3,0,11572,11605,19
Task 11572,Job 1,6,8,4,8,1,10,14,4,4,3,1,11572,11605,10
Task 11573,Job 0,5,6,2,11,0,7,16,9,2,4,1,11573,11607,5
Task 11573,Job 1,10,9,1,7,0,11,17,6,1,1,1,11573,11607,16
Task 11574,Job 0,6,9,1,8,0,7,14,7,1,3,1,11574,11607,8
Task 11574,Job 1,11,6,1,8,0,12,19,7,1,4,0,11574,11607,14
Task 11575,Job 0,6,7,1,8,0,7,14,7,1,2,1,11575,11608,16
Task 11575,Job 1,11,9,1,7,0,12,18,6,1,4,2,11575,11608,4
Task 11576,Job 0,6,10,2,6,0,8,12,4,2,2,2,11576,11610,5
Task 11576,Job 1,11,4,2,9,0,13,20,7,2,2,0,11576,11610,8
Task 11577,Job 0,6,8,1,12,0,7,18,11,1,3,2,11577,11610,11
Task 11577,Job 1,11,8,2,8,0,13,19,6,2,4,1,11577,11610,6
Task 11578,Job 0,2,8,1,7,0,3,9,6,1,4,0,11578,11612,9
Task 11578,Job 1,7,4,1,11,0,8,18,10,1,1,1,11578,11612,16
Task 11579,Job 0,4,9,3,7,1,7,11,4,3,2,1,11579,11612,11
Task 11579,Job 1,9,5,3,11,0,12,20,8,3,4,0,11579,11612,20
Task 11580,Job 0,9,5,2,10,0,11,19,8,2,1,0,11580,11613,16
Task 11580,Job 1,14,6,2,7,0,16,21,5,2,4,2,11580,11613,6
Task 11581,Job 0,8,6,4,12,0,12,20,8,4,1,1,11581,11614,11
Task 11581,Job 1,13,7,4,8,1,17,21,4,4,3,0,11581,11614,18
Task 11582,Job 0,1,10,4,6,0,5,7,2,4,2,1,11582,11615,17
Task 11582,Job 1,6,4,4,7,0,10,13,3,4,1,2,11582,11615,3
Task 11583,Job 0,3,9,4,12,0,7,15,8,4,2,0,11583,11616,20
Task 11583,Job 1,8,7,4,10,0,12,18,6,4,2,0,11583,11616,4
Task 11584,Job 0,3,10,3,10,0,6,13,7,3,4,1,11584,11618,18
Task 11584,Job 1,8,6,1,7,1,9,15,6,1,2,2,11584,11618,19
Task 11585,Job 0,2,5,4,9,1,6,11,5,4,3,2,11585,11618,19
Task 11585,Job 1,7,5,3,7,1,10,14,4,3,2,1,11585,11618,3
Task 11586,Job 0,1,9,4,11,0,5,12,7,4,4,1,11586,11619,2
Task 11586,Job 1,6,9,2,12,0,8,18,10,2,1,0,11586,11619,20
Task 11587,Job 0,6,7,4,8,0,10,14,4,4,3,1,11587,11621,12
Task 11587,Job 1,11,9,4,6,1,15,17,2,4,3,2,11587,11621,8
Task 11588,Job 0,3,5,4,9,0,7,12,5,4,1,1,11588,11621,5
Task 11588,Job 1,8,10,3,12,0,11,20,9,3,3,1,11588,11621,20
Task 11589,Job 0,6,6,4,9,0,10,15,5,4,1,0,11589,11623,8
Task 11589,Job 1,11,7,4,12,0,15,23,8,4,1,1,11589,11623,4
Task 11590,Job 0,8,6,4,6,0,12,14,2,4,4,0,11590,11623,19
Task 11590,Job 1,13,4,3,11,0,16,24,8,3,2,0,11590,11623,5
Task 11591,Job 0,7,7,1,8,1,8,15,7,1,3,2,11591,11625,19
Task 11591,Job 1,12,6,4,11,0,16,23,7,4,2,0,11591,11625,11
Task 11592,Job 0,10,9,3,6,0,13,16,3,3,2,0,11592,11625,2
Task 11592,Job 1,15,7,2,8,0,17,23,6,2,4,2,11592,11625,14
Task 11593,Job 0,9,6,1,9,0,10,18,8,1,3,2,11593,11627,14
Task 11593,Job 1,14,6,1,6,0,15,20,5,1,3,1,11593,11627,2
Task 11594,Job 0,10,7,1,11,0,11,21,10,1,2,1,11594,11628,4
Task 11594,Job 1,15,10,1,11,0,16,26,10,1,2,0,11594,11628,10
Task 11595,Job 0,10,7,4,10,0,14,20,6,4,3,0,11595,11628,18
Task 11595,Job 1,15,4,2,11,0,17,26,9,2,3,2,11595,11628,13
Task 11596,Job 0,5,10,2,8,0,7,13,6,2,1,0,11596,11629,16
Task 11596,Job 1,10,9,3,9,0,13,19,6,3,4,0,11596,11629,13
Task 11597,Job 0,10,8,2,11,0,12,21,9,2,1,0,11597,11631,14
Task 11597,Job 1,15,4,4,9,0,19,24,5,4,2,2,11597,11631,14
Task 11598,Job 0,10,6,4,9,0,14,19,5,4,1,2,11598,11631,11
Task 11598,Job 1,15,7,4,10,0,19,25,6,4,3,0,11598,11631,4
Task 11599,Job 0,8,5,2,8,0,10,16,6,2,1,1,11599,11632,13
Task 11599,Job 1,13,6,1,6,0,14,19,5,1,2,1,11599,11632,4
Task 11600,Job 0,4,10,2,11,0,6,15,9,2,4,2,11600,11633,12
Task 11600,Job 1,9,4,4,10,0,13,19,6,4,4,0,11600,11633,13
Task 11601,Job 0,9,5,1,6,1,10,15,5,1,1,0,11601,11634,12
Task 11601,Job 1,14,5,4,12,0,18,26,8,4,3,0,11601,11634,12
Task 11602,Job 0,2,6,2,10,0,4,12,8,2,4,2,11602,11636,2
Task 11602,Job 1,7,9,3,8,0,10,15,5,3,3,2,11602,11636,11
Task 11603,Job 0,3,6,1,9,1,4,12,8,1,4,0,11603,11636,13
Task 11603,Job 1,8,7,1,12,1,9,20,11,1,2,2,11603,11636,13
Task 11604,Job 0,8,6,3,10,1,11,18,7,3,4,2,11604,11637,19
Task 11604,Job 1,13,5,3,10,1,16,23,7,3,1,2,11604,11637,19
Task 11605,Job 0,8,10,2,7,1,10,15,5,2,4,1,11605,11638,15
Task 11605,Job 1,13,8,2,10,0,15,23,8,2,4,1,11605,11638,8
Task 11606,Job 0,9,6,3,6,0,12,15,3,3,3,2,11606,11639,16
Task 11606,Job 1,14,10,1,10,0,15,24,9,1,1,1,11606,11639,15
Task 11607,Job 0,10,5,3,8,0,13,18,5,3,2,2,11607,11640,3
Task 11607,Job 1,15,8,4,10,0,19,25,6,4,1,0,11607,11640,10
Task 11608,Job 0,9,8,2,11,1,11,20,9,2,2,0,11608,11641,17
Task 11608,Job 1,14,5,1,10,0,15,24,9,1,2,1,11608,11641,2
Task 11609,Job 0,2,6,3,12,1,5,14,9,3,1,1,11609,11643,8
Task 11609,Job 1,7,4,1,7,0,8,14,6,1,1,1,11609,11643,19
Task 11610,Job 0,7,4,2,6,0,9,13,4,2,1,1,11610,11643,13
Task 11610,Job 1,12,4,2,12,0,14,24,10,2,1,0,11610,11643,7
Task 11611,Job 0,10,6,2,7,0,12,17,5,2,3,2,11611,11644,3
Task 11611,Job 1,15,7,4,7,0,19,22,3,4,4,0,11611,11644,20
Task 11612,Job 0,6,10,3,9,0,9,15,6,3,3,2,11612,11646,11
Task 11612,Job 1,11,6,3,8,0,14,19,5,3,1,2,11612,11646,14
Task 11613,Job 0,10,5,4,10,0,14,20,6,4,1,0,11613,11646,18
Task 11613,Job 1,15,8,4,7,1,19,22,3,4,1,0,11613,11646,17
Task 11614,Job 0,8,4,2,10,0,10,18,8,2,3,0,11614,11648,12
Task 11614,Job 1,13,4,3,6,0,16,19,3,3,1,0,11614,11648,6
Task 11615,Job 0,8,10,2,6,0,10,14,4,2,1,0,11615,11649,17
Task 11615,Job 1,13,5,4,7,0,17,20,3,4,4,2,11615,11649,13
Task 11616,Job 0,4,9,1,9,1,5,13,8,1,3,2,11616,11650,2
Task 11616,Job 1,9,7,4,6,0,13,15,2,4,2,1,11616,11650,4
Task 11617,Job 0,10,6,2,11,0,12,21,9,2,2,0,11617,11650,7
Task 11617,Job 1,15,10,4,8,0,19,23,4,4,3,1,11617,11650,8
Task 11618,Job 0,5,5,3,6,0,8,11,3,3,4,2,11618,11652,18
Task 11618,Job 1,10,9,3,10,0,13,20,7,3,3,0,11618,11652,17
Task 11619,Job 0,2,10,2,7,1,4,9,5,2,3,2,11619,11653,16
Task 11619,Job 1,7,4,1,9,0,8,16,8,1,1,2,11619,11653,16
Task 11620,Job 0,9,7,3,9,0,12,18,6,3,3,0,11620,11653,19
Task 11620,Job 1,14,9,4,10,0,18,24,6,4,3,1,11620,11653,7
Task 11621,Job 0,10,7,1,8,0,11,18,7,1,4,0,11621,11654,7
Task 11621,Job 1,15,9,1,11,0,16,26,10,1,2,2,11621,11654,3
Task 11622,Job 0,2,8,1,6,1,3,8,5,1,4,2,11622,11656,9
Task 11622,Job 1,7,5,2,7,1,9,14,5,2,3,2,11622,11656,11
Task 11623,Job 0,1,9,2,12,1,3,13,10,2,2,0,11623,11656,16
Task 11623,Job 1,6,9,3,6,0,9,12,3,3,2,2,11623,11656,10
Task 11624,Job 0,8,7,3,7,0,11,15,4,3,3,0,11624,11658,17
Task 11624,Job 1,13,5,2,7,0,15,20,5,2,4,0,11624,11658,16
Task 11625,Job 0,10,5,3,12,0,13,22,9,3,1,1,11625,11658,5
Task 11625,Job 1,15,4,2,9,0,17,24,7,2,1,1,11625,11658,12
Task 11626,Job 0,6,7,1,10,0,7,16,9,1,1,0,11626,11659,7
Task 11626,Job 1,11,5,2,10,0,13,21,8,2,4,1,11626,11659,20
Task 11627,Job 0,5,10,4,7,1,9,12,3,4,4,1,11627,11660,5
Task 11627,Job 1,10,9,4,9,0,14,19,5,4,2,1,11627,11660,19
Task 11628,Job 0,5,8,3,12,1,8,17,9,3,2,2,11628,11661,10
Task 11628,Job 1,10,4,4,9,0,14,19,5,4,1,2,11628,11661,3
Task 11629,Job 0,1,9,1,8,1,2,9,7,1,4,1,11629,11663,18
Task 11629,Job 1,6,8,4,9,0,10,15,5,4,1,1,11629,11663,10
Task 11630,Job 0,5,9,3,6,0,8,11,3,3,2,2,11630,11664,16
Task 11630,Job 1,10,9,4,6,0,14,16,2,4,1,0,11630,11664,13
Task 11631,Job 0,5,8,4,11,0,9,16,7,4,3,1,11631,11664,7
Task 11631,Job 1,10,7,1,10,1,11,20,9,1,4,2,11631,11664,20
Task 11632,Job 0,9,9,4,11,0,13,20,7,4,2,0,11632,11666,13
Task 11632,Job 1,14,9,1,8,0,15,22,7,1,3,1,11632,11666,8
Task 11633,Job 0,5,6,2,6,1,7,11,4,2,2,0,11633,11666,4
Task 11633,Job 1,10,6,1,9,1,11,19,8,1,4,2,11633,11666,3
Task 11634,Job 0,2,5,4,6,0,6,8,2,4,3,2,11634,11667,13
Task 11634,Job 1,7,9,3,9,0,10,16,6,3,2,2,11634,11667,5
Task 11635,Job 0,7,10,2,6,1,9,13,4,2,4,1,11635,11668,19
Task 11635,Job 1,12,7,4,7,1,16,19,3,4,4,1,11635,11668,14
Task 11636,Job 0,1,6,1,10,0,2,11,9,1,3,0,11636,11669,4
Task 11636,Job 1,6,7,2,10,1,8,16,8,2,3,1,11636,11669,11
Task 11637,Job 0,9,6,3,10,0,12,19,7,3,4,0,11637,11671,12
Task 11637,Job 1,14,10,2,12,0,16,26,10,2,1,2,11637,11671,5
Task 11638,Job 0,7,7,2,9,0,9,16,7,2,2,0,11638,11672,13
Task 11638,Job 1,12,10,1,6,0,13,18,5,1,4,1,11638,11672,12
Task 11639,Job 0,6,5,4,11,0,10,17,7,4,1,0,11639,11673,16
Task 11639,Job 1,11,5,2,6,0,13,17,4,2,2,0,11639,11673,6
Task 11640,Job 0,1,10,4,12,0,5,13,8,4,1,0,11640,11674,14
Task 11640,Job 1,6,6,3,6,0,9,12,3,3,2,1,11640,11674,12
Task 11641,Job 0,1,7,1,8,1,2,9,7,1,4,1,11641,11674,12
Task 11641,Job 1,6,4,2,12,0,8,18,10,2,2,0,11641,11674,9
Task 11642,Job 0,1,9,4,7,0,5,8,3,4,3,1,11642,11675,9
Task 11642,Job 1,6,7,3,6,0,9,12,3,3,2,0,11642,11675,6
Task 11643,Job 0,3,10,3,12,0,6,15,9,3,2,1,11643,11676,4
Task 11643,Job 1,8,8,4,9,1,12,17,5,4,3,1,11643,11676,10
Task 11644,Job 0,9,8,3,8,1,12,17,5,3,2,1,11644,11678,4
Task 11644,Job 1,14,4,3,7,1,17,21,4,3,3,1,11644,11678,17
Task 11645,Job 0,6,7,4,12,0,10,18,8,4,3,0,11645,11679,12
Task 11645,Job 1,11,7,2,9,0,13,20,7,2,1,1,11645,11679,10
Task 11646,Job 0,5,5,1,6,0,6,11,5,1,4,2,11646,11680,5
Task 11646,Job 1,10,7,4,12,1,14,22,8,4,4,1,11646,11680,10
Task 11647,Job 0,1,10,3,9,0,4,10,6,3,1,0,11647,11681,13
Task 11647,Job 1,6,8,3,9,0,9,15,6,3,1,2,11647,11681,14
Task 11648,Job 0,2,6,3,12,0,5,14,9,3,1,0,11648,11682,16
Task 11648,Job 1,7,7,2,9,0,9,16,7,2,2,1,11648,11682,11
Task 11649,Job 0,6,8,1,7,0,7,13,6,1,4,2,11649,11682,16
Task 11649,Job 1,11,6,2,6,0,13,17,4,2,3,1,11649,11682,15
Task 11650,Job 0,7,4,2,9,0,9,16,7,2,2,2,11650,11683,10
Task 11650,Job 1,12,4,4,7,0,16,19,3,4,2,2,11650,11683,16
Task 11651,Job 0,3,9,2,8,0,5,11,6,2,2,1,11651,11685,5
Task 11651,Job 1,8,10,4,6,0,12,14,2,4,1,0,11651,11685,13
Task 11652,Job 0,2,4,4,10,0,6,12,6,4,3,0,11652,11686,20
Task 11652,Job 1,7,8,2,6,0,9,13,4,2,1,0,11652,11686,13
Task 11653,Job 0,1,6,4,11,1,5,12,7,4,2,0,11653,11687,3
Task 11653,Job 1,6,10,2,10,1,8,16,8,2,1,2,11653,11687,12
Task 11654,Job 0,7,4,2,9,1,9,16,7,2,4,1,11654,11688,13
Task 11654,Job 1,12,8,1,11,0,13,23,10,1,3,0,11654,11688,9
Task 11655,Job 0,5,9,2,8,0,7,13,6,2,4,2,11655,11689,18
Task 11655,Job 1,10,5,4,10,1,14,20,6,4,2,0,11655,11689,4
Task 11656,Job 0,6,7,1,8,0,7,14,7,1,4,2,11656,11689,16
Task 11656,Job 1,11,9,4,7,0,15,18,3,4,2,0,11656,11689,11
Task 11657,Job 0,7,9,4,9,0,11,16,5,4,1,2,11657,11690,5
Task 11657,Job 1,12,6,2,9,0,14,21,7,2,1,2,11657,11690,9
Task 11658,Job 0,3,6,2,8,0,5,11,6,2,1,0,11658,11691,17
Task 11658,Job 1,8,10,4,9,1,12,17,5,4,4,0,11658,11691,10
Task 11659,Job 0,6,9,2,6,0,8,12,4,2,4,0,11659,11692,19
Task 11659,Job 1,11,8,3,10,0,14,21,7,3,3,1,11659,11692,15
Task 11660,Job 0,2,9,4,8,0,6,10,4,4,4,2,11660,11693,9
Task 11660,Job 1,7,5,4,8,0,11,15,4,4,3,0,11660,11693,10
Task 11661,Job 0,6,8,2,11,0,8,17,9,2,4,1,11661,11694,14
Task 11661,Job 1,11,9,4,9,0,15,20,5,4,4,2,11661,11694,11
Task 11662,Job 0,9,7,2,10,0,11,19,8,2,4,0,11662,11695,15
Task 11662,Job 1,14,7,2,9,0,16,23,7,2,2,1,11662,11695,3
Task 11663,Job 0,10,9,1,12,0,11,22,11,1,3,2,11663,11697,2
Task 11663,Job 1,15,5,3,6,0,18,21,3,3,4,2,11663,11697,4
Task 11664,Job 0,3,9,4,6,0,7,9,2,4,2,2,11664,11698,7
Task 11664,Job 1,8,7,4,6,0,12,14,2,4,4,2,11664,11698,19
Task 11665,Job 0,7,10,4,7,0,11,14,3,4,4,0,11665,11699,12
Task 11665,Job 1,12,6,1,8,0,13,20,7,1,1,1,11665,11699,16
Task 11666,Job 0,10,7,1,12,0,11,22,11,1,1,0,11666,11699,14
Task 11666,Job 1,15,9,3,6,0,18,21,3,3,3,1,11666,11699,5
Task 11667,Job 0,4,7,1,8,0,5,12,7,1,4,1,11667,11701,4
Task 11667,Job 1,9,5,3,7,1,12,16,4,3,2,0,11667,11701,13
Task 11668,Job 0,10,9,4,7,0,14,17,3,4,4,2,11668,11702,7
Task 11668,Job 1,15,9,4,6,1,19,21,2,4,3,0,11668,11702,20
Task 11669,Job 0,5,9,2,12,0,7,17,10,2,1,1,11669,11703,7
Task 11669,Job 1,10,7,1,6,1,11,16,5,1,4,1,11669,11703,12
Task 11670,Job 0,1,10,4,11,0,5,12,7,4,2,1,11670,11704,19
Task 11670,Job 1,6,10,1,9,0,7,15,8,1,3,1,11670,11704,5
Task 11671,Job 0,1,9,3,10,0,4,11,7,3,3,2,11671,11704,2
Task 11671,Job 1,6,9,2,10,0,8,16,8,2,2,0,11671,11704,13
Task 11672,Job 0,7,4,2,11,0,9,18,9,2,3,2,11672,11706,19
Task 11672,Job 1,12,4,3,9,0,15,21,6,3,4,1,11672,11706,20
Task 11673,Job 0,7,4,4,10,0,11,17,6,4,4,1,11673,11707,9
Task 11673,Job 1,12,4,1,9,0,13,21,8,1,2,0,11673,11707,10
Task 11674,Job 0,1,5,1,9,0,2,10,8,1,4,0,11674,11707,3
Task 11674,Job 1,6,9,1,10,1,7,16,9,1,2,0,11674,11707,3
Task 11675,Job 0,6,10,4,8,0,10,14,4,4,4,2,11675,11709,6
Task 11675,Job 1,11,6,1,10,0,12,21,9,1,3,1,11675,11709,15
Task 11676,Job 0,1,7,3,8,0,4,9,5,3,1,0,11676,11709,5
Task 11676,Job 1,6,7,3,10,0,9,16,7,3,1,1,11676,11709,3
Task 11677,Job 0,8,5,4,8,0,12,16,4,4,2,1,11677,11711,20
Task 11677,Job 1,13,9,3,11,1,16,24,8,3,3,2,11677,11711,9
Task 11678,Job 0,3,5,3,9,1,6,12,6,3,2,1,11678,11712,18
Task 11678,Job 1,8,7,4,10,0,12,18,6,4,3,0,11678,11712,5
Task 11679,Job 0,2,8,3,8,0,5,10,5,3,4,1,11679,11712,12
Task 11679,Job 1,7,8,3,10,1,10,17,7,3,3,1,11679,11712,19
Task 11680,Job 0,2,9,3,7,1,5,9,4,3,4,0,11680,11714,15
Task 11680,Job 1,7,10,3,8,0,10,15,5,3,3,2,11680,11714,19
Task 11681,Job 0,8,8,3,8,0,11,16,5,3,4,1,11681,11715,12
Task 11681,Job 1,13,10,4,11,1,17,24,7,4,2,1,11681,11715,7
Task 11682,Job 0,8,5,4,6,0,12,14,2,4,1,2,11682,11716,19
Task 11682,Job 1,13,7,2,12,0,15,25,10,2,1,1,11682,11716,11
Task 11683,Job 0,1,7,4,6,0,5,7,2,4,2,1,11683,11717,11
Task 11683,Job 1,6,9,1,12,1,7,18,11,1,4,0,11683,11717,10
Task 11684,Job 0,3,7,1,7,0,4,10,6,1,4,2,11684,11717,7
Task 11684,Job 1,8,5,3,12,1,11,20,9,3,1,2,11684,11717,7
Task 11685,Job 0,1,5,2,6,0,3,7,4,2,2,1,11685,11719,3
Task 11685,Job 1,6,5,1,6,0,7,12,5,1,1,0,11685,11719,14
Task 11686,Job 0,6,9,4,6,0,10,12,2,4,4,0,11686,11720,17
Task 11686,Job 1,11,5,2,12,0,13,23,10,2,3,1,11686,11720,15
Task 11687,Job 0,6,5,4,7,0,10,13,3,4,2,2,11687,11721,7
Task 11687,Job 1,11,6,3,10,0,14,21,7,3,1,0,11687,11721,9
Task 11688,Job 0,10,10,2,11,1,12,21,9,2,3,0,11688,11722,19
Task 11688,Job 1,15,6,1,6,0,16,21,5,1,4,0,11688,11722,8
Task 11689,Job 0,7,10,2,6,0,9,13,4,2,2,1,11689,11723,4
Task 11689,Job 1,12,9,3,9,0,15,21,6,3,1,1,11689,11723,7
Task 11690,Job 0,4,9,4,8,1,8,12,4,4,3,2,11690,11724,10
Task 11690,Job 1,9,7,1,7,1,10,16,6,1,1,0,11690,11724,6
Task 11691,Job 0,1,5,1,9,0,2,10,8,1,4,1,11691,11725,8
Task 11691,Job 1,6,6,4,9,0,10,15,5,4,1,2,11691,11725,3
Task 11692,Job 0,4,10,3,8,1,7,12,5,3,3,2,11692,11726,4
Task 11692,Job 1,9,5,4,12,0,13,21,8,4,4,0,11692,11726,6
Task 11693,Job 0,10,9,1,8,0,11,18,7,1,1,0,11693,11726,15
Task 11693,Job 1,15,10,3,11,0,18,26,8,3,4,1,11693,11726,11
Task 11694,Job 0,4,10,2,9,0,6,13,7,2,3,2,11694,11727,14
Task 11694,Job 1,9,7,4,9,0,13,18,5,4,1,2,11694,11727,3
Task 11695,Job 0,5,9,1,7,0,6,12,6,1,3,2,11695,11729,17
Task 11695,Job 1,10,9,2,12,0,12,22,10,2,2,2,11695,11729,6
Task 11696,Job 0,3,6,4,9,0,7,12,5,4,1,1,11696,11729,12
Task 11696,Job 1,8,8,4,7,0,12,15,3,4,2,1,11696,11729,8
Task 11697,Job 0,8,8,2,12,0,10,20,10,2,1,2,11697,11730,11
Task 11697,Job 1,13,9,2,12,0,15,25,10,2,2,1,11697,11730,10
Task 11698,Job 0,9,10,2,9,0,11,18,7,2,2,2,11698,11731,2
Task 11698,Job 1,14,6,1,12,0,15,26,11,1,2,2,11698,11731,7
Task 11699,Job 0,4,4,3,6,1,7,10,3,3,3,1,11699,11732,7
Task 11699,Job 1,9,4,2,12,0,11,21,10,2,3,2,11699,11732,14
Task 11700,Job 0,1,5,2,9,0,3,10,7,2,2,1,11700,11734,18
Task 11700,Job 1,6,6,3,9,0,9,15,6,3,1,0,11700,11734,5
Task 11701,Job 0,4,4,2,11,0,6,15,9,2,3,1,11701,11735,16
Task 11701,Job 1,9,9,1,9,0,10,18,8,1,4,1,11701,11735,13
Task 11702,Job 0,10,10,2,9,1,12,19,7,2,3,2,11702,11735,3
Task 11702,Job 1,15,6,2,12,0,17,27,10,2,4,1,11702,11735,20
Task 11703,Job 0,6,6,4,8,0,10,14,4,4,1,0,11703,11736,16
Task 11703,Job 1,11,9,4,7,0,15,18,3,4,1,1,11703,11736,13
Task 11704,Job 0,6,8,3,7,0,9,13,4,3,1,1,11704,11738,12
Task 11704,Job 1,11,5,1,11,0,12,22,10,1,1,0,11704,11738,15
Task 11705,Job 0,3,4,1,8,0,4,11,7,1,1,0,11705,11739,18
Task 11705,Job 1,8,7,4,11,1,12,19,7,4,2,1,11705,11739,11
Task 11706,Job 0,8,10,2,6,1,10,14,4,2,1,0,11706,11739,16
Task 11706,Job 1,13,8,2,11,0,15,24,9,2,2,2,11706,11739,7
Task 11707,Job 0,4,4,2,9,1,6,13,7,2,1,1,11707,11740,18
Task 11707,Job 1,9,7,4,10,1,13,19,6,4,3,1,11707,11740,12
Task 11708,Job 0,5,4,3,6,0,8,11,3,3,1,2,11708,11742,18
Task 11708,Job 1,10,5,3,10,0,13,20,7,3,2,0,11708,11742,13
Task 11709,Job 0,3,9,1,12,0,4,15,11,1,2,2,11709,11743,15
Task 11709,Job 1,8,5,4,8,1,12,16,4,4,3,1,11709,11743,7
Task 11710,Job 0,5,10,1,12,0,6,17,11,1,3,0,11710,11743,7
Task 11710,Job 1,10,4,4,6,0,14,16,2,4,4,2,11710,11743,8
Task 11711,Job 0,7,7,2,9,1,9,16,7,2,1,1,11711,11744,14
Task 11711,Job 1,12,8,4,7,0,16,19,3,4,4,1,11711,11744,19
Task 11712,Job 0,2,4,3,11,1,5,13,8,3,4,1,11712,11746,5
Task 11712,Job 1,7,8,2,9,0,9,16,7,2,3,2,11712,11746,11
Task 11713,Job 0,8,5,1,6,0,9,14,5,1,1,0,11713,11746,20
Task 11713,Job 1,13,7,2,10,0,15,23,8,2,1,2,11713,11746,20
Task 11714,Job 0,7,6,1,6,1,8,13,5,1,2,1,11714,11748,7
Task 11714,Job 1,12,4,3,8,0,15,20,5,3,2,1,11714,11748,12
Task 11715,Job 0,6,10,2,8,1,8,14,6,2,3,1,11715,11749,13
Task 11715,Job 1,11,8,1,7,0,12,18,6,1,2,2,11715,11749,5
Task 11716,Job 0,7,5,2,11,0,9,18,9,2,4,0,11716,11750,9
Task 11716,Job 1,12,4,3,8,0,15,20,5,3,3,2,11716,11750,11
Task 11717,Job 0,9,7,4,6,0,13,15,2,4,3,0,11717,11750,15
Task 11717,Job 1,14,5,1,10,0,15,24,9,1,2,0,11717,11750,2
Task 11718,Job 0,10,4,2,10,0,12,20,8,2,2,1,11718,11752,3
Task 11718,Job 1,15,8,3,10,1,18,25,7,3,1,2,11718,11752,17
Task 11719,Job 0,4,8,4,7,1,8,11,3,4,3,2,11719,11752,6
Task 11719,Job 1,9,5,2,10,0,11,19,8,2,2,1,11719,11752,18
Task 11720,Job 0,4,9,3,11,0,7,15,8,3,2,0,11720,11753,3
Task 11720,Job 1,9,10,1,8,0,10,17,7,1,1,0,11720,11753,13
Task 11721,Job 0,1,5,4,10,0,5,11,6,4,1,2,11721,11754,3
Task 11721,Job 1,6,5,2,12,1,8,18,10,2,3,1,11721,11754,20
Task 11722,Job 0,1,7,2,8,1,3,9,6,2,1,0,11722,11756,2
Task 11722,Job 1,6,8,4,10,0,10,16,6,4,4,0,11722,11756,18
Task 11723,Job 0,2,6,4,6,0,6,8,2,4,3,1,11723,11757,7
Task 11723,Job 1,7,6,3,7,1,10,14,4,3,1,2,11723,11757,17
Task 11724,Job 0,6,9,3,12,0,9,18,9,3,2,0,11724,11758,10
Task 11724,Job 1,11,9,4,11,0,15,22,7,4,2,1,11724,11758,8
Task 11725,Job 0,6,8,1,12,0,7,18,11,1,4,1,11725,11758,18
Task 11725,Job 1,11,5,3,7,1,14,18,4,3,1,0,11725,11758,3
Task 11726,Job 0,1,7,1,11,0,2,12,10,1,1,1,11726,11760,18
Task 11726,Job 1,6,4,2,10,1,8,16,8,2,4,1,11726,11760,12
Task 11727,Job 0,10,8,1,7,0,11,17,6,1,1,1,11727,11760,3
Task 11727,Job 1,15,4,2,10,0,17,25,8,2,1,1,11727,11760,15
Task 11728,Job 0,9,8,1,8,0,10,17,7,1,4,2,11728,11762,4
Task 11728,Job 1,14,9,2,7,0,16,21,5,2,1,2,11728,11762,10
Task 11729,Job 0,5,4,3,9,0,8,14,6,3,3,0,11729,11762,20
Task 11729,Job 1,10,6,4,7,1,14,17,3,4,3,1,11729,11762,9
Task 11730,Job 0,7,10,4,9,0,11,16,5,4,3,2,11730,11763,11
Task 11730,Job 1,12,10,4,9,1,16,21,5,4,3,0,11730,11763,13
Task 11731,Job 0,8,6,1,7,0,9,15,6,1,4,0,11731,11765,9
Task 11731,Job 1,13,8,3,7,1,16,20,4,3,1,2,11731,11765,5
Task 11732,Job 0,8,5,2,11,0,10,19,9,2,2,0,11732,11766,8
Task 11732,Job 1,13,4,2,11,1,15,24,9,2,2,0,11732,11766,8
Task 11733,Job 0,4,10,4,7,0,8,11,3,4,2,2,11733,11766,14
Task 11733,Job 1,9,7,1,12,0,10,21,11,1,4,0,11733,11766,19
Task 11734,Job 0,7,8,2,7,0,9,14,5,2,1,0,11734,11768,6
Task 11734,Job 1,12,8,4,11,0,16,23,7,4,3,2,11734,11768,10
Task 11735,Job 0,5,7,4,12,0,9,17,8,4,2,1,11735,11768,10
Task 11735,Job 1,10,7,2,6,0,12,16,4,2,2,0,11735,11768,10
Task 11736,Job 0,9,9,4,9,0,13,18,5,4,1,0,11736,11770,12
Task 11736,Job 1,14,5,1,11,1,15,25,10,1,3,0,11736,11770,16
Task 11737,Job 0,1,9,2,9,0,3,10,7,2,2,1,11737,11770,19
Task 11737,Job 1,6,8,2,12,0,8,18,10,2,1,1,11737,11770,12
Task 11738,Job 0,3,10,3,8,0,6,11,5,3,4,0,11738,11772,20
Task 11738,Job 1,8,8,1,9,0,9,17,8,1,1,0,11738,11772,4
Task 11739,Job 0,9,9,3,8,1,12,17,5,3,4,1,11739,11772,13
Task 11739,Job 1,14,10,3,8,0,17,22,5,3,4,1,11739,11772,9
Task 11740,Job 0,4,7,4,10,0,8,14,6,4,3,0,11740,11774,16
Task 11740,Job 1,9,10,4,7,0,13,16,3,4,1,1,11740,11774,14
Task 11741,Job 0,10,7,1,7,0,11,17,6,1,1,1,11741,11774,11
Task 11741,Job 1,15,6,4,9,0,19,24,5,4,4,0,11741,11774,11
Task 11742,Job 0,2,6,4,8,0,6,10,4,4,4,0,11742,11775,16
Task 11742,Job 1,7,10,2,11,0,9,18,9,2,1,0,11742,11775,8
Task 11743,Job 0,8,6,4,9,0,12,17,5,4,2,2,11743,11776,5
Task 11743,Job 1,13,9,1,12,1,14,25,11,1,3,0,11743,11776,5
Task 11744,Job 0,3,9,2,11,1,5,14,9,2,1,2,11744,11777,6
Task 11744,Job 1,8,9,4,7,0,12,15,3,4,2,0,11744,11777,19
Task 11745,Job 0,8,10,2,10,0,10,18,8,2,1,2,11745,11778,9
Task 11745,Job 1,13,6,1,11,1,14,24,10,1,2,2,11745,11778,4
Task 11746,Job 0,1,10,4,6,1,5,7,2,4,4,0,11746,11780,20
Task 11746,Job 1,6,8,4,9,0,10,15,5,4,2,1,11746,11780,20
Task 11747,Job 0,4,8,3,10,0,7,14,7,3,4,0,11747,11781,13
Task 11747,Job 1,9,7,3,9,1,12,18,6,3,1,1,11747,11781,5
Task 11748,Job 0,5,10,4,7,0,9,12,3,4,4,2,11748,11781,11
Task 11748,Job 1,10,8,4,12,0,14,22,8,4,4,0,11748,11781,13
Task 11749,Job 0,7,9,3,6,1,10,13,3,3,1,2,11749,11783,16
Task 11749,Job 1,12,6,4,6,0,16,18,2,4,2,0,11749,11783,12
Task 11750,Job 0,9,10,4,10,0,13,19,6,4,1,2,11750,11784,7
Task 11750,Job 1,14,9,4,10,0,18,24,6,4,3,0,11750,11784,15
Task 11751,Job 0,10,5,2,12,0,12,22,10,2,2,0,11751,11785,7
Task 11751,Job 1,15,8,3,8,1,18,23,5,3,3,2,11751,11785,19
Task 11752,Job 0,3,10,3,12,1,6,15,9,3,3,1,11752,11785,6
Task 11752,Job 1,8,4,4,6,1,12,14,2,4,4,0,11752,11785,4
Task 11753,Job 0,7,4,3,7,0,10,14,4,3,4,1,11753,11786,8
Task 11753,Job 1,12,8,3,10,1,15,22,7,3,3,0,11753,11786,7
Task 11754,Job 0,3,5,4,6,1,7,9,2,4,1,1,11754,11787,8
Task 11754,Job 1,8,6,2,10,0,10,18,8,2,1,0,11754,11787,5
Task 11755,Job 0,4,6,4,12,0,8,16,8,4,1,0,11755,11788,12
Task 11755,Job 1,9,7,4,9,0,13,18,5,4,1,1,11755,11788,13
Task 11756,Job 0,6,10,4,12,0,10,18,8,4,2,1,11756,11789,13
Task 11756,Job 1,11,10,3,9,0,14,20,6,3,1,1,11756,11789,8
Task 11757,Job 0,5,4,1,12,0,6,17,11,1,4,2,11757,11791,14
Task 11757,Job 1,10,10,3,9,0,13,19,6,3,2,1,11757,11791,12
Task 11758,Job 0,1,9,4,11,0,5,12,7,4,1,2,11758,11791,20
Task 11758,Job 1,6,7,3,9,0,9,15,6,3,2,2,11758,11791,7
Task 11759,Job 0,3,9,2,11,1,5,14,9,2,1,0,11759,11793,4
Task 11759,Job 1,8,4,2,12,1,10,20,10,2,2,0,11759,11793,18
Task 11760,Job 0,5,5,1,11,0,6,16,10,1,4,0,11760,11793,16
Task 11760,Job 1,10,6,4,11,1,14,21,7,4,3,1,11760,11793,2
Task 11761,Job 0,2,5,4,8,0,6,10,4,4,4,1,11761,11794,13
Task 11761,Job 1,7,6,1,6,1,8,13,5,1,2,1,11761,11794,8
Task 11762,Job 0,8,10,3,7,0,11,15,4,3,2,0,11762,11795,3
Task 11762,Job 1,13,8,3,11,0,16,24,8,3,4,2,11762,11795,3
Task 11763,Job 0,3,5,2,12,0,5,15,10,2,3,1,11763,11797,16
Task 11763,Job 1,8,7,2,6,0,10,14,4,2,1,1,11763,11797,7
Task 11764,Job 0,6,8,1,8,0,7,14,7,1,3,2,11764,11797,15
Task 11764,Job 1,11,5,1,12,0,12,23,11,1,4,1,11764,11797,12
Task 11765,Job 0,2,10,2,8,1,4,10,6,2,3,1,11765,11798,7
Task 11765,Job 1,7,8,1,6,0,8,13,5,1,1,2,11765,11798,15
Task 11766,Job 0,8,10,2,7,1,10,15,5,2,4,2,11766,11800,9
Task 11766,Job 1,13,10,1,8,1,14,21,7,1,4,2,11766,11800,13
Task 11767,Job 0,3,7,2,6,0,5,9,4,2,3,0,11767,11801,19
Task 11767,Job 1,8,4,4,10,0,12,18,6,4,3,0,11767,11801,19
Task 11768,Job 0,5,8,4,11,0,9,16,7,4,4,0,11768,11801,20
Task 11768,Job 1,10,4,3,7,0,13,17,4,3,4,2,11768,11801,4
Task 11769,Job 0,4,7,3,8,0,7,12,5,3,4,1,11769,11803,7
Task 11769,Job 1,9,4,3,10,0,12,19,7,3,3,0,11769,11803,2
Task 11770,Job 0,7,8,1,12,0,8,19,11,1,1,0,11770,11803,2
Task 11770,Job 1,12,5,4,8,0,16,20,4,4,2,0,11770,11803,18
Task 11771,Job 0,2,7,4,12,0,6,14,8,4,4,2,11771,11804,18
Task 11771,Job 1,7,8,4,12,1,11,19,8,4,4,1,11771,11804,6
Task 11772,Job 0,1,4,4,10,0,5,11,6,4,1,0,11772,11805,17
Task 11772,Job 1,6,5,4,12,0,10,18,8,4,4,0,11772,11805,6
Task 11773,Job 0,8,9,3,10,0,11,18,7,3,3,2,11773,11807,9
Task 11773,Job 1,13,9,1,9,1,14,22,8,1,4,1,11773,11807,2
Task 11774,Job 0,1,6,2,8,0,3,9,6,2,1,1,11774,11808,10
Task 11774,Job 1,6,5,4,11,0,10,17,7,4,1,0,11774,11808,18
Task 11775,Job 0,2,7,1,6,0,3,8,5,1,2,2,11775,11809,7
Task 11775,Job 1,7,7,4,8,0,11,15,4,4,3,0,11775,11809,12
Task 11776,Job 0,1,7,1,8,0,2,9,7,1,1,2,11776,11810,2
Task 11776,Job 1,6,5,1,9,1,7,15,8,1,3,1,11776,11810,17
Task 11777,Job 0,7,8,4,6,0,11,13,2,4,3,1,11777,11810,11
Task 11777,Job 1,12,4,3,9,0,15,21,6,3,3,0,11777,11810,6
Task 11778,Job 0,2,9,3,7,1,5,9,4,3,2,2,11778,11811,15
Task 11778,Job 1,7,8,4,9,0,11,16,5,4,2,0,11778,11811,15
Task 11779,Job 0,4,5,1,10,0,5,14,9,1,1,2,11779,11813,19
Task 11779,Job 1,9,4,4,10,1,13,19,6,4,1,1,11779,11813,16
Task 11780,Job 0,7,8,1,7,1,8,14,6,1,2,0,11780,11813,15
Task 11780,Job 1,12,9,3,7,1,15,19,4,3,3,0,11780,11813,2
Task 11781,Job 0,5,5,3,7,1,8,12,4,3,1,0,11781,11814,20
Task 11781,Job 1,10,7,1,12,1,11,22,11,1,2,2,11781,11814,6
Task 11782,Job 0,1,4,1,6,0,2,7,5,1,3,2,11782,11816,9
Task 11782,Job 1,6,4,3,9,1,9,15,6,3,4,2,11782,11816,9
Task 11783,Job 0,10,6,3,12,1,13,22,9,3,1,0,11783,11817,12
Task 11783,Job 1,15,10,4,7,0,19,22,3,4,1,1,11783,11817,16
Task 11784,Job 0,5,4,1,7,0,6,12,6,1,2,1,11784,11817,11
Task 11784,Job 1,10,8,1,6,0,11,16,5,1,4,0,11784,11817,10
Task 11785,Job 0,1,8,3,7,1,4,8,4,3,1,0,11785,11819,14
Task 11785,Job 1,6,7,2,11,0,8,17,9,2,2,2,11785,11819,17
Task 11786,Job 0,9,4,1,12,0,10,21,11,1,1,2,11786,11820,3
Task 11786,Job 1,14,7,1,7,0,15,21,6,1,4,0,11786,11820,17
Task 11787,Job 0,2,6,1,6,0,3,8,5,1,4,2,11787,11820,12
Task 11787,Job 1,7,5,3,12,0,10,19,9,3,1,1,11787,11820,20
Task 11788,Job 0,10,8,1,7,0,11,17,6,1,3,2,11788,11822,14
Task 11788,Job 1,15,7,2,6,0,17,21,4,2,1,1,11788,11822,12
Task 11789,Job 0,3,10,2,8,0,5,11,6,2,3,2,11789,11823,14
Task 11789,Job 1,8,5,1,12,0,9,20,11,1,1,1,11789,11823,16
Task 11790,Job 0,8,10,4,11,0,12,19,7,4,4,2,11790,11824,8
Task 11790,Job 1,13,9,4,10,1,17,23,6,4,4,1,11790,11824,16
Task 11791,Job 0,5,5,3,6,0,8,11,3,3,4,1,11791,11824,20
Task 11791,Job 1,10,5,3,10,0,13,20,7,3,2,1,11791,11824,20
Task 11792,Job 0,3,7,1,7,0,4,10,6,1,1,1,11792,11825,20
Task 11792,Job 1,8,8,4,10,0,12,18,6,4,4,2,11792,11825,9
Task 11793,Job 0,4,10,2,12,0,6,16,10,2,4,2,11793,11826,10
Task 11793,Job 1,9,4,2,9,1,11,18,7,2,4,0,11793,11826,16
Task 11794,Job 0,9,10,3,8,1,12,17,5,3,2,2,11794,11828,8
Task 11794,Job 1,14,4,2,9,0,16,23,7,2,1,2,11794,11828,4
Task 11795,Job 0,9,9,4,6,0,13,15,2,4,2,0,11795,11829,19
Task 11795,Job 1,14,8,1,6,1,15,20,5,1,4,2,11795,11829,12
Task 11796,Job 0,4,4,4,10,0,8,14,6,4,2,2,11796,11830,3
Task 11796,Job 1,9,10,3,11,1,12,20,8,3,1,0,11796,11830,8
Task 11797,Job 0,6,9,3,12,0,9,18,9,3,3,0,11797,11830,4
Task 11797,Job 1,11,9,4,11,0,15,22,7,4,1,1,11797,11830,18
Task 11798,Job 0,8,4,4,12,1,12,20,8,4,1,1,11798,11831,20
Task 11798,Job 1,13,7,4,11,1,17,24,7,4,2,0,11798,11831,3
Task 11799,Job 0,1,8,3,12,0,4,13,9,3,2,1,11799,11833,7
Task 11799,Job 1,6,10,4,9,0,10,15,5,4,2,0,11799,11833,14
Task 11800,Job 0,2,5,1,10,0,3,12,9,1,3,0,11800,11834,19
Task 11800,Job 1,7,4,2,6,1,9,13,4,2,1,2,11800,11834,11
Task 11801,Job 0,7,9,2,11,0,9,18,9,2,4,0,11801,11834,12
Task 11801,Job 1,12,4,4,8,0,16,20,4,4,3,2,11801,11834,14
Task 11802,Job 0,3,7,2,11,0,5,14,9,2,1,1,11802,11835,19
Task 11802,Job 1,8,8,3,6,0,11,14,3,3,3,2,11802,11835,18
Task 11803,Job 0,8,4,2,7,1,10,15,5,2,1,2,11803,11836,10
Task 11803,Job 1,13,10,2,9,0,15,22,7,2,2,0,11803,11836,12
Task 11804,Job 0,10,6,3,6,0,13,16,3,3,4,0,11804,11838,18
Task 11804,Job 1,15,4,1,11,1,16,26,10,1,1,0,11804,11838,4
Task 11805,Job 0,9,6,1,8,0,10,17,7,1,3,2,11805,11838,3
Task 11805,Job 1,14,5,4,7,0,18,21,3,4,2,2,11805,11838,14
Task 11806,Job 0,6,7,3,6,0,9,12,3,3,1,1,11806,11840,20
Task 11806,Job 1,11,5,4,8,0,15,19,4,4,4,1,11806,11840,18
Task 11807,Job 0,6,7,4,6,0,10,12,2,4,3,1,11807,11840,12
Task 11807,Job 1,11,5,3,11,1,14,22,8,3,3,2,11807,11840,4
Task 11808,Job 0,9,7,1,10,0,10,19,9,1,3,2,11808,11842,16
Task 11808,Job 1,14,4,3,10,0,17,24,7,3,4,0,11808,11842,9
Task 11809,Job 0,6,6,1,11,0,7,17,10,1,4,2,11809,11842,18
Task 11809,Job 1,11,9,3,11,0,14,22,8,3,2,2,11809,11842,3
Task 11810,Job 0,3,7,3,9,1,6,12,6,3,1,2,11810,11843,12
Task 11810,Job 1,8,10,2,10,1,10,18,8,2,2,0,11810,11843,7
Task 11811,Job 0,6,7,1,7,1,7,13,6,1,2,1,11811,11845,5
Task 11811,Job 1,11,8,3,10,0,14,21,7,3,1,0,11811,11845,12
Task 11812,Job 0,9,7,2,7,0,11,16,5,2,4,1,11812,11845,8
Task 11812,Job 1,14,7,2,8,0,16,22,6,2,1,2,11812,11845,14
Task 11813,Job 0,3,10,2,7,0,5,10,5,2,4,2,11813,11847,2
Task 11813,Job 1,8,8,3,9,0,11,17,6,3,1,1,11813,11847,12
Task 11814,Job 0,2,8,1,8,0,3,10,7,1,4,0,11814,11848,2
Task 11814,Job 1,7,8,2,6,0,9,13,4,2,3,0,11814,11848,11
Task 11815,Job 0,3,5,4,8,0,7,11,4,4,4,0,11815,11849,12
Task 11815,Job 1,8,6,1,6,1,9,14,5,1,1,0,11815,11849,18
Task 11816,Job 0,3,5,2,10,0,5,13,8,2,1,0,11816,11849,18
Task 11816,Job 1,8,8,1,12,0,9,20,11,1,1,0,11816,11849,6
Task 11817,Job 0,1,9,1,7,0,2,8,6,1,2,1,11817,11850,12
Task 11817,Job 1,6,9,4,10,0,10,16,6,4,4,2,11817,11850,20
Task 11818,Job 0,5,9,2,6,0,7,11,4,2,1,0,11818,11851,10
Task 11818,Job 1,10,10,4,10,0,14,20,6,4,2,0,11818,11851,12
Task 11819,Job 0,7,6,3,9,0,10,16,6,3,4,1,11819,11853,10
Task 11819,Job 1,12,9,2,8,0,14,20,6,2,2,1,11819,11853,8
Task 11820,Job 0,2,6,1,6,0,3,8,5,1,3,0,11820,11853,3
Task 11820,Job 1,7,10,1,6,1,8,13,5,1,2,2,11820,11853,14
Task 11821,Job 0,10,7,1,12,0,11,22,11,1,3,2,11821,11855,15
Task 11821,Job 1,15,4,1,11,0,16,26,10,1,2,2,11821,11855,15
Task 11822,Job 0,10,6,1,9,0,11,19,8,1,2,1,11822,11855,13
Task 11822,Job 1,15,8,4,9,0,19,24,5,4,1,2,11822,11855,14
Task 11823,Job 0,7,5,2,11,0,9,18,9,2,1,1,11823,11857,7
Task 11823,Job 1,12,8,1,6,0,13,18,5,1,1,1,11823,11857,18
Task 11824,Job 0,1,8,3,11,0,4,12,8,3,3,0,11824,11858,8
Task 11824,Job 1,6,4,4,7,0,10,13,3,4,4,0,11824,11858,11
Task 11825,Job 0,8,5,3,12,0,11,20,9,3,1,0,11825,11859,17
Task 11825,Job 1,13,10,4,8,0,17,21,4,4,1,2,11825,11859,10
Task 11826,Job 0,5,8,3,11,0,8,16,8,3,3,1,11826,11860,9
Task 11826,Job 1,10,6,3,12,0,13,22,9,3,4,2,11826,11860,4
Task 11827,Job 0,8,4,1,12,0,9,20,11,1,4,1,11827,11861,3
Task 11827,Job 1,13,6,4,10,1,17,23,6,4,3,0,11827,11861,19
Task 11828,Job 0,2,9,3,6,0,5,8,3,3,3,1,11828,11861,13
Task 11828,Job 1,7,8,2,9,0,9,16,7,2,2,1,11828,11861,17
Task 11829,Job 0,1,8,2,7,1,3,8,5,2,4,0,11829,11862,12
Task 11829,Job 1,6,10,1,10,0,7,16,9,1,2,2,11829,11862,10
Task 11830,Job 0,10,9,4,6,0,14,16,2,4,2,0,11830,11863,2
Task 11830,Job 1,15,8,2,8,0,17,23,6,2,3,2,11830,11863,5
Task 11831,Job 0,2,4,4,9,0,6,11,5,4,3,0,11831,11864,14
Task 11831,Job 1,7,8,3,12,0,10,19,9,3,4,2,11831,11864,3
Task 11832,Job 0,8,8,1,6,0,9,14,5,1,1,0,11832,11865,5
Task 11832,Job 1,13,6,3,9,0,16,22,6,3,3,1,11832,11865,18
Task 11833,Job 0,2,4,4,11,1,6,13,7,4,3,1,11833,11866,4
Task 11833,Job 1,7,10,2,12,0,9,19,10,2,3,0,11833,11866,12
Task 11834,Job 0,10,4,2,9,0,12,19,7,2,3,1,11834,11868,2
Task 11834,Job 1,15,5,2,10,0,17,25,8,2,4,1,11834,11868,2
Task 11835,Job 0,9,5,4,7,0,13,16,3,4,2,1,11835,11868,18
Task 11835,Job 1,14,7,1,9,0,15,23,8,1,4,1,11835,11868,19
Task 11836,Job 0,9,6,3,9,0,12,18,6,3,1,2,11836,11870,3
Task 11836,Job 1,14,7,3,6,1,17,20,3,3,3,0,11836,11870,3
Task 11837,Job 0,2,6,1,10,1,3,12,9,1,2,1,11837,11870,19
Task 11837,Job 1,7,6,2,8,0,9,15,6,2,4,2,11837,11870,14
Task 11838,Job 0,1,7,3,9,1,4,10,6,3,4,2,11838,11872,16
Task 11838,Job 1,6,8,2,11,1,8,17,9,2,4,1,11838,11872,9
Task 11839,Job 0,3,7,1,6,1,4,9,5,1,2,1,11839,11873,7
Task 11839,Job 1,8,7,2,11,0,10,19,9,2,3,2,11839,11873,10
Task 11840,Job 0,8,4,1,9,0,9,17,8,1,1,0,11840,11873,12
Task 11840,Job 1,13,9,4,10,1,17,23,6,4,1,2,11840,11873,10
Task 11841,Job 0,9,9,2,8,0,11,17,6,2,1,0,11841,11874,9
Task 11841,Job 1,14,7,2,11,0,16,25,9,2,4,0,11841,11874,15
Task 11842,Job 0,1,8,4,6,0,5,7,2,4,2,2,11842,11876,10
Task 11842,Job 1,6,10,1,10,0,7,16,9,1,4,2,11842,11876,13
Task 11843,Job 0,7,10,4,11,0,11,18,7,4,3,0,11843,11877,14
Task 11843,Job 1,12,6,1,9,0,13,21,8,1,2,2,11843,11877,18
Task 11844,Job 0,10,6,4,12,1,14,22,8,4,4,0,11844,11878,2
Task 11844,Job 1,15,9,1,11,0,16,26,10,1,2,0,11844,11878,13
Task 11845,Job 0,3,7,2,8,0,5,11,6,2,1,2,11845,11878,7
Task 11845,Job 1,8,9,3,11,0,11,19,8,3,2,1,11845,11878,15
Task 11846,Job 0,3,5,3,8,0,6,11,5,3,4,0,11846,11880,10
Task 11846,Job 1,8,7,3,8,1,11,16,5,3,1,2,11846,11880,14
Task 11847,Job 0,2,10,4,8,0,6,10,4,4,3,1,11847,11880,18
Task 11847,Job 1,7,7,1,8,1,8,15,7,1,3,0,11847,11880,4
Task 11848,Job 0,4,8,4,8,0,8,12,4,4,1,0,11848,11881,15
Task 11848,Job 1,9,5,3,11,0,12,20,8,3,2,1,11848,11881,5
Task 11849,Job 0,7,4,4,11,0,11,18,7,4,2,2,11849,11883,19
Task 11849,Job 1,12,9,1,9,0,13,21,8,1,2,1,11849,11883,17
Task 11850,Job 0,2,8,4,11,0,6,13,7,4,2,1,11850,11884,2
Task 11850,Job 1,7,5,2,7,0,9,14,5,2,2,2,11850,11884,3
Task 11851,Job 0,2,4,4,10,0,6,12,6,4,1,2,11851,11885,7
Task 11851,Job 1,7,7,1,10,1,8,17,9,1,4,1,11851,11885,14
Task 11852,Job 0,10,9,4,12,0,14,22,8,4,2,0,11852,11885,8
Task 11852,Job 1,15,7,2,9,0,17,24,7,2,3,0,11852,11885,10
Task 11853,Job 0,4,6,4,8,0,8,12,4,4,1,1,11853,11886,14
Task 11853,Job 1,9,6,3,11,1,12,20,8,3,4,1,11853,11886,13
Task 11854,Job 0,4,6,3,10,1,7,14,7,3,4,1,11854,11887,16
Task 11854,Job 1,9,4,2,6,1,11,15,4,2,3,0,11854,11887,2
Task 11855,Job 0,6,5,2,6,0,8,12,4,2,4,1,11855,11889,18
Task 11855,Job 1,11,10,1,7,0,12,18,6,1,4,0,11855,11889,17
Task 11856,Job 0,7,6,3,12,0,10,19,9,3,4,1,11856,11889,19
Task 11856,Job 1,12,6,1,12,0,13,24,11,1,4,2,11856,11889,7
Task 11857,Job 0,5,6,1,11,1,6,16,10,1,1,2,11857,11891,16
Task 11857,Job 1,10,7,2,9,0,12,19,7,2,2,0,11857,11891,19
Task 11858,Job 0,3,7,4,11,1,7,14,7,4,4,0,11858,11891,6
Task 11858,Job 1,8,9,3,8,0,11,16,5,3,4,0,11858,11891,9
Task 11859,Job 0,9,4,2,12,0,11,21,10,2,1,1,11859,11893,3
Task 11859,Job 1,14,10,3,10,0,17,24,7,3,4,0,11859,11893,5
Task 11860,Job 0,10,4,4,10,1,14,20,6,4,3,1,11860,11893,16
Task 11860,Job 1,15,5,3,6,1,18,21,3,3,2,2,11860,11893,6
Task 11861,Job 0,9,6,4,8,0,13,17,4,4,4,2,11861,11894,5
Task 11861,Job 1,14,4,3,8,0,17,22,5,3,3,1,11861,11894,15
Task 11862,Job 0,7,8,3,8,0,10,15,5,3,4,1,11862,11896,18
Task 11862,Job 1,12,10,3,9,0,15,21,6,3,4,0,11862,11896,2
Task 11863,Job 0,6,9,4,8,0,10,14,4,4,3,0,11863,11896,3
Task 11863,Job 1,11,10,1,7,0,12,18,6,1,1,2,11863,11896,19
Task 11864,Job 0,6,5,4,7,1,10,13,3,4,3,1,11864,11898,4
Task 11864,Job 1,11,5,2,10,0,13,21,8,2,4,1,11864,11898,9
Task 11865,Job 0,6,5,2,9,1,8,15,7,2,3,1,11865,11898,15
Task 11865,Job 1,11,10,3,6,0,14,17,3,3,4,0,11865,11898,18
Task 11866,Job 0,5,10,1,10,0,6,15,9,1,4,1,11866,11900,3
Task 11866,Job 1,10,8,1,7,0,11,17,6,1,3,2,11866,11900,10
Task 11867,Job 0,10,9,1,8,0,11,18,7,1,4,1,11867,11901,13
Task 11867,Job 1,15,10,4,7,0,19,22,3,4,1,1,11867,11901,14
Task 11868,Job 0,1,8,2,11,0,3,12,9,2,4,1,11868,11902,9
Task 11868,Job 1,6,4,3,12,0,9,18,9,3,3,0,11868,11902,13
Task 11869,Job 0,2,5,1,11,1,3,13,10,1,4,1,11869,11903,18
Task 11869,Job 1,7,9,4,12,1,11,19,8,4,3,2,11869,11903,16
Task 11870,Job 0,5,4,4,12,0,9,17,8,4,3,0,11870,11903,9
Task 11870,Job 1,10,9,1,10,1,11,20,9,1,4,1,11870,11903,18
Task 11871,Job 0,5,9,1,12,1,6,17,11,1,3,1,11871,11905,15
Task 11871,Job 1,10,8,2,6,0,12,16,4,2,4,1,11871,11905,8
Task 11872,Job 0,5,6,1,11,0,6,16,10,1,4,2,11872,11905,3
Task 11872,Job 1,10,5,2,10,0,12,20,8,2,3,0,11872,11905,12
Task 11873,Job 0,9,8,2,10,0,11,19,8,2,4,2,11873,11907,9
Task 11873,Job 1,14,7,1,7,1,15,21,6,1,1,2,11873,11907,15
Task 11874,Job 0,10,6,4,11,0,14,21,7,4,2,0,11874,11907,13
Task 11874,Job 1,15,9,4,9,0,19,24,5,4,2,0,11874,11907,5
Task 11875,Job 0,3,8,1,9,0,4,12,8,1,1,2,11875,11909,11
Task 11875,Job 1,8,6,3,10,0,11,18,7,3,3,1,11875,11909,17
Task 11876,Job 0,2,4,4,11,0,6,13,7,4,2,0,11876,11909,8
Task 11876,Job 1,7,5,2,10,0,9,17,8,2,1,2,11876,11909,18
Task 11877,Job 0,5,7,1,12,1,6,17,11,1,4,1,11877,11911,10
Task 11877,Job 1,10,10,3,12,1,13,22,9,3,3,1,11877,11911,6
Task 11878,Job 0,2,7,4,10,0,6,12,6,4,1,0,11878,11912,18
Task 11878,Job 1,7,6,1,8,1,8,15,7,1,2,1,11878,11912,3
Task 11879,Job 0,7,7,2,7,0,9,14,5,2,2,0,11879,11912,20
Task 11879,Job 1,12,5,4,11,0,16,23,7,4,4,0,11879,11912,9
Task 11880,Job 0,6,7,3,8,1,9,14,5,3,1,0,11880,11914,16
Task 11880,Job 1,11,4,3,6,0,14,17,3,3,3,2,11880,11914,16
Task 11881,Job 0,2,4,4,12,1,6,14,8,4,4,0,11881,11915,2
Task 11881,Job 1,7,9,4,11,1,11,18,7,4,1,1,11881,11915,9
Task 11882,Job 0,10,7,4,12,1,14,22,8,4,2,2,11882,11915,8
Task 11882,Job 1,15,5,1,9,1,16,24,8,1,4,1,11882,11915,10
Task 11883,Job 0,10,10,1,12,0,11,22,11,1,1,2,11883,11916,20
Task 11883,Job 1,15,5,1,8,1,16,23,7,1,1,1,11883,11916,3
Task 11884,Job 0,10,10,1,8,0,11,18,7,1,1,0,11884,11917,4
Task 11884,Job 1,15,9,3,11,0,18,26,8,3,4,0,11884,11917,10
Task 11885,Job 0,5,5,3,9,0,8,14,6,3,1,0,11885,11918,15
Task 11885,Job 1,10,8,2,12,0,12,22,10,2,2,2,11885,11918,12
Task 11886,Job 0,10,5,3,6,0,13,16,3,3,1,0,11886,11920,18
Task 11886,Job 1,15,4,3,12,1,18,27,9,3,3,0,11886,11920,12
Task 11887,Job 0,10,9,4,10,0,14,20,6,4,1,2,11887,11921,13
Task 11887,Job 1,15,5,4,8,0,19,23,4,4,1,1,11887,11921,19
Task 11888,Job 0,8,8,3,12,0,11,20,9,3,1,1,11888,11922,13
Task 11888,Job 1,13,10,2,9,0,15,22,7,2,3,1,11888,11922,19
Task 11889,Job 0,2,8,3,10,1,5,12,7,3,3,1,11889,11922,8
Task 11889,Job 1,7,9,2,7,0,9,14,5,2,4,0,11889,11922,20
Task 11890,Job 0,8,5,3,8,0,11,16,5,3,1,2,11890,11923,13
Task 11890,Job 1,13,6,1,10,0,14,23,9,1,2,2,11890,11923,19
Task 11891,Job 0,5,6,3,8,0,8,13,5,3,4,2,11891,11925,9
Task 11891,Job 1,10,10,2,12,1,12,22,10,2,3,1,11891,11925,5
Task 11892,Job 0,5,7,1,11,0,6,16,10,1,3,2,11892,11926,5
Task 11892,Job 1,10,8,1,12,0,11,22,11,1,4,2,11892,11926,18
Task 11893,Job 0,5,9,1,9,0,6,14,8,1,1,0,11893,11927,18
Task 11893,Job 1,10,10,2,8,0,12,18,6,2,3,2,11893,11927,16
Task 11894,Job 0,9,5,2,12,0,11,21,10,2,3,0,11894,11928,14
Task 11894,Job 1,14,4,4,7,0,18,21,3,4,3,2,11894,11928,2
Task 11895,Job 0,5,8,2,7,0,7,12,5,2,4,0,11895,11929,13
Task 11895,Job 1,10,4,2,12,0,12,22,10,2,1,2,11895,11929,20
Task 11896,Job 0,8,6,3,10,0,11,18,7,3,1,2,11896,11929,11
Task 11896,Job 1,13,10,4,6,0,17,19,2,4,2,0,11896,11929,9
Task 11897,Job 0,6,6,3,7,1,9,13,4,3,2,2,11897,11930,5
Task 11897,Job 1,11,7,3,7,0,14,18,4,3,3,0,11897,11930,17
Task 11898,Job 0,6,9,4,8,1,10,14,4,4,1,0,11898,11931,10
Task 11898,Job 1,11,6,2,6,1,13,17,4,2,2,1,11898,11931,10
Task 11899,Job 0,7,9,1,7,0,8,14,6,1,4,0,11899,11933,11
Task 11899,Job 1,12,10,3,10,0,15,22,7,3,3,0,11899,11933,8
Task 11900,Job 0,8,10,1,6,1,9,14,5,1,2,1,11900,11933,20
Task 11900,Job 1,13,5,2,7,0,15,20,5,2,3,0,11900,11933,2
Task 11901,Job 0,9,6,2,11,0,11,20,9,2,3,0,11901,11935,13
Task 11901,Job 1,14,8,2,10,0,16,24,8,2,2,1,11901,11935,10
Task 11902,Job 0,4,9,2,12,0,6,16,10,2,2,0,11902,11935,17
Task 11902,Job 1,9,10,3,7,1,12,16,4,3,3,1,11902,11935,11
Task 11903,Job 0,5,10,2,10,1,7,15,8,2,2,0,11903,11936,9
Task 11903,Job 1,10,8,3,10,0,13,20,7,3,4,2,11903,11936,8
Task 11904,Job 0,6,8,4,11,1,10,17,7,4,2,0,11904,11937,4
Task 11904,Job 1,11,7,1,10,0,12,21,9,1,2,1,11904,11937,4
Task 11905,Job 0,7,6,2,10,0,9,17,8,2,4,2,11905,11939,12
Task 11905,Job 1,12,5,3,11,0,15,23,8,3,2,2,11905,11939,14
Task 11906,Job 0,8,7,1,12,0,9,20,11,1,4,1,11906,11940,15
Task 11906,Job 1,13,6,1,10,0,14,23,9,1,3,2,11906,11940,13
Task 11907,Job 0,8,7,3,10,0,11,18,7,3,3,0,11907,11940,12
Task 11907,Job 1,13,6,1,12,1,14,25,11,1,2,1,11907,11940,10
Task 11908,Job 0,8,7,4,6,0,12,14,2,4,2,2,11908,11942,7
Task 11908,Job 1,13,8,2,11,1,15,24,9,2,1,1,11908,11942,12
Task 11909,Job 0,1,9,2,9,1,3,10,7,2,1,2,11909,11942,9
Task 11909,Job 1,6,6,2,12,0,8,18,10,2,2,1,11909,11942,16
Task 11910,Job 0,9,4,1,11,0,10,20,10,1,1,2,11910,11944,18
Task 11910,Job 1,14,10,4,6,0,18,20,2,4,2,0,11910,11944,14
Task 11911,Job 0,7,8,1,10,0,8,17,9,1,4,0,11911,11945,3
Task 11911,Job 1,12,9,2,9,1,14,21,7,2,1,1,11911,11945,3
Task 11912,Job 0,4,5,2,9,0,6,13,7,2,3,2,11912,11945,11
Task 11912,Job 1,9,6,3,7,1,12,16,4,3,1,2,11912,11945,8
Task 11913,Job 0,8,4,2,9,0,10,17,7,2,1,1,11913,11946,13
Task 11913,Job 1,13,4,1,10,0,14,23,9,1,1,2,11913,11946,13
Task 11914,Job 0,10,4,4,6,0,14,16,2,4,1,0,11914,11948,14
Task 11914,Job 1,15,7,4,10,0,19,25,6,4,1,0,11914,11948,15
Task 11915,Job 0,10,7,2,7,0,12,17,5,2,2,2,11915,11949,11
Task 11915,Job 1,15,9,4,12,0,19,27,8,4,2,0,11915,11949,16
Task 11916,Job 0,9,8,4,12,1,13,21,8,4,4,2,11916,11949,9
Task 11916,Job 1,14,8,2,12,0,16,26,10,2,1,1,11916,11949,9
Task 11917,Job 0,2,9,2,12,1,4,14,10,2,3,0,11917,11951,14
Task 11917,Job 1,7,7,4,8,1,11,15,4,4,3,0,11917,11951,5
Task 11918,Job 0,8,5,1,10,0,9,18,9,1,1,1,11918,11951,17
Task 11918,Job 1,13,7,1,10,1,14,23,9,1,4,0,11918,11951,12
Task 11919,Job 0,3,6,4,11,0,7,14,7,4,3,0,11919,11953,6
Task 11919,Job 1,8,9,2,7,0,10,15,5,2,4,2,11919,11953,15
Task 11920,Job 0,8,9,2,7,1,10,15,5,2,4,0,11920,11953,9
Task 11920,Job 1,13,5,2,8,0,15,21,6,2,2,1,11920,11953,16
Task 11921,Job 0,4,5,3,9,0,7,13,6,3,1,1,11921,11955,17
Task 11921,Job 1,9,4,1,9,0,10,18,8,1,1,1,11921,11955,10
Task 11922,Job 0,9,10,3,7,0,12,16,4,3,1,1,11922,11956,8
Task 11922,Job 1,14,6,1,9,0,15,23,8,1,4,2,11922,11956,20
Task 11923,Job 0,7,4,2,11,0,9,18,9,2,3,1,11923,11957,2
Task 11923,Job 1,12,6,4,7,1,16,19,3,4,3,1,11923,11957,4
Task 11924,Job 0,4,6,1,9,0,5,13,8,1,4,2,11924,11957,4
Task 11924,Job 1,9,6,2,9,0,11,18,7,2,3,1,11924,11957,19
Task 11925,Job 0,2,5,3,11,0,5,13,8,3,1,1,11925,11958,9
Task 11925,Job 1,7,10,2,12,0,9,19,10,2,4,1,11925,11958,11
Task 11926,Job 0,5,10,4,6,1,9,11,2,4,3,2,11926,11959,20
Task 11926,Job 1,10,9,3,7,1,13,17,4,3,1,0,11926,11959,7
Task 11927,Job 0,1,9,2,11,0,3,12,9,2,1,1,11927,11960,12
Task 11927,Job 1,6,6,4,8,0,10,14,4,4,4,2,11927,11960,20
Task 11928,Job 0,10,5,2,9,0,12,19,7,2,3,0,11928,11962,19
Task 11928,Job 1,15,5,3,6,0,18,21,3,3,3,2,11928,11962,16
Task 11929,Job 0,1,10,2,12,0,3,13,10,2,1,2,11929,11963,6
Task 11929,Job 1,6,8,3,7,0,9,13,4,3,1,1,11929,11963,10
Task 11930,Job 0,9,8,3,9,1,12,18,6,3,3,1,11930,11964,16
Task 11930,Job 1,14,7,1,10,1,15,24,9,1,2,2,11930,11964,8
Task 11931,Job 0,4,7,3,8,0,7,12,5,3,2,2,11931,11964,17
Task 11931,Job 1,9,5,3,11,0,12,20,8,3,3,0,11931,11964,7
Task 11932,Job 0,4,5,2,7,0,6,11,5,2,2,2,11932,11965,3
Task 11932,Job 1,9,10,2,7,1,11,16,5,2,1,1,11932,11965,9
Task 11933,Job 0,5,10,4,9,0,9,14,5,4,2,0,11933,11966,11
Task 11933,Job 1,10,8,4,11,0,14,21,7,4,1,2,11933,11966,6
Task 11934,Job 0,10,7,3,7,1,13,17,4,3,2,2,11934,11967,3
Task 11934,Job 1,15,6,2,6,1,17,21,4,2,2,1,11934,11967,19
Task 11935,Job 0,9,9,4,7,1,13,16,3,4,3,1,11935,11969,18
Task 11935,Job 1,14,6,4,9,0,18,23,5,4,1,2,11935,11969,4
Task 11936,Job 0,5,5,1,12,1,6,17,11,1,4,0,11936,11970,17
Task 11936,Job 1,10,6,4,8,1,14,18,4,4,2,2,11936,11970,16
Task 11937,Job 0,6,4,4,8,1,10,14,4,4,4,1,11937,11970,9
Task 11937,Job 1,11,8,1,6,0,12,17,5,1,3,1,11937,11970,20
Task 11938,Job 0,8,9,4,12,0,12,20,8,4,2,1,11938,11971,8
Task 11938,Job 1,13,8,4,7,0,17,20,3,4,1,1,11938,11971,14
Task 11939,Job 0,2,9,3,6,0,5,8,3,3,4,0,11939,11973,17
Task 11939,Job 1,7,9,4,6,0,11,13,2,4,3,0,11939,11973,15
Task 11940,Job 0,9,5,3,10,0,12,19,7,3,3,0,11940,11973,7
Task 11940,Job 1,14,7,3,11,1,17,25,8,3,2,2,11940,11973,18
Task 11941,Job 0,6,10,2,7,0,8,13,5,2,3,0,11941,11975,17
Task 11941,Job 1,11,8,2,7,0,13,18,5,2,1,1,11941,11975,20
Task 11942,Job 0,3,10,3,10,0,6,13,7,3,4,2,11942,11976,17
Task 11942,Job 1,8,9,2,7,0,10,15,5,2,1,0,11942,11976,12
Task 11943,Job 0,1,4,1,8,1,2,9,7,1,3,0,11943,11977,8
Task 11943,Job 1,6,4,4,9,0,10,15,5,4,2,1,11943,11977,4
Task 11944,Job 0,7,10,3,9,1,10,16,6,3,3,1,11944,11978,17
Task 11944,Job 1,12,9,4,7,0,16,19,3,4,4,1,11944,11978,6
Task 11945,Job 0,2,8,3,10,1,5,12,7,3,2,0,11945,11978,11
Task 11945,Job 1,7,4,3,6,0,10,13,3,3,1,2,11945,11978,10
Task 11946,Job 0,4,8,2,8,0,6,12,6,2,3,0,11946,11980,2
Task 11946,Job 1,9,7,2,11,0,11,20,9,2,1,2,11946,11980,3
Task 11947,Job 0,2,9,4,11,0,6,13,7,4,3,0,11947,11981,12
Task 11947,Job 1,7,4,3,10,1,10,17,7,3,2,1,11947,11981,19
Task 11948,Job 0,4,7,1,10,0,5,14,9,1,4,2,11948,11981,3
Task 11948,Job 1,9,7,4,8,1,13,17,4,4,3,1,11948,11981,10
Task 11949,Job 0,4,6,1,6,1,5,10,5,1,3,0,11949,11983,13
Task 11949,Job 1,9,6,1,12,0,10,21,11,1,2,1,11949,11983,12
Task 11950,Job 0,1,5,2,6,1,3,7,4,2,4,2,11950,11984,3
Task 11950,Job 1,6,6,1,7,0,7,13,6,1,2,0,11950,11984,18
Task 11951,Job 0,7,5,1,6,0,8,13,5,1,2,2,11951,11985,7
Task 11951,Job 1,12,8,4,6,0,16,18,2,4,1,2,11951,11985,15
Task 11952,Job 0,9,10,3,12,1,12,21,9,3,3,0,11952,11985,13
Task 11952,Job 1,14,6,2,8,0,16,22,6,2,1,1,11952,11985,7
Task 11953,Job 0,8,4,2,12,0,10,20,10,2,4,1,11953,11986,20
Task 11953,Job 1,13,4,3,11,0,16,24,8,3,4,1,11953,11986,16
Task 11954,Job 0,10,10,4,12,0,14,22,8,4,4,1,11954,11987,4
Task 11954,Job 1,15,7,1,10,0,16,25,9,1,1,0,11954,11987,20
Task 11955,Job 0,2,10,4,7,0,6,9,3,4,1,2,11955,11988,5
Task 11955,Job 1,7,6,4,6,0,11,13,2,4,1,1,11955,11988,5
Task 11956,Job 0,4,7,4,12,1,8,16,8,4,3,0,11956,11989,6
Task 11956,Job 1,9,7,1,6,0,10,15,5,1,4,2,11956,11989,8
Task 11957,Job 0,8,8,3,11,0,11,19,8,3,2,1,11957,11991,2
Task 11957,Job 1,13,6,3,7,0,16,20,4,3,1,0,11957,11991,3
Task 11958,Job 0,7,5,3,8,0,10,15,5,3,3,2,11958,11992,16
Task 11958,Job 1,12,9,3,10,0,15,22,7,3,3,2,11958,11992,17
Task 11959,Job 0,9,8,3,10,0,12,19,7,3,4,1,11959,11993,17
Task 11959,Job 1,14,6,4,9,0,18,23,5,4,3,1,11959,11993,10
Task 11960,Job 0,9,9,2,11,1,11,20,9,2,1,2,11960,11993,13
Task 11960,Job 1,14,8,1,12,0,15,26,11,1,3,1,11960,11993,9
Task 11961,Job 0,7,6,4,9,0,11,16,5,4,2,2,11961,11994,2
Task 11961,Job 1,12,9,2,12,0,14,24,10,2,1,0,11961,11994,12
Task 11962,Job 0,4,9,2,10,0,6,14,8,2,1,0,11962,11996,20
Task 11962,Job 1,9,10,2,9,0,11,18,7,2,2,0,11962,11996,3
Task 11963,Job 0,3,6,2,12,0,5,15,10,2,1,0,11963,11997,11
Task 11963,Job 1,8,4,1,7,0,9,15,6,1,4,1,11963,11997,8
Task 11964,Job 0,2,5,1,8,0,3,10,7,1,4,0,11964,11998,6
Task 11964,Job 1,7,10,4,6,0,11,13,2,4,1,2,11964,11998,18
Task 11965,Job 0,9,8,1,12,0,10,21,11,1,3,0,11965,11998,20
Task 11965,Job 1,14,5,3,11,1,17,25,8,3,1,2,11965,11998,5
Task 11966,Job 0,8,7,1,12,1,9,20,11,1,4,1,11966,12000,11
Task 11966,Job 1,13,5,2,9,0,15,22,7,2,4,1,11966,12000,5
Task 11967,Job 0,3,9,3,6,0,6,9,3,3,3,0,11967,12000,11
Task 11967,Job 1,8,7,2,9,0,10,17,7,2,1,0,11967,12000,14
Task 11968,Job 0,6,8,4,8,0,10,14,4,4,4,2,11968,12002,18
Task 11968,Job 1,11,10,1,6,0,12,17,5,1,3,2,11968,12002,6
Task 11969,Job 0,8,8,1,11,1,9,19,10,1,3,1,11969,12002,7
Task 11969,Job 1,13,10,1,6,0,14,19,5,1,2,0,11969,12002,3
Task 11970,Job 0,2,8,2,6,0,4,8,4,2,1,1,11970,12004,5
Task 11970,Job 1,7,7,4,6,0,11,13,2,4,2,0,11970,12004,15
Task 11971,Job 0,10,4,4,12,0,14,22,8,4,2,1,11971,12004,13
Task 11971,Job 1,15,4,2,10,1,17,25,8,2,4,2,11971,12004,20
Task 11972,Job 0,10,8,4,6,1,14,16,2,4,1,1,11972,12006,4
Task 11972,Job 1,15,8,1,10,0,16,25,9,1,2,1,11972,12006,11
Task 11973,Job 0,7,5,2,6,0,9,13,4,2,2,2,11973,12007,2
Task 11973,Job 1,12,10,3,11,0,15,23,8,3,4,0,11973,12007,12
Task 11974,Job 0,7,7,4,12,0,11,19,8,4,1,1,11974,12007,4
Task 11974,Job 1,12,9,1,10,1,13,22,9,1,2,2,11974,12007,9
Task 11975,Job 0,3,6,1,9,0,4,12,8,1,3,1,11975,12009,8
Task 11975,Job 1,8,6,4,8,1,12,16,4,4,3,1,11975,12009,6
Task 11976,Job 0,2,6,3,7,0,5,9,4,3,1,2,11976,12010,8
Task 11976,Job 1,7,7,1,6,1,8,13,5,1,3,1,11976,12010,6
Task 11977,Job 0,2,6,2,9,0,4,11,7,2,4,1,11977,12011,3
Task 11977,Job 1,7,4,3,11,1,10,18,8,3,3,1,11977,12011,19
Task 11978,Job 0,3,9,3,9,1,6,12,6,3,4,0,11978,12012,6
Task 11978,Job 1,8,10,3,6,0,11,14,3,3,2,2,11978,12012,12
Task 11979,Job 0,2,4,1,6,0,3,8,5,1,3,0,11979,12013,8
Task 11979,Job 1,7,8,2,6,0,9,13,4,2,4,1,11979,12013,15
Task 11980,Job 0,6,4,3,9,1,9,15,6,3,3,1,11980,12013,8
Task 11980,Job 1,11,5,1,10,0,12,21,9,1,1,0,11980,12013,11
Task 11981,Job 0,10,5,1,12,0,11,22,11,1,2,1,11981,12015,18
Task 11981,Job 1,15,4,3,7,0,18,22,4,3,1,1,11981,12015,8
Task 11982,Job 0,10,10,4,9,0,14,19,5,4,3,1,11982,12016,13
Task 11982,Job 1,15,10,2,12,0,17,27,10,2,3,0,11982,12016,14
Task 11983,Job 0,6,6,2,12,0,8,18,10,2,2,2,11983,12017,16
Task 11983,Job 1,11,10,2,7,0,13,18,5,2,2,1,11983,12017,8
Task 11984,Job 0,7,10,1,10,1,8,17,9,1,4,2,11984,12017,11
Task 11984,Job 1,12,6,2,11,1,14,23,9,2,2,1,11984,12017,18
Task 11985,Job 0,7,5,4,10,0,11,17,6,4,4,2,11985,12019,11
Task 11985,Job 1,12,6,1,7,1,13,19,6,1,2,0,11985,12019,6
Task 11986,Job 0,8,7,1,11,1,9,19,10,1,1,1,11986,12019,18
Task 11986,Job 1,13,5,3,12,0,16,25,9,3,4,0,11986,12019,14
Task 11987,Job 0,9,4,2,9,0,11,18,7,2,2,0,11987,12021,2
Task 11987,Job 1,14,8,4,12,0,18,26,8,4,3,2,11987,12021,10
Task 11988,Job 0,2,6,2,7,0,4,9,5,2,3,2,11988,12022,15
Task 11988,Job 1,7,9,4,11,0,11,18,7,4,2,2,11988,12022,16
Task 11989,Job 0,4,8,3,11,0,7,15,8,3,2,1,11989,12022,11
Task 11989,Job 1,9,6,2,9,0,11,18,7,2,2,0,11989,12022,12
Task 11990,Job 0,5,5,1,8,0,6,13,7,1,2,2,11990,12023,10
Task 11990,Job 1,10,9,1,11,0,11,21,10,1,3,0,11990,12023,19
Task 11991,Job 0,9,6,1,8,0,10,17,7,1,4,1,11991,12024,4
Task 11991,Job 1,14,9,2,12,0,16,26,10,2,3,2,11991,12024,20
Task 11992,Job 0,9,8,1,6,0,10,15,5,1,3,0,11992,12025,18
Task 11992,Job 1,14,6,4,8,0,18,22,4,4,3,1,11992,12025,7
Task 11993,Job 0,3,6,2,8,1,5,11,6,2,3,2,11993,12026,6
Task 11993,Job 1,8,8,4,12,0,12,20,8,4,4,2,11993,12026,8
Task 11994,Job 0,4,7,1,9,0,5,13,8,1,4,0,11994,12028,17
Task 11994,Job 1,9,8,2,11,1,11,20,9,2,1,2,11994,12028,12
Task 11995,Job 0,6,9,2,6,0,8,12,4,2,3,2,11995,12028,8
Task 11995,Job 1,11,4,3,8,0,14,19,5,3,4,0,11995,12028,19
Task 11996,Job 0,4,4,1,7,0,5,11,6,1,3,1,11996,12030,17
Task 11996,Job 1,9,9,1,10,0,10,19,9,1,2,0,11996,12030,15
Task 11997,Job 0,3,5,2,8,0,5,11,6,2,4,1,11997,12030,13
Task 11997,Job 1,8,7,3,6,0,11,14,3,3,2,0,11997,12030,11
Task 11998,Job 0,3,5,4,10,0,7,13,6,4,2,0,11998,12031,20
Task 11998,Job 1,8,5,1,8,0,9,16,7,1,2,1,11998,12031,11
Task 11999,Job 0,3,7,4,8,0,7,11,4,4,3,2,11999,12032,16
Task 11999,Job 1,8,10,1,12,0,9,20,11,1,4,2,11999,12032,3
Task 12000,Job 0,4,9,4,11,0,8,15,7,4,4,1,12000,12033,3
Task 12000,Job 1,9,10,3,6,0,12,15,3,3,1,1,12000,12033,9
Task 12001,Job 0,6,10,1,11,0,7,17,10,1,3,1,12001,12035,17
Task 12001,Job 1,11,7,4,8,0,15,19,4,4,3,0,12001,12035,11
Task 12002,Job 0,2,4,4,10,0,6,12,6,4,4,2,12002,12036,8
Task 12002,Job 1,7,10,1,6,0,8,13,5,1,2,1,12002,12036,4
Task 12003,Job 0,6,6,4,9,0,10,15,5,4,1,1,12003,12036,19
Task 12003,Job 1,11,10,2,10,0,13,21,8,2,3,0,12003,12036,10
Task 12004,Job 0,2,10,3,7,0,5,9,4,3,4,1,12004,12038,18
Task 12004,Job 1,7,8,2,12,1,9,19,10,2,3,0,12004,12038,7
Task 12005,Job 0,2,9,1,6,0,3,8,5,1,4,1,12005,12038,7
Task 12005,Job 1,7,4,3,7,1,10,14,4,3,4,1,12005,12038,14
Task 12006,Job 0,8,6,2,11,0,10,19,9,2,4,2,12006,12040,9
Task 12006,Job 1,13,7,3,11,1,16,24,8,3,4,2,12006,12040,8
Task 12007,Job 0,8,6,1,12,0,9,20,11,1,3,2,12007,12041,16
Task 12007,Job 1,13,5,1,6,1,14,19,5,1,1,1,12007,12041,19
Task 12008,Job 0,10,10,3,9,0,13,19,6,3,3,2,12008,12042,16
Task 12008,Job 1,15,10,3,8,0,18,23,5,3,1,2,12008,12042,12
Task 12009,Job 0,3,6,4,8,0,7,11,4,4,4,1,12009,12042,15
Task 12009,Job 1,8,4,1,11,1,9,19,10,1,4,2,12009,12042,5
Task 12010,Job 0,1,5,2,7,0,3,8,5,2,2,2,12010,12044,9
Task 12010,Job 1,6,6,2,6,0,8,12,4,2,3,2,12010,12044,2
Task 12011,Job 0,10,4,3,7,0,13,17,4,3,2,0,12011,12044,14
Task 12011,Job 1,15,8,2,10,0,17,25,8,2,1,2,12011,12044,6
Task 12012,Job 0,3,8,2,12,1,5,15,10,2,3,2,12012,12045,17
Task 12012,Job 1,8,10,4,12,0,12,20,8,4,2,1,12012,12045,20
Task 12013,Job 0,5,9,3,7,0,8,12,4,3,4,1,12013,12047,10
Task 12013,Job 1,10,9,4,10,0,14,20,6,4,2,0,12013,12047,4
Task 12014,Job 0,10,10,1,9,0,11,19,8,1,2,1,12014,12047,5
Task 12014,Job 1,15,8,2,11,0,17,26,9,2,2,2,12014,12047,8
Task 12015,Job 0,8,10,1,9,0,9,17,8,1,4,1,12015,12048,18
Task 12015,Job 1,13,9,2,11,0,15,24,9,2,2,0,12015,12048,5
Task 12016,Job 0,7,4,2,9,0,9,16,7,2,2,0,12016,12050,8
Task 12016,Job 1,12,4,2,11,0,14,23,9,2,3,0,12016,12050,6
Task 12017,Job 0,2,7,3,8,1,5,10,5,3,1,0,12017,12050,16
Task 12017,Job 1,7,5,4,8,0,11,15,4,4,2,2,12017,12050,5
Task 12018,Job 0,7,9,4,10,0,11,17,6,4,1,2,12018,12051,18
Task 12018,Job 1,12,9,4,7,0,16,19,3,4,3,1,12018,12051,11
Task 12019,Job 0,7,8,2,7,0,9,14,5,2,3,0,12019,12053,8
Task 12019,Job 1,12,5,1,11,1,13,23,10,1,4,0,12019,12053,7
Task 12020,Job 0,8,9,4,8,0,12,16,4,4,3,0,12020,12054,6
Task 12020,Job 1,13,6,1,8,0,14,21,7,1,3,2,12020,12054,17
Task 12021,Job 0,3,7,4,11,0,7,14,7,4,1,1,12021,12055,10
Task 12021,Job 1,8,5,4,6,0,12,14,2,4,2,1,12021,12055,20
Task 12022,Job 0,2,10,2,9,0,4,11,7,2,2,2,12022,12055,6
Task 12022,Job 1,7,4,1,8,1,8,15,7,1,4,1,12022,12055,17
Task 12023,Job 0,6,5,3,7,0,9,13,4,3,1,2,12023,12057,18
Task 12023,Job 1,11,8,1,7,0,12,18,6,1,2,0,12023,12057,8
Task 12024,Job 0,1,7,4,10,1,5,11,6,4,3,2,12024,12057,2
Task 12024,Job 1,6,6,2,12,0,8,18,10,2,4,1,12024,12057,3
Task 12025,Job 0,8,10,2,7,0,10,15,5,2,4,1,12025,12059,2
Task 12025,Job 1,13,4,2,10,0,15,23,8,2,1,2,12025,12059,14
Task 12026,Job 0,5,7,3,7,1,8,12,4,3,2,1,12026,12059,13
Task 12026,Job 1,10,5,4,7,0,14,17,3,4,4,1,12026,12059,5
Task 12027,Job 0,10,10,1,7,0,11,17,6,1,2,1,12027,12060,5
Task 12027,Job 1,15,9,2,12,0,17,27,10,2,4,0,12027,12060,15
Task 12028,Job 0,1,6,1,8,1,2,9,7,1,2,0,12028,12061,20
Task 12028,Job 1,6,6,2,6,1,8,12,4,2,2,2,12028,12061,16
Task 12029,Job 0,2,5,3,9,1,5,11,6,3,2,2,12029,12062,2
Task 12029,Job 1,7,4,3,10,0,10,17,7,3,2,0,12029,12062,16
Task 12030,Job 0,4,9,4,8,0,8,12,4,4,1,0,12030,12064,5
Task 12030,Job 1,9,9,2,6,0,11,15,4,2,2,2,12030,12064,6
Task 12031,Job 0,1,5,3,12,0,4,13,9,3,2,0,12031,12064,3
Task 12031,Job 1,6,5,4,7,0,10,13,3,4,4,1,12031,12064,14
Task 12032,Job 0,10,9,4,6,1,14,16,2,4,1,0,12032,12066,6
Task 12032,Job 1,15,10,4,6,0,19,21,2,4,3,0,12032,12066,19
Task 12033,Job 0,6,8,3,11,0,9,17,8,3,2,0,12033,12067,10
Task 12033,Job 1,11,5,1,10,0,12,21,9,1,4,1,12033,12067,14
Task 12034,Job 0,10,7,2,10,1,12,20,8,2,3,1,12034,12068,10
Task 12034,Job 1,15,7,1,7,0,16,22,6,1,3,1,12034,12068,12
Task 12035,Job 0,7,10,4,7,0,11,14,3,4,1,0,12035,12068,10
Task 12035,Job 1,12,7,1,6,1,13,18,5,1,2,2,12035,12068,9
Task 12036,Job 0,3,8,2,7,0,5,10,5,2,3,1,12036,12069,18
Task 12036,Job 1,8,6,2,10,0,10,18,8,2,1,0,12036,12069,7
Task 12037,Job 0,9,6,4,7,0,13,16,3,4,3,1,12037,12071,10
Task 12037,Job 1,14,4,4,7,0,18,21,3,4,3,2,12037,12071,4
Task 12038,Job 0,1,6,3,6,1,4,7,3,3,4,2,12038,12072,8
Task 12038,Job 1,6,8,1,7,0,7,13,6,1,4,1,12038,12072,16
Task 12039,Job 0,5,7,1,12,0,6,17,11,1,4,2,12039,12073,10
Task 12039,Job 1,10,5,1,8,0,11,18,7,1,3,2,12039,12073,6
Task 12040,Job 0,4,6,2,11,0,6,15,9,2,1,1,12040,12073,7
Task 12040,Job 1,9,8,4,10,0,13,19,6,4,1,1,12040,12073,6
Task 12041,Job 0,4,7,1,7,1,5,11,6,1,3,2,12041,12075,4
Task 12041,Job 1,9,4,1,12,0,10,21,11,1,2,2,12041,12075,14
Task 12042,Job 0,1,10,3,10,0,4,11,7,3,4,2,12042,12076,4
Task 12042,Job 1,6,9,2,7,0,8,13,5,2,3,2,12042,12076,17
Task 12043,Job 0,5,8,3,7,0,8,12,4,3,4,2,12043,12076,13
Task 12043,Job 1,10,7,1,12,0,11,22,11,1,3,2,12043,12076,2
Task 12044,Job 0,4,5,2,9,0,6,13,7,2,4,1,12044,12078,19
Task 12044,Job 1,9,6,3,6,0,12,15,3,3,1,2,12044,12078,18
Task 12045,Job 0,10,4,2,8,0,12,18,6,2,2,1,12045,12079,19
Task 12045,Job 1,15,7,2,6,1,17,21,4,2,4,1,12045,12079,5
Task 12046,Job 0,1,4,2,6,0,3,7,4,2,1,1,12046,12079,15
Task 12046,Job 1,6,7,1,10,0,7,16,9,1,4,0,12046,12079,16
Task 12047,Job 0,7,6,2,6,1,9,13,4,2,1,0,12047,12081,11
Task 12047,Job 1,12,6,2,12,1,14,24,10,2,4,2,12047,12081,15
Task 12048,Job 0,2,10,3,6,0,5,8,3,3,3,2,12048,12082,3
Task 12048,Job 1,7,7,4,7,1,11,14,3,4,2,2,12048,12082,10
Task 12049,Job 0,5,10,2,11,1,7,16,9,2,4,0,12049,12083,20
Task 12049,Job 1,10,6,3,12,1,13,22,9,3,2,0,12049,12083,18
Task 12050,Job 0,9,9,1,7,0,10,16,6,1,3,2,12050,12084,7
Task 12050,Job 1,14,5,3,8,0,17,22,5,3,2,0,12050,12084,18
Task 12051,Job 0,4,6,1,12,0,5,16,11,1,1,1,12051,12084,20
Task 12051,Job 1,9,6,3,9,0,12,18,6,3,4,1,12051,12084,4
Task 12052,Job 0,10,7,3,8,0,13,18,5,3,2,0,12052,12085,8
Task 12052,Job 1,15,6,3,7,0,18,22,4,3,4,1,12052,12085,15
Task 12053,Job 0,6,7,2,11,0,8,17,9,2,2,2,12053,12087,15
Task 12053,Job 1,11,5,3,12,1,14,23,9,3,3,2,12053,12087,18
Task 12054,Job 0,10,4,1,11,1,11,21,10,1,1,2,12054,12087,6
Task 12054,Job 1,15,4,1,11,0,16,26,10,1,2,0,12054,12087,4
Task 12055,Job 0,10,8,3,10,1,13,20,7,3,3,1,12055,12088,3
Task 12055,Job 1,15,7,2,11,1,17,26,9,2,3,2,12055,12088,4
Task 12056,Job 0,6,5,3,12,0,9,18,9,3,1,1,12056,12089,2
Task 12056,Job 1,11,10,2,12,1,13,23,10,2,3,0,12056,12089,15
Task 12057,Job 0,2,6,3,8,0,5,10,5,3,3,0,12057,12091,9
Task 12057,Job 1,7,8,3,12,0,10,19,9,3,3,1,12057,12091,19
Task 12058,Job 0,4,4,2,10,0,6,14,8,2,2,1,12058,12091,4
Task 12058,Job 1,9,6,2,12,0,11,21,10,2,3,1,12058,12091,8
Task 12059,Job 0,10,10,2,10,0,12,20,8,2,3,2,12059,12092,6
Task 12059,Job 1,15,5,2,11,1,17,26,9,2,3,1,12059,12092,5
Task 12060,Job 0,8,9,1,9,1,9,17,8,1,4,1,12060,12093,12
Task 12060,Job 1,13,8,2,9,0,15,22,7,2,1,1,12060,12093,20
Task 12061,Job 0,8,9,2,12,0,10,20,10,2,2,2,12061,12095,13
Task 12061,Job 1,13,7,2,7,1,15,20,5,2,4,2,12061,12095,18
Task 12062,Job 0,3,9,3,6,1,6,9,3,3,3,0,12062,12095,18
Task 12062,Job 1,8,7,3,6,0,11,14,3,3,1,2,12062,12095,7
Task 12063,Job 0,9,7,4,10,0,13,19,6,4,4,2,12063,12097,11
Task 12063,Job 1,14,9,3,10,0,17,24,7,3,3,1,12063,12097,3
Task 12064,Job 0,1,9,4,10,0,5,11,6,4,2,0,12064,12098,13
Task 12064,Job 1,6,10,1,6,0,7,12,5,1,4,1,12064,12098,13
Task 12065,Job 0,2,6,1,12,1,3,14,11,1,1,1,12065,12098,18
Task 12065,Job 1,7,5,3,10,0,10,17,7,3,1,2,12065,12098,17
Task 12066,Job 0,3,5,2,8,1,5,11,6,2,3,1,12066,12100,8
Task 12066,Job 1,8,8,3,11,0,11,19,8,3,4,1,12066,12100,2
Task 12067,Job 0,1,8,1,12,1,2,13,11,1,4,1,12067,12101,9
Task 12067,Job 1,6,8,3,11,0,9,17,8,3,3,1,12067,12101,8
Task 12068,Job 0,10,7,2,6,0,12,16,4,2,4,0,12068,12101,4
Task 12068,Job 1,15,6,1,7,1,16,22,6,1,4,2,12068,12101,10
Task 12069,Job 0,2,7,2,7,1,4,9,5,2,3,1,12069,12103,15
Task 12069,Job 1,7,4,2,12,0,9,19,10,2,4,1,12069,12103,5
Task 12070,Job 0,5,5,1,6,0,6,11,5,1,1,0,12070,12104,14
Task 12070,Job 1,10,9,1,6,0,11,16,5,1,2,0,12070,12104,12
Task 12071,Job 0,2,9,2,10,0,4,12,8,2,4,0,12071,12105,4
Task 12071,Job 1,7,8,4,7,0,11,14,3,4,2,0,12071,12105,2
Task 12072,Job 0,6,7,1,7,0,7,13,6,1,2,1,12072,12106,10
Task 12072,Job 1,11,9,1,9,0,12,20,8,1,1,0,12072,12106,11
Task 12073,Job 0,5,5,4,12,0,9,17,8,4,1,0,12073,12106,5
Task 12073,Job 1,10,9,2,12,0,12,22,10,2,3,1,12073,12106,20
Task 12074,Job 0,10,10,3,8,1,13,18,5,3,1,0,12074,12108,9
Task 12074,Job 1,15,4,2,6,0,17,21,4,2,4,2,12074,12108,7
Task 12075,Job 0,3,5,2,6,1,5,9,4,2,4,0,12075,12109,10
Task 12075,Job 1,8,9,2,10,1,10,18,8,2,3,0,12075,12109,17
Task 12076,Job 0,5,8,2,6,0,7,11,4,2,1,1,12076,12109,3
Task 12076,Job 1,10,4,3,10,0,13,20,7,3,4,0,12076,12109,5
Task 12077,Job 0,4,8,2,6,0,6,10,4,2,2,1,12077,12110,7
Task 12077,Job 1,9,8,1,8,1,10,17,7,1,1,2,12077,12110,20
Task 12078,Job 0,6,9,4,6,0,10,12,2,4,2,2,12078,12112,2
Task 12078,Job 1,11,7,2,11,0,13,22,9,2,3,2,12078,12112,3
Task 12079,Job 0,5,10,3,12,0,8,17,9,3,3,2,12079,12112,19
Task 12079,Job 1,10,6,1,8,0,11,18,7,1,3,2,12079,12112,15
Task 12080,Job 0,8,9,1,7,1,9,15,6,1,1,1,12080,12114,18
Task 12080,Job 1,13,8,1,6,0,14,19,5,1,1,2,12080,12114,13
Task 12081,Job 0,8,10,3,11,0,11,19,8,3,2,2,12081,12114,12
Task 12081,Job 1,13,7,3,9,0,16,22,6,3,4,2,12081,12114,18
Task 12082,Job 0,5,7,2,12,1,7,17,10,2,2,2,12082,12116,12
Task 12082,Job 1,10,9,3,8,0,13,18,5,3,1,2,12082,12116,4
Task 12083,Job 0,9,10,4,11,0,13,20,7,4,2,1,12083,12116,14
Task 12083,Job 1,14,8,2,10,1,16,24,8,2,1,2,12083,12116,17
Task 12084,Job 0,7,9,1,7,0,8,14,6,1,3,1,12084,12117,14
Task 12084,Job 1,12,7,1,8,0,13,20,7,1,3,1,12084,12117,16
Task 12085,Job 0,10,8,4,6,1,14,16,2,4,3,1,12085,12119,14
Task 12085,Job 1,15,9,3,9,0,18,24,6,3,1,2,12085,12119,5
Task 12086,Job 0,4,9,2,10,0,6,14,8,2,3,0,12086,12119,6
Task 12086,Job 1,9,8,3,8,0,12,17,5,3,2,2,12086,12119,20
Task 12087,Job 0,3,10,2,8,0,5,11,6,2,1,0,12087,12120,14
Task 12087,Job 1,8,6,3,6,0,11,14,3,3,3,1,12087,12120,8
Task 12088,Job 0,3,4,3,11,0,6,14,8,3,4,0,12088,12122,20
Task 12088,Job 1,8,6,2,8,0,10,16,6,2,2,2,12088,12122,4
Task 12089,Job 0,8,9,2,7,1,10,15,5,2,3,0,12089,12123,14
Task 12089,Job 1,13,9,4,7,0,17,20,3,4,2,2,12089,12123,8
Task 12090,Job 0,4,5,2,7,0,6,11,5,2,2,0,12090,12124,3
Task 12090,Job 1,9,7,3,8,1,12,17,5,3,2,0,12090,12124,8
Task 12091,Job 0,9,8,1,8,0,10,17,7,1,1,0,12091,12125,16
Task 12091,Job 1,14,6,4,8,0,18,22,4,4,3,0,12091,12125,12
Task 12092,Job 0,1,8,2,9,0,3,10,7,2,4,0,12092,12126,4
Task 12092,Job 1,6,10,3,11,1,9,17,8,3,4,2,12092,12126,20
Task 12093,Job 0,7,7,2,7,0,9,14,5,2,2,0,12093,12126,17
Task 12093,Job 1,12,4,1,12,0,13,24,11,1,2,2,12093,12126,10
Task 12094,Job 0,8,6,3,8,0,11,16,5,3,3,1,12094,12127,19
Task 12094,Job 1,13,10,3,7,0,16,20,4,3,1,1,12094,12127,7
Task 12095,Job 0,3,5,3,8,0,6,11,5,3,2,1,12095,12128,9
Task 12095,Job 1,8,10,2,7,0,10,15,5,2,3,0,12095,12128,11
Task 12096,Job 0,6,10,4,6,0,10,12,2,4,4,0,12096,12129,16
Task 12096,Job 1,11,6,2,9,0,13,20,7,2,3,0,12096,12129,15
Task 12097,Job 0,2,9,4,11,0,6,13,7,4,4,1,12097,12130,3
Task 12097,Job 1,7,7,2,9,0,9,16,7,2,1,2,12097,12130,6
Task 12098,Job 0,9,9,2,12,0,11,21,10,2,3,1,12098,12132,11
Task 12098,Job 1,14,7,1,8,0,15,22,7,1,3,1,12098,12132,15
Task 12099,Job 0,2,9,4,6,1,6,8,2,4,1,0,12099,12133,8
Task 12099,Job 1,7,5,4,11,0,11,18,7,4,3,0,12099,12133,16
Task 12100,Job 0,4,10,1,11,0,5,15,10,1,3,0,12100,12134,9
Task 12100,Job 1,9,10,4,7,0,13,16,3,4,2,2,12100,12134,8
Task 12101,Job 0,3,6,4,7,0,7,10,3,4,1,2,12101,12134,10
Task 12101,Job 1,8,10,2,6,0,10,14,4,2,2,1,12101,12134,8
Task 12102,Job 0,1,10,1,10,0,2,11,9,1,2,2,12102,12136,2
Task 12102,Job 1,6,8,2,10,0,8,16,8,2,1,0,12102,12136,13
Task 12103,Job 0,8,10,2,12,1,10,20,10,2,4,2,12103,12137,4
Task 12103,Job 1,13,9,2,12,0,15,25,10,2,2,1,12103,12137,3
Task 12104,Job 0,6,6,4,12,0,10,18,8,4,4,2,12104,12138,13
Task 12104,Job 1,11,8,3,8,0,14,19,5,3,3,2,12104,12138,9
Task 12105,Job 0,1,10,4,8,0,5,9,4,4,4,0,12105,12139,15
Task 12105,Job 1,6,6,2,12,0,8,18,10,2,2,0,12105,12139,9
Task 12106,Job 0,6,7,3,12,0,9,18,9,3,4,0,12106,12139,8
Task 12106,Job 1,11,9,3,12,0,14,23,9,3,3,2,12106,12139,7
Task 12107,Job 0,10,4,1,10,0,11,20,9,1,2,1,12107,12141,17
Task 12107,Job 1,15,6,3,10,0,18,25,7,3,1,1,12107,12141,7
Task 12108,Job 0,1,4,3,9,0,4,10,6,3,1,0,12108,12142,3
Task 12108,Job 1,6,9,4,11,0,10,17,7,4,3,0,12108,12142,5
Task 12109,Job 0,6,7,4,9,0,10,15,5,4,4,0,12109,12142,12
Task 12109,Job 1,11,4,2,10,0,13,21,8,2,1,1,12109,12142,3
Task 12110,Job 0,3,6,4,11,0,7,14,7,4,1,0,12110,12144,7
Task 12110,Job 1,8,8,4,11,1,12,19,7,4,4,2,12110,12144,17
Task 12111,Job 0,2,6,4,6,0,6,8,2,4,4,0,12111,12145,19
Task 12111,Job 1,7,10,3,6,0,10,13,3,3,4,2,12111,12145,17
Task 12112,Job 0,5,7,2,9,0,7,14,7,2,3,2,12112,12146,16
Task 12112,Job 1,10,5,2,11,0,12,21,9,2,2,2,12112,12146,2
Task 12113,Job 0,4,5,3,6,0,7,10,3,3,3,2,12113,12146,8
Task 12113,Job 1,9,9,3,12,1,12,21,9,3,3,2,12113,12146,12
Task 12114,Job 0,4,7,2,9,1,6,13,7,2,4,2,12114,12147,9
Task 12114,Job 1,9,7,1,6,1,10,15,5,1,2,0,12114,12147,8
Task 12115,Job 0,5,8,3,6,0,8,11,3,3,3,1,12115,12148,15
Task 12115,Job 1,10,7,1,6,0,11,16,5,1,3,0,12115,12148,17
Task 12116,Job 0,10,6,1,6,0,11,16,5,1,3,1,12116,12150,6
Task 12116,Job 1,15,6,1,7,0,16,22,6,1,2,1,12116,12150,9
Task 12117,Job 0,4,7,4,12,0,8,16,8,4,3,0,12117,12150,4
Task 12117,Job 1,9,5,3,12,1,12,21,9,3,1,0,12117,12150,18
Task 12118,Job 0,5,10,2,12,0,7,17,10,2,3,0,12118,12152,6
Task 12118,Job 1,10,6,4,10,0,14,20,6,4,3,0,12118,12152,7
Task 12119,Job 0,6,4,1,12,1,7,18,11,1,4,1,12119,12152,6
Task 12119,Job 1,11,7,3,10,0,14,21,7,3,4,0,12119,12152,3
Task 12120,Job 0,3,9,3,12,0,6,15,9,3,3,1,12120,12153,20
Task 12120,Job 1,8,5,2,7,0,10,15,5,2,1,1,12120,12153,17
Task 12121,Job 0,10,5,3,9,1,13,19,6,3,4,2,12121,12154,5
Task 12121,Job 1,15,6,2,10,0,17,25,8,2,1,0,12121,12154,12
Task 12122,Job 0,9,9,4,12,0,13,21,8,4,2,0,12122,12156,3
Task 12122,Job 1,14,6,2,11,0,16,25,9,2,3,0,12122,12156,18
Task 12123,Job 0,8,9,4,9,0,12,17,5,4,1,1,12123,12157,13
Task 12123,Job 1,13,9,3,11,0,16,24,8,3,1,0,12123,12157,5
Task 12124,Job 0,1,5,4,9,0,5,10,5,4,3,2,12124,12157,5
Task 12124,Job 1,6,7,3,11,1,9,17,8,3,1,0,12124,12157,13
Task 12125,Job 0,6,4,2,12,0,8,18,10,2,4,0,12125,12159,3
Task 12125,Job 1,11,6,3,7,1,14,18,4,3,2,2,12125,12159,12
Task 12126,Job 0,3,6,4,6,1,7,9,2,4,4,1,12126,12160,2
Task 12126,Job 1,8,5,1,9,0,9,17,8,1,4,0,12126,12160,8
Task 12127,Job 0,1,6,4,6,0,5,7,2,4,2,1,12127,12160,15
Task 12127,Job 1,6,8,1,10,0,7,16,9,1,3,1,12127,12160,9
Task 12128,Job 0,1,10,1,10,0,2,11,9,1,4,2,12128,12161,12
Task 12128,Job 1,6,4,4,6,0,10,12,2,4,4,0,12128,12161,14
Task 12129,Job 0,4,9,1,11,0,5,15,10,1,3,2,12129,12163,20
Task 12129,Job 1,9,10,1,11,0,10,20,10,1,4,2,12129,12163,16
Task 12130,Job 0,2,6,4,8,0,6,10,4,4,3,2,12130,12163,3
Task 12130,Job 1,7,7,1,12,1,8,19,11,1,3,2,12130,12163,3
Task 12131,Job 0,3,4,1,8,0,4,11,7,1,1,1,12131,12164,12
Task 12131,Job 1,8,7,3,7,1,11,15,4,3,2,1,12131,12164,7
Task 12132,Job 0,9,8,2,7,0,11,16,5,2,3,2,12132,12165,11
Task 12132,Job 1,14,5,2,11,1,16,25,9,2,4,0,12132,12165,13
Task 12133,Job 0,7,6,3,7,0,10,14,4,3,3,0,12133,12167,7
Task 12133,Job 1,12,10,3,10,0,15,22,7,3,2,2,12133,12167,12
Task 12134,Job 0,10,9,4,11,0,14,21,7,4,1,1,12134,12168,15
Task 12134,Job 1,15,8,1,7,0,16,22,6,1,1,0,12134,12168,13
Task 12135,Job 0,10,5,2,11,1,12,21,9,2,3,0,12135,12168,9
Task 12135,Job 1,15,10,3,9,0,18,24,6,3,3,2,12135,12168,19
Task 12136,Job 0,10,9,4,11,1,14,21,7,4,2,0,12136,12169,2
Task 12136,Job 1,15,6,3,8,0,18,23,5,3,2,0,12136,12169,9
Task 12137,Job 0,4,4,4,11,0,8,15,7,4,1,1,12137,12171,10
Task 12137,Job 1,9,7,2,12,0,11,21,10,2,1,1,12137,12171,5
Task 12138,Job 0,8,9,3,6,0,11,14,3,3,4,0,12138,12171,16
Task 12138,Job 1,13,7,4,10,0,17,23,6,4,1,0,12138,12171,7
Task 12139,Job 0,7,10,1,9,0,8,16,8,1,2,0,12139,12172,7
Task 12139,Job 1,12,6,4,6,0,16,18,2,4,3,1,12139,12172,6
Task 12140,Job 0,10,10,4,12,0,14,22,8,4,2,0,12140,12173,18
Task 12140,Job 1,15,10,4,8,0,19,23,4,4,2,2,12140,12173,5
Task 12141,Job 0,10,10,4,8,1,14,18,4,4,3,2,12141,12174,16
Task 12141,Job 1,15,8,3,10,0,18,25,7,3,3,2,12141,12174,17
Task 12142,Job 0,7,6,1,6,1,8,13,5,1,3,1,12142,12175,10
Task 12142,Job 1,12,9,4,9,1,16,21,5,4,3,0,12142,12175,5
Task 12143,Job 0,1,7,2,11,0,3,12,9,2,2,1,12143,12177,16
Task 12143,Job 1,6,10,2,11,0,8,17,9,2,2,2,12143,12177,7
Task 12144,Job 0,6,5,2,12,0,8,18,10,2,1,0,12144,12178,2
Task 12144,Job 1,11,9,3,6,0,14,17,3,3,4,0,12144,12178,14
Task 12145,Job 0,2,8,1,10,1,3,12,9,1,4,2,12145,12178,10
Task 12145,Job 1,7,5,3,6,0,10,13,3,3,1,0,12145,12178,17
Task 12146,Job 0,9,4,4,9,0,13,18,5,4,2,1,12146,12179,8
Task 12146,Job 1,14,8,1,7,0,15,21,6,1,3,0,12146,12179,9
Task 12147,Job 0,1,10,2,10,1,3,11,8,2,1,1,12147,12181,16
Task 12147,Job 1,6,6,4,12,1,10,18,8,4,1,2,12147,12181,9
Task 12148,Job 0,7,8,3,6,0,10,13,3,3,2,2,12148,12182,6
Task 12148,Job 1,12,8,4,8,0,16,20,4,4,3,0,12148,12182,14
Task 12149,Job 0,8,6,4,12,0,12,20,8,4,2,1,12149,12183,3
Task 12149,Job 1,13,4,2,9,0,15,22,7,2,1,2,12149,12183,11
Task 12150,Job 0,6,7,3,8,0,9,14,5,3,1,1,12150,12183,10
Task 12150,Job 1,11,4,4,9,0,15,20,5,4,3,2,12150,12183,9
Task 12151,Job 0,4,7,3,8,1,7,12,5,3,1,2,12151,12184,2
Task 12151,Job 1,9,9,1,6,1,10,15,5,1,4,2,12151,12184,15
Task 12152,Job 0,6,8,2,6,0,8,12,4,2,3,0,12152,12185,18
Task 12152,Job 1,11,7,2,6,0,13,17,4,2,1,2,12152,12185,6
Task 12153,Job 0,10,6,4,10,0,14,20,6,4,1,0,12153,12187,10
Task 12153,Job 1,15,7,3,6,1,18,21,3,3,1,2,12153,12187,16
Task 12154,Job 0,5,4,2,12,0,7,17,10,2,1,1,12154,12187,13
Task 12154,Job 1,10,8,1,6,0,11,16,5,1,4,0,12154,12187,15
Task 12155,Job 0,3,10,4,12,0,7,15,8,4,2,2,12155,12188,16
Task 12155,Job 1,8,6,3,11,1,11,19,8,3,3,1,12155,12188,5
Task 12156,Job 0,5,7,4,12,0,9,17,8,4,3,1,12156,12189,5
Task 12156,Job 1,10,8,1,8,0,11,18,7,1,4,0,12156,12189,17
Task 12157,Job 0,4,8,3,9,0,7,13,6,3,4,1,12157,12190,20
Task 12157,Job 1,9,6,2,12,0,11,21,10,2,4,2,12157,12190,5
Task 12158,Job 0,3,9,3,11,0,6,14,8,3,4,2,12158,12192,12
Task 12158,Job 1,8,4,2,7,0,10,15,5,2,3,2,12158,12192,15
Task 12159,Job 0,4,7,1,7,0,5,11,6,1,2,1,12159,12193,19
Task 12159,Job 1,9,10,3,12,0,12,21,9,3,3,0,12159,12193,11
Task 12160,Job 0,5,8,2,6,1,7,11,4,2,1,0,12160,12194,15
Task 12160,Job 1,10,6,3,10,0,13,20,7,3,1,2,12160,12194,16
Task 12161,Job 0,4,9,3,9,1,7,13,6,3,1,0,12161,12195,17
Task 12161,Job 1,9,9,2,11,0,11,20,9,2,3,2,12161,12195,18
Task 12162,Job 0,6,8,4,12,0,10,18,8,4,1,2,12162,12196,17
Task 12162,Job 1,11,10,4,12,0,15,23,8,4,1,1,12162,12196,7
Task 12163,Job 0,8,7,3,10,0,11,18,7,3,1,2,12163,12196,16
Task 12163,Job 1,13,7,1,6,0,14,19,5,1,2,1,12163,12196,2
Task 12164,Job 0,7,4,1,12,0,8,19,11,1,1,0,12164,12197,9
Task 12164,Job 1,12,10,2,7,0,14,19,5,2,1,0,12164,12197,7
Task 12165,Job 0,5,4,1,12,1,6,17,11,1,2,2,12165,12199,6
Task 12165,Job 1,10,9,2,9,1,12,19,7,2,2,2,12165,12199,6
Task 12166,Job 0,8,7,4,7,0,12,15,3,4,2,2,12166,12199,7
Task 12166,Job 1,13,4,2,9,0,15,22,7,2,2,0,12166,12199,13
Task 12167,Job 0,8,5,4,11,1,12,19,7,4,1,0,12167,12201,10
Task 12167,Job 1,13,6,4,6,0,17,19,2,4,1,0,12167,12201,3
Task 12168,Job 0,7,6,4,8,0,11,15,4,4,2,0,12168,12201,12
Task 12168,Job 1,12,7,3,10,0,15,22,7,3,3,1,12168,12201,8
Task 12169,Job 0,5,8,4,7,0,9,12,3,4,4,2,12169,12202,16
Task 12169,Job 1,10,7,4,11,0,14,21,7,4,2,0,12169,12202,8
Task 12170,Job 0,9,6,3,7,1,12,16,4,3,3,0,12170,12203,9
Task 12170,Job 1,14,6,2,8,1,16,22,6,2,1,2,12170,12203,14
Task 12171,Job 0,6,4,4,10,1,10,16,6,4,3,1,12171,12204,6
Task 12171,Job 1,11,7,2,8,0,13,19,6,2,3,0,12171,12204,20
Task 12172,Job 0,8,5,2,9,1,10,17,7,2,4,2,12172,12206,10
Task 12172,Job 1,13,5,4,10,0,17,23,6,4,2,0,12172,12206,12
Task 12173,Job 0,8,9,4,12,0,12,20,8,4,2,1,12173,12206,6
Task 12173,Job 1,13,9,2,6,1,15,19,4,2,2,2,12173,12206,6
Task 12174,Job 0,7,4,2,11,1,9,18,9,2,1,2,12174,12207,19
Task 12174,Job 1,12,10,1,10,0,13,22,9,1,3,2,12174,12207,2
Task 12175,Job 0,2,10,3,10,0,5,12,7,3,1,0,12175,12208,15
Task 12175,Job 1,7,10,4,11,1,11,18,7,4,3,0,12175,12208,15
Task 12176,Job 0,6,9,4,9,0,10,15,5,4,2,2,12176,12210,14
Task 12176,Job 1,11,8,2,8,0,13,19,6,2,4,0,12176,12210,20
Task 12177,Job 0,8,8,1,7,0,9,15,6,1,4,0,12177,12211,16
Task 12177,Job 1,13,6,4,9,0,17,22,5,4,4,1,12177,12211,10
Task 12178,Job 0,4,10,1,10,0,5,14,9,1,2,1,12178,12212,5
Task 12178,Job 1,9,5,1,10,1,10,19,9,1,3,1,12178,12212,8
Task 12179,Job 0,3,5,4,9,0,7,12,5,4,2,1,12179,12213,20
Task 12179,Job 1,8,4,2,7,0,10,15,5,2,1,1,12179,12213,19
Task 12180,Job 0,10,10,2,7,0,12,17,5,2,4,1,12180,12213,14
Task 12180,Job 1,15,9,4,9,0,19,24,5,4,1,0,12180,12213,10
Task 12181,Job 0,5,10,1,6,1,6,11,5,1,4,2,12181,12215,8
Task 12181,Job 1,10,9,1,12,0,11,22,11,1,4,2,12181,12215,9
Task 12182,Job 0,8,7,2,9,0,10,17,7,2,2,0,12182,12216,5
Task 12182,Job 1,13,5,4,12,0,17,25,8,4,1,1,12182,12216,12
Task 12183,Job 0,1,7,1,11,0,2,12,10,1,4,2,12183,12217,6
Task 12183,Job 1,6,6,2,8,0,8,14,6,2,1,1,12183,12217,19
Task 12184,Job 0,10,5,2,8,0,12,18,6,2,4,1,12184,12217,18
Task 12184,Job 1,15,6,2,6,0,17,21,4,2,4,1,12184,12217,13
Task 12185,Job 0,2,5,1,6,1,3,8,5,1,1,2,12185,12218,6
Task 12185,Job 1,7,9,2,9,0,9,16,7,2,4,2,12185,12218,5
Task 12186,Job 0,9,8,3,9,0,12,18,6,3,2,2,12186,12220,6
Task 12186,Job 1,14,4,4,7,0,18,21,3,4,2,0,12186,12220,13
Task 12187,Job 0,1,4,2,12,0,3,13,10,2,2,0,12187,12221,20
Task 12187,Job 1,6,10,4,11,1,10,17,7,4,1,1,12187,12221,2
Task 12188,Job 0,3,10,3,11,1,6,14,8,3,4,2,12188,12222,13
Task 12188,Job 1,8,8,4,7,0,12,15,3,4,3,1,12188,12222,8
Task 12189,Job 0,8,10,1,11,1,9,19,10,1,2,0,12189,12223,2
Task 12189,Job 1,13,10,4,9,0,17,22,5,4,2,0,12189,12223,17
Task 12190,Job 0,9,9,4,12,0,13,21,8,4,2,2,12190,12223,2
Task 12190,Job 1,14,6,1,11,0,15,25,10,1,3,1,12190,12223,6
Task 12191,Job 0,2,4,3,10,0,5,12,7,3,2,1,12191,12225,11
Task 12191,Job 1,7,7,2,8,0,9,15,6,2,3,1,12191,12225,4
Task 12192,Job 0,7,4,2,12,0,9,19,10,2,4,2,12192,12225,9
Task 12192,Job 1,12,8,4,6,0,16,18,2,4,1,0,12192,12225,11
Task 12193,Job 0,2,4,2,10,0,4,12,8,2,4,1,12193,12226,11
Task 12193,Job 1,7,5,4,7,0,11,14,3,4,4,1,12193,12226,5
Task 12194,Job 0,7,8,2,11,0,9,18,9,2,4,2,12194,12227,20
Task 12194,Job 1,12,8,4,6,1,16,18,2,4,1,2,12194,12227,4
Task 12195,Job 0,2,10,4,9,0,6,11,5,4,3,1,12195,12229,6
Task 12195,Job 1,7,8,2,6,0,9,13,4,2,2,1,12195,12229,9
Task 12196,Job 0,2,9,1,7,0,3,9,6,1,2,0,12196,12229,13
Task 12196,Job 1,7,9,1,11,0,8,18,10,1,3,1,12196,12229,10
Task 12197,Job 0,10,8,1,8,0,11,18,7,1,3,1,12197,12230,11
Task 12197,Job 1,15,6,2,6,0,17,21,4,2,1,0,12197,12230,13
Task 12198,Job 0,5,9,3,8,0,8,13,5,3,3,2,12198,12231,2
Task 12198,Job 1,10,6,1,12,0,11,22,11,1,2,1,12198,12231,11
Task 12199,Job 0,6,10,2,10,0,8,16,8,2,4,2,12199,12232,11
Task 12199,Job 1,11,7,4,6,0,15,17,2,4,2,2,12199,12232,17
Task 12200,Job 0,7,10,3,7,0,10,14,4,3,3,1,12200,12233,16
Task 12200,Job 1,12,6,1,6,1,13,18,5,1,3,2,12200,12233,5
Task 12201,Job 0,3,7,2,7,1,5,10,5,2,2,2,12201,12234,16
Task 12201,Job 1,8,9,2,12,1,10,20,10,2,1,0,12201,12234,11
Task 12202,Job 0,8,8,1,10,0,9,18,9,1,1,1,12202,12236,14
Task 12202,Job 1,13,4,1,7,1,14,20,6,1,2,2,12202,12236,5
Task 12203,Job 0,1,9,2,12,0,3,13,10,2,2,0,12203,12237,16
Task 12203,Job 1,6,5,3,9,0,9,15,6,3,1,2,12203,12237,19
Task 12204,Job 0,8,8,3,9,1,11,17,6,3,3,1,12204,12238,19
Task 12204,Job 1,13,9,3,9,1,16,22,6,3,3,0,12204,12238,2
Task 12205,Job 0,6,8,2,9,0,8,15,7,2,2,1,12205,12238,18
Task 12205,Job 1,11,5,4,7,0,15,18,3,4,1,1,12205,12238,4
Task 12206,Job 0,2,7,4,10,0,6,12,6,4,2,1,12206,12239,18
Task 12206,Job 1,7,6,2,9,0,9,16,7,2,4,2,12206,12239,10
Task 12207,Job 0,8,8,2,10,0,10,18,8,2,2,0,12207,12240,10
Task 12207,Job 1,13,8,3,11,0,16,24,8,3,1,0,12207,12240,11
Task 12208,Job 0,7,4,2,12,0,9,19,10,2,2,2,12208,12242,11
Task 12208,Job 1,12,10,4,10,0,16,22,6,4,1,1,12208,12242,13
Task 12209,Job 0,7,5,2,8,1,9,15,6,2,3,1,12209,12242,12
Task 12209,Job 1,12,6,3,8,0,15,20,5,3,2,0,12209,12242,14
Task 12210,Job 0,3,5,2,8,0,5,11,6,2,3,1,12210,12244,13
Task 12210,Job 1,8,9,1,12,0,9,20,11,1,4,0,12210,12244,10
Task 12211,Job 0,9,4,3,7,1,12,16,4,3,3,2,12211,12244,3
Task 12211,Job 1,14,6,2,6,1,16,20,4,2,2,2,12211,12244,20
Task 12212,Job 0,5,5,1,8,0,6,13,7,1,4,2,12212,12245,11
Task 12212,Job 1,10,9,3,8,0,13,18,5,3,1,0,12212,12245,17
Task 12213,Job 0,7,10,3,10,0,10,17,7,3,1,2,12213,12246,20
Task 12213,Job 1,12,7,4,12,0,16,24,8,4,1,2,12213,12246,15
Task 12214,Job 0,4,5,1,6,0,5,10,5,1,3,2,12214,12247,17
Task 12214,Job 1,9,9,4,8,1,13,17,4,4,3,1,12214,12247,8
Task 12215,Job 0,2,8,3,8,0,5,10,5,3,2,1,12215,12249,20
Task 12215,Job 1,7,6,3,12,1,10,19,9,3,1,2,12215,12249,14
Task 12216,Job 0,1,10,4,8,0,5,9,4,4,3,2,12216,12250,5
Task 12216,Job 1,6,7,1,8,0,7,14,7,1,3,0,12216,12250,6
Task 12217,Job 0,4,10,2,6,0,6,10,4,2,2,0,12217,12251,3
Task 12217,Job 1,9,8,2,8,0,11,17,6,2,3,2,12217,12251,5
Task 12218,Job 0,6,8,1,6,0,7,12,5,1,2,2,12218,12252,11
Task 12218,Job 1,11,5,4,8,0,15,19,4,4,4,1,12218,12252,15
Task 12219,Job 0,10,8,3,12,1,13,22,9,3,3,0,12219,12253,16
Task 12219,Job 1,15,4,1,8,0,16,23,7,1,2,0,12219,12253,6
Task 12220,Job 0,7,7,2,11,0,9,18,9,2,1,0,12220,12253,7
Task 12220,Job 1,12,7,4,10,1,16,22,6,4,4,2,12220,12253,2
Task 12221,Job 0,6,9,1,8,1,7,14,7,1,1,0,12221,12255,14
Task 12221,Job 1,11,7,3,6,0,14,17,3,3,2,1,12221,12255,3
Task 12222,Job 0,10,6,3,9,0,13,19,6,3,1,0,12222,12255,8
Task 12222,Job 1,15,10,3,8,0,18,23,5,3,1,1,12222,12255,2
Task 12223,Job 0,1,9,2,8,0,3,9,6,2,1,2,12223,12256,13
Task 12223,Job 1,6,9,4,10,1,10,16,6,4,1,1,12223,12256,15
Task 12224,Job 0,9,4,2,11,1,11,20,9,2,1,2,12224,12257,6
Task 12224,Job 1,14,9,2,7,0,16,21,5,2,3,1,12224,12257,13
Task 12225,Job 0,9,10,3,10,1,12,19,7,3,2,1,12225,12259,6
Task 12225,Job 1,14,10,1,7,0,15,21,6,1,3,0,12225,12259,11
Task 12226,Job 0,4,7,3,6,0,7,10,3,3,3,2,12226,12259,11
Task 12226,Job 1,9,10,1,6,0,10,15,5,1,3,0,12226,12259,10
Task 12227,Job 0,2,9,3,6,0,5,8,3,3,1,1,12227,12260,13
Task 12227,Job 1,7,5,2,12,0,9,19,10,2,4,0,12227,12260,6
Task 12228,Job 0,4,4,1,12,0,5,16,11,1,1,1,12228,12262,3
Task 12228,Job 1,9,4,1,7,0,10,16,6,1,1,2,12228,12262,2
Task 12229,Job 0,3,7,4,9,0,7,12,5,4,3,2,12229,12262,19
Task 12229,Job 1,8,10,3,9,0,11,17,6,3,4,1,12229,12262,11
Task 12230,Job 0,1,5,1,10,0,2,11,9,1,4,1,12230,12263,11
Task 12230,Job 1,6,5,2,7,0,8,13,5,2,3,2,12230,12263,16
Task 12231,Job 0,8,7,2,7,0,10,15,5,2,1,0,12231,12265,17
Task 12231,Job 1,13,4,1,10,0,14,23,9,1,4,0,12231,12265,13
Task 12232,Job 0,6,5,2,6,1,8,12,4,2,3,2,12232,12266,16
Task 12232,Job 1,11,5,2,11,0,13,22,9,2,1,2,12232,12266,9
Task 12233,Job 0,3,6,1,7,1,4,10,6,1,1,0,12233,12266,14
Task 12233,Job 1,8,4,3,7,0,11,15,4,3,4,2,12233,12266,3
Task 12234,Job 0,2,5,2,7,1,4,9,5,2,1,0,12234,12267,8
Task 12234,Job 1,7,5,3,8,0,10,15,5,3,3,0,12234,12267,17
Task 12235,Job 0,4,6,2,7,1,6,11,5,2,1,0,12235,12269,2
Task 12235,Job 1,9,9,4,7,0,13,16,3,4,3,2,12235,12269,4
Task 12236,Job 0,1,7,4,9,0,5,10,5,4,1,2,12236,12269,4
Task 12236,Job 1,6,7,4,11,0,10,17,7,4,2,1,12236,12269,8
Task 12237,Job 0,8,7,3,10,1,11,18,7,3,2,2,12237,12270,7
Task 12237,Job 1,13,10,2,6,0,15,19,4,2,2,1,12237,12270,14
Task 12238,Job 0,1,7,3,11,1,4,12,8,3,2,1,12238,12271,19
Task 12238,Job 1,6,6,3,6,0,9,12,3,3,4,0,12238,12271,6
Task 12239,Job 0,6,8,1,9,1,7,15,8,1,3,0,12239,12272,18
Task 12239,Job 1,11,6,4,11,1,15,22,7,4,2,0,12239,12272,7
Task 12240,Job 0,2,6,4,11,0,6,13,7,4,2,1,12240,12273,2
Task 12240,Job 1,7,6,3,6,1,10,13,3,3,3,1,12240,12273,8
Task 12241,Job 0,9,4,2,11,0,11,20,9,2,2,2,12241,12274,9
Task 12241,Job 1,14,9,1,9,1,15,23,8,1,2,1,12241,12274,16
Task 12242,Job 0,6,6,2,10,0,8,16,8,2,4,0,12242,12275,9
Task 12242,Job 1,11,9,3,11,0,14,22,8,3,2,2,12242,12275,9
Task 12243,Job 0,5,7,3,11,1,8,16,8,3,3,1,12243,12277,18
Task 12243,Job 1,10,5,4,10,1,14,20,6,4,4,1,12243,12277,6
Task 12244,Job 0,4,6,2,12,0,6,16,10,2,3,0,12244,12278,20
Task 12244,Job 1,9,9,2,10,0,11,19,8,2,2,1,12244,12278,3
Task 12245,Job 0,1,5,4,11,0,5,12,7,4,1,1,12245,12279,10
Task 12245,Job 1,6,9,1,11,0,7,17,10,1,3,0,12245,12279,2
Task 12246,Job 0,4,5,4,12,0,8,16,8,4,4,1,12246,12279,19
Task 12246,Job 1,9,4,4,12,0,13,21,8,4,2,1,12246,12279,6
Task 12247,Job 0,6,8,2,8,0,8,14,6,2,1,1,12247,12280,5
Task 12247,Job 1,11,4,1,6,1,12,17,5,1,3,2,12247,12280,2
Task 12248,Job 0,7,6,3,7,1,10,14,4,3,2,2,12248,12281,20
Task 12248,Job 1,12,8,3,7,1,15,19,4,3,3,0,12248,12281,10
Task 12249,Job 0,5,5,1,7,0,6,12,6,1,4,2,12249,12283,19
Task 12249,Job 1,10,9,2,12,1,12,22,10,2,2,1,12249,12283,3
Task 12250,Job 0,1,6,3,10,1,4,11,7,3,4,2,12250,12284,20
Task 12250,Job 1,6,5,4,9,1,10,15,5,4,1,0,12250,12284,14
Task 12251,Job 0,4,9,3,7,1,7,11,4,3,2,1,12251,12284,12
Task 12251,Job 1,9,7,4,7,1,13,16,3,4,4,0,12251,12284,9
Task 12252,Job 0,8,10,3,6,0,11,14,3,3,4,2,12252,12285,6
Task 12252,Job 1,13,5,4,12,0,17,25,8,4,2,0,12252,12285,13
Task 12253,Job 0,2,9,2,9,0,4,11,7,2,3,0,12253,12286,7
Task 12253,Job 1,7,6,2,9,1,9,16,7,2,1,2,12253,12286,6
Task 12254,Job 0,2,4,2,11,0,4,13,9,2,2,2,12254,12288,6
Task 12254,Job 1,7,4,1,9,0,8,16,8,1,4,2,12254,12288,3
Task 12255,Job 0,5,6,3,7,1,8,12,4,3,3,1,12255,12288,13
Task 12255,Job 1,10,10,2,6,0,12,16,4,2,2,2,12255,12288,13
Task 12256,Job 0,8,8,1,11,0,9,19,10,1,2,2,12256,12289,4
Task 12256,Job 1,13,10,4,9,0,17,22,5,4,1,1,12256,12289,13
Task 12257,Job 0,10,8,3,11,1,13,21,8,3,1,2,12257,12290,2
Task 12257,Job 1,15,7,1,6,0,16,21,5,1,3,1,12257,12290,6
Task 12258,Job 0,6,4,4,11,0,10,17,7,4,1,2,12258,12291,13
Task 12258,Job 1,11,10,3,10,0,14,21,7,3,4,2,12258,12291,10
Task 12259,Job 0,6,8,2,11,0,8,17,9,2,3,2,12259,12292,17
Task 12259,Job 1,11,7,3,10,0,14,21,7,3,3,1,12259,12292,20
Task 12260,Job 0,8,4,3,12,0,11,20,9,3,4,2,12260,12294,20
Task 12260,Job 1,13,10,1,7,0,14,20,6,1,1,1,12260,12294,7
Task 12261,Job 0,10,8,2,12,0,12,22,10,2,2,2,12261,12294,14
Task 12261,Job 1,15,7,3,9,0,18,24,6,3,1,2,12261,12294,15
Task 12262,Job 0,8,7,4,6,0,12,14,2,4,3,1,12262,12296,11
Task 12262,Job 1,13,7,2,10,0,15,23,8,2,3,1,12262,12296,10
Task 12263,Job 0,9,7,4,11,0,13,20,7,4,2,1,12263,12296,13
Task 12263,Job 1,14,9,1,7,0,15,21,6,1,4,2,12263,12296,17
Task 12264,Job 0,6,5,4,6,0,10,12,2,4,3,1,12264,12298,6
Task 12264,Job 1,11,9,3,7,1,14,18,4,3,2,1,12264,12298,12
Task 12265,Job 0,7,4,2,8,0,9,15,6,2,1,0,12265,12298,7
Task 12265,Job 1,12,8,2,6,1,14,18,4,2,1,1,12265,12298,2
Task 12266,Job 0,8,7,3,10,0,11,18,7,3,1,2,12266,12299,19
Task 12266,Job 1,13,5,1,6,0,14,19,5,1,3,0,12266,12299,12
Task 12267,Job 0,3,5,1,10,0,4,13,9,1,2,2,12267,12301,6
Task 12267,Job 1,8,7,1,6,0,9,14,5,1,3,0,12267,12301,12
Task 12268,Job 0,10,8,3,6,1,13,16,3,3,2,1,12268,12302,13
Task 12268,Job 1,15,4,4,7,0,19,22,3,4,3,1,12268,12302,5
Task 12269,Job 0,7,5,3,9,0,10,16,6,3,4,0,12269,12303,17
Task 12269,Job 1,12,4,2,6,1,14,18,4,2,4,2,12269,12303,13
Task 12270,Job 0,7,9,2,6,0,9,13,4,2,4,1,12270,12303,11
Task 12270,Job 1,12,6,3,9,0,15,21,6,3,3,0,12270,12303,14
Task 12271,Job 0,4,8,1,6,0,5,10,5,1,2,1,12271,12305,12
Task 12271,Job 1,9,7,4,10,0,13,19,6,4,2,0,12271,12305,5
Task 12272,Job 0,5,4,4,6,0,9,11,2,4,4,2,12272,12306,8
Task 12272,Job 1,10,5,1,12,0,11,22,11,1,1,1,12272,12306,12
Task 12273,Job 0,8,4,3,11,0,11,19,8,3,2,2,12273,12306,11
Task 12273,Job 1,13,5,3,12,0,16,25,9,3,1,1,12273,12306,3
Task 12274,Job 0,10,5,3,9,0,13,19,6,3,3,0,12274,12307,14
Task 12274,Job 1,15,10,4,7,0,19,22,3,4,2,1,12274,12307,12
Task 12275,Job 0,9,7,4,11,1,13,20,7,4,2,0,12275,12308,17
Task 12275,Job 1,14,5,3,7,0,17,21,4,3,2,2,12275,12308,14
Task 12276,Job 0,9,10,1,6,0,10,15,5,1,4,1,12276,12310,16
Task 12276,Job 1,14,6,1,12,1,15,26,11,1,2,2,12276,12310,10
Task 12277,Job 0,8,8,2,7,0,10,15,5,2,2,2,12277,12310,8
Task 12277,Job 1,13,4,2,11,0,15,24,9,2,4,0,12277,12310,19
Task 12278,Job 0,1,10,4,10,0,5,11,6,4,3,0,12278,12312,18
Task 12278,Job 1,6,4,4,11,1,10,17,7,4,2,2,12278,12312,9
Task 12279,Job 0,6,10,3,6,0,9,12,3,3,2,2,12279,12313,17
Task 12279,Job 1,11,9,1,12,0,12,23,11,1,2,1,12279,12313,20
Task 12280,Job 0,9,10,3,7,0,12,16,4,3,4,2,12280,12314,17
Task 12280,Job 1,14,9,3,8,0,17,22,5,3,1,0,12280,12314,4
Task 12281,Job 0,2,7,4,10,0,6,12,6,4,3,0,12281,12315,5
Task 12281,Job 1,7,4,4,10,0,11,17,6,4,2,2,12281,12315,19
Task 12282,Job 0,2,8,1,7,0,3,9,6,1,2,0,12282,12315,11
Task 12282,Job 1,7,6,3,12,0,10,19,9,3,3,0,12282,12315,4
Task 12283,Job 0,4,10,2,10,0,6,14,8,2,3,2,12283,12317,3
Task 12283,Job 1,9,8,1,12,0,10,21,11,1,1,0,12283,12317,3
Task 12284,Job 0,8,9,1,11,1,9,19,10,1,3,2,12284,12317,3
Task 12284,Job 1,13,7,4,9,0,17,22,5,4,4,1,12284,12317,18
Task 12285,Job 0,3,6,1,6,0,4,9,5,1,1,0,12285,12318,14
Task 12285,Job 1,8,5,4,10,0,12,18,6,4,1,0,12285,12318,9
Task 12286,Job 0,4,6,3,8,1,7,12,5,3,2,1,12286,12319,19
Task 12286,Job 1,9,7,4,11,0,13,20,7,4,3,2,12286,12319,9
Task 12287,Job 0,8,10,2,9,1,10,17,7,2,2,1,12287,12321,15
Task 12287,Job 1,13,10,4,6,0,17,19,2,4,1,0,12287,12321,15
Task 12288,Job 0,3,5,3,10,1,6,13,7,3,3,2,12288,12321,2
Task 12288,Job 1,8,7,4,10,0,12,18,6,4,1,2,12288,12321,14
Task 12289,Job 0,8,9,2,7,0,10,15,5,2,3,0,12289,12323,10
Task 12289,Job 1,13,8,4,9,0,17,22,5,4,2,0,12289,12323,4
Task 12290,Job 0,9,9,1,10,1,10,19,9,1,3,2,12290,12324,5
Task 12290,Job 1,14,8,1,11,0,15,25,10,1,3,2,12290,12324,10
Task 12291,Job 0,7,6,1,11,0,8,18,10,1,3,1,12291,12324,8
Task 12291,Job 1,12,6,4,8,0,16,20,4,4,3,0,12291,12324,16
Task 12292,Job 0,7,8,4,10,0,11,17,6,4,3,2,12292,12326,18
Task 12292,Job 1,12,4,1,8,0,13,20,7,1,2,0,12292,12326,12
Task 12293,Job 0,7,9,4,10,0,11,17,6,4,3,1,12293,12327,15
Task 12293,Job 1,12,10,2,12,0,14,24,10,2,3,0,12293,12327,11
Task 12294,Job 0,3,9,1,12,0,4,15,11,1,2,0,12294,12327,10
Task 12294,Job 1,8,4,2,7,0,10,15,5,2,1,0,12294,12327,5
Task 12295,Job 0,5,6,2,6,0,7,11,4,2,1,0,12295,12328,2
Task 12295,Job 1,10,10,1,8,0,11,18,7,1,2,1,12295,12328,3
Task 12296,Job 0,8,10,2,8,0,10,16,6,2,1,0,12296,12329,11
Task 12296,Job 1,13,4,2,10,0,15,23,8,2,1,1,12296,12329,13
Task 12297,Job 0,3,10,1,11,0,4,14,10,1,1,2,12297,12331,15
Task 12297,Job 1,8,6,3,6,0,11,14,3,3,4,2,12297,12331,12
Task 12298,Job 0,10,5,4,7,1,14,17,3,4,2,0,12298,12332,8
Task 12298,Job 1,15,7,2,10,0,17,25,8,2,3,1,12298,12332,14
Task 12299,Job 0,4,9,1,8,0,5,12,7,1,2,1,12299,12332,6
Task 12299,Job 1,9,6,3,9,0,12,18,6,3,3,0,12299,12332,20
Task 12300,Job 0,3,5,2,7,0,5,10,5,2,1,0,12300,12334,7
Task 12300,Job 1,8,5,3,6,0,11,14,3,3,4,0,12300,12334,7
Task 12301,Job 0,2,6,3,7,0,5,9,4,3,2,1,12301,12335,9
Task 12301,Job 1,7,7,2,12,0,9,19,10,2,4,1,12301,12335,19
Task 12302,Job 0,1,7,2,10,0,3,11,8,2,2,0,12302,12335,14
Task 12302,Job 1,6,7,3,6,0,9,12,3,3,4,1,12302,12335,17
Task 12303,Job 0,4,10,2,10,0,6,14,8,2,3,0,12303,12337,6
Task 12303,Job 1,9,5,1,9,0,10,18,8,1,2,0,12303,12337,11
Task 12304,Job 0,4,10,4,10,1,8,14,6,4,4,1,12304,12337,16
Task 12304,Job 1,9,5,3,6,0,12,15,3,3,2,1,12304,12337,11
Task 12305,Job 0,3,7,4,11,0,7,14,7,4,4,1,12305,12338,19
Task 12305,Job 1,8,5,4,11,0,12,19,7,4,4,0,12305,12338,13
Task 12306,Job 0,5,9,2,8,0,7,13,6,2,2,0,12306,12340,4
Task 12306,Job 1,10,7,4,7,0,14,17,3,4,2,1,12306,12340,16
Task 12307,Job 0,9,7,1,7,1,10,16,6,1,3,2,12307,12340,16
Task 12307,Job 1,14,4,2,10,0,16,24,8,2,3,0,12307,12340,3
Task 12308,Job 0,7,8,3,7,0,10,14,4,3,3,2,12308,12341,12
Task 12308,Job 1,12,4,4,12,1,16,24,8,4,2,2,12308,12341,17
Task 12309,Job 0,2,8,1,10,0,3,12,9,1,1,1,12309,12343,11
Task 12309,Job 1,7,7,2,9,0,9,16,7,2,3,0,12309,12343,12
Task 12310,Job 0,7,6,3,9,0,10,16,6,3,3,1,12310,12343,11
Task 12310,Job 1,12,10,4,7,0,16,19,3,4,4,1,12310,12343,3
Task 12311,Job 0,4,4,2,9,0,6,13,7,2,3,1,12311,12345,2
Task 12311,Job 1,9,5,2,6,0,11,15,4,2,4,1,12311,12345,14
Task 12312,Job 0,7,6,4,9,1,11,16,5,4,2,1,12312,12345,20
Task 12312,Job 1,12,10,1,8,0,13,20,7,1,1,2,12312,12345,16
Task 12313,Job 0,6,7,2,12,0,8,18,10,2,4,1,12313,12347,14
Task 12313,Job 1,11,10,3,10,0,14,21,7,3,3,2,12313,12347,14
Task 12314,Job 0,2,7,3,7,0,5,9,4,3,4,2,12314,12348,12
Task 12314,Job 1,7,7,2,8,0,9,15,6,2,1,1,12314,12348,8
Task 12315,Job 0,6,10,4,12,0,10,18,8,4,1,0,12315,12348,17
Task 12315,Job 1,11,4,1,12,0,12,23,11,1,3,2,12315,12348,10
Task 12316,Job 0,9,7,2,9,0,11,18,7,2,3,1,12316,12349,5
Task 12316,Job 1,14,4,4,10,0,18,24,6,4,1,2,12316,12349,10
Task 12317,Job 0,7,8,4,8,0,11,15,4,4,2,0,12317,12350,16
Task 12317,Job 1,12,8,1,11,0,13,23,10,1,1,0,12317,12350,6
Task 12318,Job 0,2,4,2,11,0,4,13,9,2,1,1,12318,12351,7
Task 12318,Job 1,7,10,1,9,0,8,16,8,1,2,1,12318,12351,15
Task 12319,Job 0,2,9,3,11,1,5,13,8,3,4,2,12319,12352,17
Task 12319,Job 1,7,9,3,12,0,10,19,9,3,2,0,12319,12352,19
Task 12320,Job 0,1,9,4,11,1,5,12,7,4,1,2,12320,12353,10
Task 12320,Job 1,6,10,1,6,0,7,12,5,1,2,0,12320,12353,18
Task 12321,Job 0,10,7,2,8,1,12,18,6,2,3,1,12321,12354,17
Task 12321,Job 1,15,10,4,12,1,19,27,8,4,3,1,12321,12354,5
Task 12322,Job 0,1,8,1,9,0,2,10,8,1,1,0,12322,12355,10
Task 12322,Job 1,6,8,3,6,0,9,12,3,3,3,1,12322,12355,19
Task 12323,Job 0,4,6,1,11,0,5,15,10,1,2,1,12323,12356,12
Task 12323,Job 1,9,5,1,10,0,10,19,9,1,3,2,12323,12356,20
Task 12324,Job 0,1,8,1,11,0,2,12,10,1,4,0,12324,12358,3
Task 12324,Job 1,6,5,4,6,0,10,12,2,4,3,0,12324,12358,7
Task 12325,Job 0,10,4,4,8,0,14,18,4,4,3,0,12325,12359,11
Task 12325,Job 1,15,7,3,9,0,18,24,6,3,1,0,12325,12359,18
Task 12326,Job 0,6,9,4,8,0,10,14,4,4,1,1,12326,12359,3
Task 12326,Job 1,11,8,4,7,0,15,18,3,4,4,2,12326,12359,15
Task 12327,Job 0,2,10,4,10,0,6,12,6,4,4,2,12327,12360,9
Task 12327,Job 1,7,9,4,7,1,11,14,3,4,1,2,12327,12360,8
Task 12328,Job 0,7,9,2,8,0,9,15,6,2,2,2,12328,12361,13
Task 12328,Job 1,12,6,3,10,1,15,22,7,3,1,1,12328,12361,3
Task 12329,Job 0,5,10,2,10,1,7,15,8,2,3,1,12329,12363,6
Task 12329,Job 1,10,7,1,9,0,11,19,8,1,3,0,12329,12363,10
Task 12330,Job 0,6,5,4,10,0,10,16,6,4,4,2,12330,12363,15
Task 12330,Job 1,11,5,2,12,0,13,23,10,2,1,1,12330,12363,14
Task 12331,Job 0,2,8,2,9,1,4,11,7,2,1,2,12331,12364,19
Task 12331,Job 1,7,5,4,10,0,11,17,6,4,4,1,12331,12364,15
Task 12332,Job 0,10,5,4,7,1,14,17,3,4,3,0,12332,12365,7
Task 12332,Job 1,15,6,4,6,0,19,21,2,4,1,2,12332,12365,6
Task 12333,Job 0,10,7,3,8,0,13,18,5,3,4,0,12333,12366,3
Task 12333,Job 1,15,9,1,10,0,16,25,9,1,2,2,12333,12366,20
Task 12334,Job 0,9,7,4,9,0,13,18,5,4,2,0,12334,12367,17
Task 12334,Job 1,14,10,2,10,1,16,24,8,2,1,2,12334,12367,3
Task 12335,Job 0,7,6,4,12,0,11,19,8,4,4,1,12335,12369,18
Task 12335,Job 1,12,7,2,10,0,14,22,8,2,3,1,12335,12369,18
Task 12336,Job 0,7,6,4,10,0,11,17,6,4,4,2,12336,12370,4
Task 12336,Job 1,12,10,4,12,1,16,24,8,4,1,0,12336,12370,10
Task 12337,Job 0,8,6,1,7,0,9,15,6,1,2,2,12337,12371,13
Task 12337,Job 1,13,7,4,11,1,17,24,7,4,1,2,12337,12371,4
Task 12338,Job 0,5,4,4,10,0,9,15,6,4,3,1,12338,12372,17
Task 12338,Job 1,10,9,1,9,0,11,19,8,1,4,2,12338,12372,4
Task 12339,Job 0,1,8,2,9,1,3,10,7,2,2,0,12339,12372,10
Task 12339,Job 1,6,7,4,6,0,10,12,2,4,2,0,12339,12372,15
Task 12340,Job 0,3,4,2,11,1,5,14,9,2,4,2,12340,12373,19
Task 12340,Job 1,8,8,3,9,0,11,17,6,3,4,1,12340,12373,16
Task 12341,Job 0,9,10,1,9,0,10,18,8,1,1,1,12341,12374,13
Task 12341,Job 1,14,9,2,10,0,16,24,8,2,3,1,12341,12374,17
Task 12342,Job 0,7,10,2,11,0,9,18,9,2,1,2,12342,12376,19
Task 12342,Job 1,12,9,1,7,0,13,19,6,1,2,2,12342,12376,11
Task 12343,Job 0,2,5,1,8,1,3,10,7,1,1,0,12343,12377,2
Task 12343,Job 1,7,5,3,12,0,10,19,9,3,4,1,12343,12377,2
Task 12344,Job 0,7,10,2,10,0,9,17,8,2,3,1,12344,12378,15
Task 12344,Job 1,12,7,2,7,0,14,19,5,2,2,1,12344,12378,13
Task 12345,Job 0,6,10,2,12,0,8,18,10,2,1,2,12345,12379,13
Task 12345,Job 1,11,8,2,11,0,13,22,9,2,1,1,12345,12379,11
Task 12346,Job 0,10,8,2,9,0,12,19,7,2,2,2,12346,12379,18
Task 12346,Job 1,15,8,2,12,1,17,27,10,2,2,0,12346,12379,2
Task 12347,Job 0,9,8,2,10,1,11,19,8,2,1,0,12347,12380,10
Task 12347,Job 1,14,4,1,9,0,15,23,8,1,3,1,12347,12380,12
Task 12348,Job 0,3,9,1,11,0,4,14,10,1,4,0,12348,12381,19
Task 12348,Job 1,8,6,3,7,0,11,15,4,3,4,1,12348,12381,5
Task 12349,Job 0,6,6,3,11,0,9,17,8,3,4,1,12349,12382,14
Task 12349,Job 1,11,4,1,11,1,12,22,10,1,1,0,12349,12382,19
Task 12350,Job 0,5,5,3,8,0,8,13,5,3,1,0,12350,12384,16
Task 12350,Job 1,10,9,4,9,0,14,19,5,4,1,2,12350,12384,12
Task 12351,Job 0,8,5,1,10,1,9,18,9,1,1,1,12351,12385,20
Task 12351,Job 1,13,4,3,12,0,16,25,9,3,1,2,12351,12385,12
Task 12352,Job 0,4,6,1,8,0,5,12,7,1,1,2,12352,12385,20
Task 12352,Job 1,9,9,1,7,0,10,16,6,1,4,0,12352,12385,13
Task 12353,Job 0,2,7,1,9,0,3,11,8,1,4,0,12353,12387,5
Task 12353,Job 1,7,6,2,11,0,9,18,9,2,3,2,12353,12387,13
Task 12354,Job 0,1,8,4,11,1,5,12,7,4,1,2,12354,12387,13
Task 12354,Job 1,6,8,4,11,0,10,17,7,4,4,2,12354,12387,2
Task 12355,Job 0,10,8,3,11,0,13,21,8,3,3,1,12355,12389,6
Task 12355,Job 1,15,8,2,9,0,17,24,7,2,3,2,12355,12389,2
Task 12356,Job 0,5,6,2,7,0,7,12,5,2,1,2,12356,12389,7
Task 12356,Job 1,10,7,1,11,1,11,21,10,1,4,0,12356,12389,18
Task 12357,Job 0,1,4,4,7,0,5,8,3,4,4,1,12357,12390,4
Task 12357,Job 1,6,7,4,9,0,10,15,5,4,4,0,12357,12390,5
Task 12358,Job 0,6,5,2,6,1,8,12,4,2,3,1,12358,12392,17
Task 12358,Job 1,11,7,3,6,1,14,17,3,3,3,1,12358,12392,13
Task 12359,Job 0,9,7,1,7,0,10,16,6,1,3,2,12359,12393,15
Task 12359,Job 1,14,4,1,6,0,15,20,5,1,3,0,12359,12393,9
Task 12360,Job 0,1,6,1,9,0,2,10,8,1,4,1,12360,12394,10
Task 12360,Job 1,6,9,4,9,0,10,15,5,4,1,1,12360,12394,15
Task 12361,Job 0,9,4,4,10,1,13,19,6,4,4,1,12361,12394,14
Task 12361,Job 1,14,8,3,7,0,17,21,4,3,1,1,12361,12394,13
Task 12362,Job 0,10,10,4,7,0,14,17,3,4,2,1,12362,12396,18
Task 12362,Job 1,15,5,3,11,0,18,26,8,3,3,2,12362,12396,10
Task 12363,Job 0,6,10,1,6,0,7,12,5,1,4,0,12363,12396,17
Task 12363,Job 1,11,8,3,12,1,14,23,9,3,3,2,12363,12396,15
Task 12364,Job 0,3,6,4,6,0,7,9,2,4,1,0,12364,12397,6
Task 12364,Job 1,8,10,4,6,1,12,14,2,4,1,0,12364,12397,11
Task 12365,Job 0,4,4,1,11,0,5,15,10,1,3,2,12365,12399,6
Task 12365,Job 1,9,8,1,8,0,10,17,7,1,2,2,12365,12399,14
Task 12366,Job 0,5,7,3,11,0,8,16,8,3,2,0,12366,12399,20
Task 12366,Job 1,10,7,4,6,0,14,16,2,4,4,1,12366,12399,18
Task 12367,Job 0,4,5,2,10,0,6,14,8,2,3,1,12367,12401,14
Task 12367,Job 1,9,6,1,11,1,10,20,10,1,2,1,12367,12401,19
Task 12368,Job 0,8,10,2,12,1,10,20,10,2,2,2,12368,12401,14
Task 12368,Job 1,13,8,1,10,0,14,23,9,1,2,1,12368,12401,14
Task 12369,Job 0,3,10,1,9,0,4,12,8,1,1,0,12369,12402,8
Task 12369,Job 1,8,8,1,11,1,9,19,10,1,3,0,12369,12402,6
Task 12370,Job 0,4,7,3,8,0,7,12,5,3,4,2,12370,12404,3
Task 12370,Job 1,9,4,4,11,0,13,20,7,4,1,1,12370,12404,19
Task 12371,Job 0,5,7,4,7,0,9,12,3,4,3,0,12371,12405,15
Task 12371,Job 1,10,9,4,12,0,14,22,8,4,1,1,12371,12405,9
Task 12372,Job 0,6,6,4,12,0,10,18,8,4,1,2,12372,12406,8
Task 12372,Job 1,11,10,2,7,0,13,18,5,2,1,2,12372,12406,11
Task 12373,Job 0,7,7,1,9,0,8,16,8,1,3,0,12373,12406,8
Task 12373,Job 1,12,10,2,7,0,14,19,5,2,3,1,12373,12406,2
Task 12374,Job 0,3,10,3,6,1,6,9,3,3,4,0,12374,12408,17
Task 12374,Job 1,8,6,4,10,1,12,18,6,4,1,2,12374,12408,20
Task 12375,Job 0,9,7,3,9,0,12,18,6,3,3,0,12375,12409,17
Task 12375,Job 1,14,7,4,8,0,18,22,4,4,4,0,12375,12409,16
Task 12376,Job 0,1,6,1,9,0,2,10,8,1,1,2,12376,12409,20
Task 12376,Job 1,6,9,1,8,0,7,14,7,1,1,1,12376,12409,6
Task 12377,Job 0,8,5,4,7,0,12,15,3,4,2,0,12377,12411,10
Task 12377,Job 1,13,6,2,10,0,15,23,8,2,3,2,12377,12411,13
Task 12378,Job 0,7,4,4,8,0,11,15,4,4,1,2,12378,12412,17
Task 12378,Job 1,12,8,1,10,0,13,22,9,1,4,1,12378,12412,12
Task 12379,Job 0,2,9,4,12,0,6,14,8,4,4,2,12379,12412,17
Task 12379,Job 1,7,6,3,9,0,10,16,6,3,1,0,12379,12412,7
Task 12380,Job 0,2,8,3,7,1,5,9,4,3,4,1,12380,12413,6
Task 12380,Job 1,7,6,2,10,0,9,17,8,2,2,2,12380,12413,14
Task 12381,Job 0,5,9,4,10,0,9,15,6,4,3,1,12381,12415,6
Task 12381,Job 1,10,9,1,10,0,11,20,9,1,4,1,12381,12415,12
Task 12382,Job 0,9,10,1,8,0,10,17,7,1,1,1,12382,12415,18
Task 12382,Job 1,14,4,1,7,1,15,21,6,1,1,1,12382,12415,7
Task 12383,Job 0,10,6,2,6,0,12,16,4,2,2,2,12383,12416,12
Task 12383,Job 1,15,8,4,8,0,19,23,4,4,3,2,12383,12416,13
Task 12384,Job 0,6,5,1,9,0,7,15,8,1,3,1,12384,12418,2
Task 12384,Job 1,11,7,1,11,0,12,22,10,1,1,0,12384,12418,2
Task 12385,Job 0,9,9,2,10,0,11,19,8,2,3,2,12385,12418,19
Task 12385,Job 1,14,5,4,12,1,18,26,8,4,2,1,12385,12418,20
Task 12386,Job 0,10,6,3,12,0,13,22,9,3,4,0,12386,12420,13
Task 12386,Job 1,15,6,2,8,0,17,23,6,2,1,2,12386,12420,17
Task 12387,Job 0,10,10,3,8,0,13,18,5,3,4,1,12387,12421,18
Task 12387,Job 1,15,6,2,7,0,17,22,5,2,4,1,12387,12421,13
Task 12388,Job 0,2,4,4,11,1,6,13,7,4,2,0,12388,12421,2
Task 12388,Job 1,7,4,2,7,1,9,14,5,2,4,1,12388,12421,3
Task 12389,Job 0,1,6,1,10,1,2,11,9,1,3,2,12389,12423,9
Task 12389,Job 1,6,10,1,7,1,7,13,6,1,2,2,12389,12423,18
Task 12390,Job 0,2,6,4,6,0,6,8,2,4,4,0,12390,12423,4
Task 12390,Job 1,7,10,2,10,0,9,17,8,2,4,2,12390,12423,12
Task 12391,Job 0,6,5,3,12,0,9,18,9,3,4,1,12391,12424,10
Task 12391,Job 1,11,7,3,7,0,14,18,4,3,2,2,12391,12424,18
Task 12392,Job 0,2,8,3,11,0,5,13,8,3,2,1,12392,12426,4
Task 12392,Job 1,7,6,2,10,0,9,17,8,2,4,0,12392,12426,4
Task 12393,Job 0,8,10,4,9,1,12,17,5,4,3,1,12393,12426,10
Task 12393,Job 1,13,6,3,11,0,16,24,8,3,2,0,12393,12426,6
Task 12394,Job 0,3,7,2,8,0,5,11,6,2,2,1,12394,12427,15
Task 12394,Job 1,8,7,3,10,0,11,18,7,3,3,2,12394,12427,17
Task 12395,Job 0,6,5,3,11,0,9,17,8,3,4,2,12395,12429,16
Task 12395,Job 1,11,5,3,9,0,14,20,6,3,2,1,12395,12429,6
Task 12396,Job 0,7,7,3,12,0,10,19,9,3,3,0,12396,12430,19
Task 12396,Job 1,12,5,2,8,1,14,20,6,2,4,1,12396,12430,5
Task 12397,Job 0,3,4,3,8,1,6,11,5,3,2,0,12397,12430,7
Task 12397,Job 1,8,8,4,10,0,12,18,6,4,4,1,12397,12430,6
Task 12398,Job 0,10,8,1,7,0,11,17,6,1,1,2,12398,12431,18
Task 12398,Job 1,15,5,2,9,0,17,24,7,2,4,1,12398,12431,10
Task 12399,Job 0,2,5,3,9,0,5,11,6,3,3,2,12399,12432,18
Task 12399,Job 1,7,4,4,6,0,11,13,2,4,1,1,12399,12432,5
Task 12400,Job 0,3,8,4,12,0,7,15,8,4,1,2,12400,12434,9
Task 12400,Job 1,8,10,1,11,0,9,19,10,1,3,1,12400,12434,19
Task 12401,Job 0,7,10,1,10,0,8,17,9,1,1,0,12401,12434,18
Task 12401,Job 1,12,4,2,10,1,14,22,8,2,4,0,12401,12434,14
Task 12402,Job 0,10,4,1,12,1,11,22,11,1,1,1,12402,12436,20
Task 12402,Job 1,15,8,1,10,0,16,25,9,1,2,2,12402,12436,7
Task 12403,Job 0,8,9,1,12,0,9,20,11,1,4,2,12403,12437,19
Task 12403,Job 1,13,10,2,12,0,15,25,10,2,2,0,12403,12437,5
Task 12404,Job 0,5,10,3,10,0,8,15,7,3,1,1,12404,12438,17
Task 12404,Job 1,10,8,1,10,1,11,20,9,1,2,1,12404,12438,6
Task 12405,Job 0,9,4,1,12,0,10,21,11,1,2,0,12405,12439,9
Task 12405,Job 1,14,9,1,11,0,15,25,10,1,1,0,12405,12439,9
Task 12406,Job 0,4,10,2,7,1,6,11,5,2,1,0,12406,12439,9
Task 12406,Job 1,9,4,4,11,1,13,20,7,4,4,1,12406,12439,10
Task 12407,Job 0,7,4,3,7,0,10,14,4,3,2,0,12407,12441,10
Task 12407,Job 1,12,6,1,10,0,13,22,9,1,2,0,12407,12441,10
Task 12408,Job 0,9,4,4,12,0,13,21,8,4,1,1,12408,12441,18
Task 12408,Job 1,14,8,3,12,0,17,26,9,3,4,1,12408,12441,18
Task 12409,Job 0,3,4,2,6,0,5,9,4,2,4,2,12409,12443,3
Task 12409,Job 1,8,9,4,6,0,12,14,2,4,1,0,12409,12443,20
Task 12410,Job 0,6,6,1,7,0,7,13,6,1,3,0,12410,12443,7
Task 12410,Job 1,11,6,1,11,0,12,22,10,1,1,0,12410,12443,19
Task 12411,Job 0,6,4,4,6,0,10,12,2,4,3,2,12411,12445,13
Task 12411,Job 1,11,5,3,10,0,14,21,7,3,3,2,12411,12445,6
Task 12412,Job 0,2,8,4,9,1,6,11,5,4,1,2,12412,12445,6
Task 12412,Job 1,7,8,1,12,0,8,19,11,1,3,1,12412,12445,2
Task 12413,Job 0,10,10,3,11,0,13,21,8,3,4,0,12413,12447,20
Task 12413,Job 1,15,6,1,10,1,16,25,9,1,3,0,12413,12447,16
Task 12414,Job 0,1,5,2,9,0,3,10,7,2,2,2,12414,12448,11
Task 12414,Job 1,6,7,3,7,0,9,13,4,3,3,2,12414,12448,17
Task 12415,Job 0,1,6,3,11,0,4,12,8,3,4,0,12415,12448,14
Task 12415,Job 1,6,10,2,12,1,8,18,10,2,2,0,12415,12448,12
Task 12416,Job 0,5,10,1,12,1,6,17,11,1,1,2,12416,12449,11
Task 12416,Job 1,10,10,3,7,1,13,17,4,3,2,1,12416,12449,10
Task 12417,Job 0,2,8,3,7,0,5,9,4,3,3,1,12417,12451,16
Task 12417,Job 1,7,6,1,7,0,8,14,6,1,3,0,12417,12451,9
Task 12418,Job 0,10,8,2,7,0,12,17,5,2,1,2,12418,12451,9
Task 12418,Job 1,15,9,2,8,1,17,23,6,2,2,0,12418,12451,10
Task 12419,Job 0,9,7,4,8,0,13,17,4,4,3,1,12419,12452,4
Task 12419,Job 1,14,5,2,12,1,16,26,10,2,1,2,12419,12452,6
Task 12420,Job 0,1,4,2,9,1,3,10,7,2,4,1,12420,12454,15
Task 12420,Job 1,6,4,3,10,0,9,16,7,3,2,2,12420,12454,16
Task 12421,Job 0,3,6,3,7,0,6,10,4,3,4,2,12421,12454,15
Task 12421,Job 1,8,7,2,10,0,10,18,8,2,1,0,12421,12454,8
Task 12422,Job 0,5,6,1,11,0,6,16,10,1,4,1,12422,12455,20
Task 12422,Job 1,10,6,3,9,0,13,19,6,3,2,2,12422,12455,18
Task 12423,Job 0,7,7,2,11,0,9,18,9,2,4,0,12423,12456,3
Task 12423,Job 1,12,7,4,9,0,16,21,5,4,1,1,12423,12456,5
Task 12424,Job 0,3,6,2,10,0,5,13,8,2,2,2,12424,12458,16
Task 12424,Job 1,8,9,4,6,1,12,14,2,4,2,2,12424,12458,11
Task 12425,Job 0,3,6,3,9,0,6,12,6,3,2,1,12425,12459,13
Task 12425,Job 1,8,10,4,12,0,12,20,8,4,4,2,12425,12459,20
Task 12426,Job 0,1,9,3,8,0,4,9,5,3,4,2,12426,12460,11
Task 12426,Job 1,6,9,1,12,0,7,18,11,1,1,1,12426,12460,9
Task 12427,Job 0,6,10,2,7,1,8,13,5,2,4,0,12427,12461,10
Task 12427,Job 1,11,9,4,12,0,15,23,8,4,1,1,12427,12461,18
Task 12428,Job 0,1,5,3,8,0,4,9,5,3,3,2,12428,12461,18
Task 12428,Job 1,6,6,1,6,0,7,12,5,1,2,1,12428,12461,10
Task 12429,Job 0,2,7,2,6,1,4,8,4,2,3,2,12429,12462,10
Task 12429,Job 1,7,9,1,9,0,8,16,8,1,2,0,12429,12462,9
Task 12430,Job 0,9,10,3,6,0,12,15,3,3,1,2,12430,12463,6
Task 12430,Job 1,14,5,3,11,0,17,25,8,3,1,2,12430,12463,16
Task 12431,Job 0,3,6,3,12,0,6,15,9,3,2,0,12431,12465,12
Task 12431,Job 1,8,9,1,7,1,9,15,6,1,2,2,12431,12465,14
Task 12432,Job 0,5,8,1,12,1,6,17,11,1,2,1,12432,12465,7
Task 12432,Job 1,10,4,1,9,0,11,19,8,1,4,2,12432,12465,18
Task 12433,Job 0,6,4,3,8,0,9,14,5,3,3,2,12433,12466,7
Task 12433,Job 1,11,4,2,8,0,13,19,6,2,4,2,12433,12466,5
Task 12434,Job 0,9,7,1,12,1,10,21,11,1,3,2,12434,12467,17
Task 12434,Job 1,14,5,1,11,0,15,25,10,1,4,2,12434,12467,16
Task 12435,Job 0,4,8,3,10,0,7,14,7,3,1,0,12435,12469,20
Task 12435,Job 1,9,8,4,6,0,13,15,2,4,4,0,12435,12469,2
Task 12436,Job 0,3,9,4,12,0,7,15,8,4,3,1,12436,12470,12
Task 12436,Job 1,8,10,3,9,1,11,17,6,3,3,2,12436,12470,5
Task 12437,Job 0,1,6,4,9,0,5,10,5,4,4,1,12437,12470,6
Task 12437,Job 1,6,10,3,8,0,9,14,5,3,2,1,12437,12470,13
Task 12438,Job 0,2,7,2,6,1,4,8,4,2,3,0,12438,12471,11
Task 12438,Job 1,7,4,3,9,0,10,16,6,3,1,2,12438,12471,16
Task 12439,Job 0,3,10,4,11,0,7,14,7,4,2,2,12439,12473,12
Task 12439,Job 1,8,9,4,9,0,12,17,5,4,1,2,12439,12473,8
Task 12440,Job 0,8,9,3,7,0,11,15,4,3,2,1,12440,12473,11
Task 12440,Job 1,13,7,3,11,0,16,24,8,3,1,1,12440,12473,4
Task 12441,Job 0,1,4,1,10,1,2,11,9,1,3,1,12441,12475,19
Task 12441,Job 1,6,7,3,9,1,9,15,6,3,2,2,12441,12475,3
Task 12442,Job 0,9,6,1,10,0,10,19,9,1,4,1,12442,12476,11
Task 12442,Job 1,14,10,3,11,1,17,25,8,3,1,2,12442,12476,16
Task 12443,Job 0,3,8,1,6,0,4,9,5,1,3,1,12443,12476,8
Task 12443,Job 1,8,7,1,8,0,9,16,7,1,2,2,12443,12476,8
Task 12444,Job 0,7,6,4,10,0,11,17,6,4,2,2,12444,12477,9
Task 12444,Job 1,12,6,1,12,1,13,24,11,1,3,0,12444,12477,3
Task 12445,Job 0,8,7,2,12,1,10,20,10,2,2,1,12445,12479,18
Task 12445,Job 1,13,9,4,6,0,17,19,2,4,4,0,12445,12479,18
Task 12446,Job 0,4,7,3,10,0,7,14,7,3,3,2,12446,12479,5
Task 12446,Job 1,9,9,4,10,0,13,19,6,4,1,1,12446,12479,18
Task 12447,Job 0,10,9,4,11,0,14,21,7,4,4,0,12447,12481,11
Task 12447,Job 1,15,7,4,9,1,19,24,5,4,4,0,12447,12481,9
Task 12448,Job 0,2,8,4,7,1,6,9,3,4,3,1,12448,12482,15
Task 12448,Job 1,7,8,3,10,0,10,17,7,3,1,2,12448,12482,8
Task 12449,Job 0,5,9,3,10,1,8,15,7,3,3,2,12449,12482,6
Task 12449,Job 1,10,10,3,12,0,13,22,9,3,1,0,12449,12482,3
Task 12450,Job 0,7,6,1,8,1,8,15,7,1,3,0,12450,12484,13
Task 12450,Job 1,12,4,4,12,0,16,24,8,4,2,2,12450,12484,4
Task 12451,Job 0,4,5,1,6,1,5,10,5,1,2,1,12451,12484,20
Task 12451,Job 1,9,8,3,12,0,12,21,9,3,4,0,12451,12484,6
Task 12452,Job 0,1,4,2,9,0,3,10,7,2,1,0,12452,12486,13
Task 12452,Job 1,6,4,3,8,0,9,14,5,3,1,2,12452,12486,15
Task 12453,Job 0,9,5,2,6,0,11,15,4,2,3,2,12453,12486,9
Task 12453,Job 1,14,8,2,11,1,16,25,9,2,3,0,12453,12486,15
Task 12454,Job 0,8,5,4,7,0,12,15,3,4,4,1,12454,12487,19
Task 12454,Job 1,13,5,3,9,0,16,22,6,3,4,0,12454,12487,2
Task 12455,Job 0,7,7,4,10,0,11,17,6,4,2,1,12455,12488,18
Task 12455,Job 1,12,6,2,11,0,14,23,9,2,4,0,12455,12488,2
Task 12456,Job 0,9,6,4,9,0,13,18,5,4,3,0,12456,12489,13
Task 12456,Job 1,14,9,1,9,0,15,23,8,1,3,1,12456,12489,12
Task 12457,Job 0,7,4,4,9,0,11,16,5,4,2,0,12457,12491,13
Task 12457,Job 1,12,8,2,10,0,14,22,8,2,4,0,12457,12491,10
Task 12458,Job 0,9,5,3,8,0,12,17,5,3,1,2,12458,12491,6
Task 12458,Job 1,14,4,1,6,1,15,20,5,1,4,2,12458,12491,5
Task 12459,Job 0,2,9,2,7,0,4,9,5,2,1,0,12459,12493,11
Task 12459,Job 1,7,4,2,12,0,9,19,10,2,1,2,12459,12493,7
Task 12460,Job 0,10,10,3,12,1,13,22,9,3,3,0,12460,12494,13
Task 12460,Job 1,15,6,3,9,0,18,24,6,3,4,2,12460,12494,2
Task 12461,Job 0,7,7,3,11,0,10,18,8,3,4,2,12461,12494,16
Task 12461,Job 1,12,7,3,11,0,15,23,8,3,2,0,12461,12494,20
Task 12462,Job 0,7,8,2,6,0,9,13,4,2,4,1,12462,12495,4
Task 12462,Job 1,12,4,4,9,0,16,21,5,4,1,2,12462,12495,17
Task 12463,Job 0,1,7,4,8,0,5,9,4,4,1,2,12463,12497,9
Task 12463,Job 1,6,8,2,12,0,8,18,10,2,2,0,12463,12497,16
Task 12464,Job 0,6,6,3,8,0,9,14,5,3,2,0,12464,12497,6
Task 12464,Job 1,11,6,1,7,0,12,18,6,1,2,0,12464,12497,5
Task 12465,Job 0,10,10,2,8,0,12,18,6,2,2,0,12465,12498,7
Task 12465,Job 1,15,10,4,10,0,19,25,6,4,2,1,12465,12498,19
Task 12466,Job 0,6,10,1,9,0,7,15,8,1,3,0,12466,12500,15
Task 12466,Job 1,11,6,2,6,0,13,17,4,2,3,2,12466,12500,20
Task 12467,Job 0,10,6,4,7,0,14,17,3,4,1,1,12467,12501,4
Task 12467,Job 1,15,4,3,8,0,18,23,5,3,2,0,12467,12501,11
Task 12468,Job 0,7,9,4,11,1,11,18,7,4,1,0,12468,12501,20
Task 12468,Job 1,12,10,4,11,0,16,23,7,4,4,2,12468,12501,19
Task 12469,Job 0,9,6,4,6,1,13,15,2,4,4,0,12469,12502,3
Task 12469,Job 1,14,4,4,6,0,18,20,2,4,4,2,12469,12502,2
Task 12470,Job 0,5,7,2,12,0,7,17,10,2,3,0,12470,12503,5
Task 12470,Job 1,10,4,1,7,0,11,17,6,1,2,1,12470,12503,13
Task 12471,Job 0,4,5,4,8,0,8,12,4,4,2,2,12471,12504,11
Task 12471,Job 1,9,4,1,9,0,10,18,8,1,1,1,12471,12504,19
Task 12472,Job 0,8,6,4,10,0,12,18,6,4,3,2,12472,12505,4
Task 12472,Job 1,13,4,4,10,1,17,23,6,4,4,2,12472,12505,2
Task 12473,Job 0,4,8,2,7,0,6,11,5,2,1,0,12473,12507,18
Task 12473,Job 1,9,6,4,6,0,13,15,2,4,3,1,12473,12507,3
Task 12474,Job 0,3,5,4,11,0,7,14,7,4,3,2,12474,12508,6
Task 12474,Job 1,8,9,1,7,0,9,15,6,1,2,2,12474,12508,18
Task 12475,Job 0,9,6,4,10,1,13,19,6,4,2,1,12475,12509,18
Task 12475,Job 1,14,5,1,6,0,15,20,5,1,4,1,12475,12509,14
Task 12476,Job 0,10,9,4,6,0,14,16,2,4,1,2,12476,12510,2
Task 12476,Job 1,15,6,4,11,0,19,26,7,4,4,2,12476,12510,3
Task 12477,Job 0,1,5,2,12,0,3,13,10,2,2,1,12477,12511,12
Task 12477,Job 1,6,8,2,9,0,8,15,7,2,3,0,12477,12511,10
Task 12478,Job 0,9,10,3,10,0,12,19,7,3,3,0,12478,12511,12
Task 12478,Job 1,14,8,1,8,1,15,22,7,1,3,0,12478,12511,12
Task 12479,Job 0,10,6,3,6,0,13,16,3,3,2,2,12479,12512,16
Task 12479,Job 1,15,8,3,9,0,18,24,6,3,2,0,12479,12512,20
Task 12480,Job 0,6,4,4,10,0,10,16,6,4,3,1,12480,12513,3
Task 12480,Job 1,11,4,2,8,1,13,19,6,2,2,2,12480,12513,20
Task 12481,Job 0,5,6,3,8,0,8,13,5,3,1,1,12481,12515,14
Task 12481,Job 1,10,7,1,10,0,11,20,9,1,3,2,12481,12515,9
Task 12482,Job 0,1,9,1,9,0,2,10,8,1,3,2,12482,12515,14
Task 12482,Job 1,6,4,3,6,0,9,12,3,3,4,1,12482,12515,2
Task 12483,Job 0,8,5,3,10,0,11,18,7,3,1,2,12483,12516,18
Task 12483,Job 1,13,4,2,9,0,15,22,7,2,1,2,12483,12516,16
Task 12484,Job 0,10,9,4,7,0,14,17,3,4,4,2,12484,12517,9
Task 12484,Job 1,15,8,3,6,0,18,21,3,3,2,1,12484,12517,17
Task 12485,Job 0,8,8,3,11,0,11,19,8,3,4,0,12485,12518,16
Task 12485,Job 1,13,6,1,12,0,14,25,11,1,4,0,12485,12518,11
Task 12486,Job 0,1,9,1,8,0,2,9,7,1,4,2,12486,12520,16
Task 12486,Job 1,6,4,3,10,0,9,16,7,3,2,2,12486,12520,20
Task 12487,Job 0,3,6,1,8,0,4,11,7,1,1,2,12487,12521,3
Task 12487,Job 1,8,5,4,6,1,12,14,2,4,3,1,12487,12521,12
Task 12488,Job 0,8,8,2,11,1,10,19,9,2,4,1,12488,12521,3
Task 12488,Job 1,13,9,1,10,1,14,23,9,1,4,1,12488,12521,8
Task 12489,Job 0,10,9,3,11,0,13,21,8,3,1,1,12489,12523,17
Task 12489,Job 1,15,9,2,10,1,17,25,8,2,1,2,12489,12523,14
Task 12490,Job 0,2,4,4,11,0,6,13,7,4,4,2,12490,12524,11
Task 12490,Job 1,7,5,4,10,0,11,17,6,4,1,2,12490,12524,12
Task 12491,Job 0,3,8,4,9,0,7,12,5,4,2,2,12491,12524,13
Task 12491,Job 1,8,7,3,7,0,11,15,4,3,2,0,12491,12524,18
Task 12492,Job 0,4,9,2,7,1,6,11,5,2,1,1,12492,12526,18
Task 12492,Job 1,9,8,2,9,0,11,18,7,2,3,1,12492,12526,7
Task 12493,Job 0,9,9,4,11,1,13,20,7,4,3,2,12493,12526,7
Task 12493,Job 1,14,6,1,9,0,15,23,8,1,3,1,12493,12526,6
Task 12494,Job 0,2,6,2,10,1,4,12,8,2,2,0,12494,12527,10
Task 12494,Job 1,7,4,3,12,0,10,19,9,3,3,2,12494,12527,15
Task 12495,Job 0,2,7,1,10,0,3,12,9,1,3,1,12495,12529,5
Task 12495,Job 1,7,10,4,11,1,11,18,7,4,2,2,12495,12529,14
Task 12496,Job 0,10,4,1,10,0,11,20,9,1,3,0,12496,12529,2
Task 12496,Job 1,15,8,3,8,1,18,23,5,3,1,0,12496,12529,7
Task 12497,Job 0,5,6,1,10,0,6,15,9,1,1,2,12497,12530,8
Task 12497,Job 1,10,10,1,6,0,11,16,5,1,4,2,12497,12530,19
Task 12498,Job 0,3,5,4,10,0,7,13,6,4,1,1,12498,12531,4
Task 12498,Job 1,8,9,2,9,0,10,17,7,2,3,0,12498,12531,18
Task 12499,Job 0,2,4,3,12,0,5,14,9,3,4,0,12499,12533,19
Task 12499,Job 1,7,6,2,11,1,9,18,9,2,3,0,12499,12533,19
Task 12500,Job 0,1,6,1,12,0,2,13,11,1,4,0,12500,12533,7
Task 12500,Job 1,6,6,2,12,0,8,18,10,2,3,0,12500,12533,12
Task 12501,Job 0,6,6,4,6,0,10,12,2,4,1,1,12501,12534,8
Task 12501,Job 1,11,10,2,11,0,13,22,9,2,2,0,12501,12534,11
Task 12502,Job 0,6,9,4,9,0,10,15,5,4,3,0,12502,12535,2
Task 12502,Job 1,11,10,3,10,0,14,21,7,3,2,1,12502,12535,9
Task 12503,Job 0,8,4,2,10,1,10,18,8,2,4,0,12503,12537,20
Task 12503,Job 1,13,10,2,12,0,15,25,10,2,2,0,12503,12537,4
Task 12504,Job 0,2,9,3,9,0,5,11,6,3,3,1,12504,12538,14
Task 12504,Job 1,7,6,2,9,0,9,16,7,2,1,0,12504,12538,20
Task 12505,Job 0,7,5,3,7,0,10,14,4,3,4,2,12505,12538,2
Task 12505,Job 1,12,7,3,12,0,15,24,9,3,1,2,12505,12538,9
Task 12506,Job 0,4,7,3,12,1,7,16,9,3,2,0,12506,12540,13
Task 12506,Job 1,9,7,1,12,1,10,21,11,1,3,2,12506,12540,2
Task 12507,Job 0,1,10,2,12,0,3,13,10,2,1,2,12507,12541,4
Task 12507,Job 1,6,7,3,8,0,9,14,5,3,3,1,12507,12541,13
Task 12508,Job 0,1,8,2,8,1,3,9,6,2,2,2,12508,12542,16
Task 12508,Job 1,6,7,2,12,0,8,18,10,2,4,1,12508,12542,11
Task 12509,Job 0,6,4,3,8,0,9,14,5,3,3,1,12509,12542,11
Task 12509,Job 1,11,9,3,12,0,14,23,9,3,2,2,12509,12542,20
Task 12510,Job 0,4,10,4,9,0,8,13,5,4,3,1,12510,12543,8
Task 12510,Job 1,9,4,1,8,0,10,17,7,1,1,0,12510,12543,10
Task 12511,Job 0,1,5,3,11,1,4,12,8,3,1,0,12511,12544,19
Task 12511,Job 1,6,10,2,7,0,8,13,5,2,1,0,12511,12544,5
Task 12512,Job 0,4,4,3,12,0,7,16,9,3,1,0,12512,12545,2
Task 12512,Job 1,9,7,4,6,0,13,15,2,4,4,1,12512,12545,5
Task 12513,Job 0,8,5,3,8,0,11,16,5,3,4,0,12513,12546,15
Task 12513,Job 1,13,9,1,6,0,14,19,5,1,3,0,12513,12546,7
Task 12514,Job 0,9,8,1,8,0,10,17,7,1,4,0,12514,12548,16
Task 12514,Job 1,14,10,3,7,0,17,21,4,3,2,0,12514,12548,18
Task 12515,Job 0,5,4,1,9,0,6,14,8,1,1,1,12515,12548,7
Task 12515,Job 1,10,8,3,12,0,13,22,9,3,2,1,12515,12548,17
Task 12516,Job 0,7,8,2,8,0,9,15,6,2,1,1,12516,12549,13
Task 12516,Job 1,12,4,4,7,0,16,19,3,4,2,1,12516,12549,5
Task 12517,Job 0,2,8,4,9,1,6,11,5,4,1,2,12517,12551,10
Task 12517,Job 1,7,5,1,9,0,8,16,8,1,2,1,12517,12551,3
Task 12518,Job 0,9,7,4,9,0,13,18,5,4,1,2,12518,12551,3
Task 12518,Job 1,14,8,4,10,0,18,24,6,4,3,0,12518,12551,16
Task 12519,Job 0,10,6,4,11,0,14,21,7,4,4,0,12519,12552,3
Task 12519,Job 1,15,8,2,10,0,17,25,8,2,3,2,12519,12552,11
Task 12520,Job 0,9,9,4,10,1,13,19,6,4,3,0,12520,12554,18
Task 12520,Job 1,14,6,1,8,0,15,22,7,1,1,1,12520,12554,12
Task 12521,Job 0,5,8,1,7,0,6,12,6,1,3,0,12521,12554,7
Task 12521,Job 1,10,7,4,11,0,14,21,7,4,3,0,12521,12554,8
Task 12522,Job 0,6,5,1,7,0,7,13,6,1,2,1,12522,12555,13
Task 12522,Job 1,11,10,4,11,0,15,22,7,4,2,2,12522,12555,17
Task 12523,Job 0,8,5,4,11,0,12,19,7,4,2,2,12523,12557,2
Task 12523,Job 1,13,4,4,6,0,17,19,2,4,3,0,12523,12557,18
Task 12524,Job 0,2,8,2,10,0,4,12,8,2,3,0,12524,12558,8
Task 12524,Job 1,7,8,4,10,0,11,17,6,4,3,1,12524,12558,15
Task 12525,Job 0,6,7,1,12,0,7,18,11,1,3,0,12525,12558,17
Task 12525,Job 1,11,6,2,11,1,13,22,9,2,4,2,12525,12558,19
Task 12526,Job 0,2,7,4,7,1,6,9,3,4,3,1,12526,12560,3
Task 12526,Job 1,7,10,4,9,1,11,16,5,4,1,0,12526,12560,16
Task 12527,Job 0,1,4,4,11,0,5,12,7,4,1,2,12527,12561,9
Task 12527,Job 1,6,6,2,11,1,8,17,9,2,4,1,12527,12561,8
Task 12528,Job 0,2,7,3,8,0,5,10,5,3,2,1,12528,12562,2
Task 12528,Job 1,7,7,2,10,0,9,17,8,2,2,2,12528,12562,20
Task 12529,Job 0,7,4,3,10,0,10,17,7,3,4,1,12529,12563,13
Task 12529,Job 1,12,7,4,8,0,16,20,4,4,3,2,12529,12563,15
Task 12530,Job 0,2,6,1,6,0,3,8,5,1,3,1,12530,12563,2
Task 12530,Job 1,7,8,1,12,0,8,19,11,1,1,2,12530,12563,5
Task 12531,Job 0,6,8,2,11,1,8,17,9,2,1,2,12531,12564,4
Task 12531,Job 1,11,9,1,11,1,12,22,10,1,3,1,12531,12564,20
Task 12532,Job 0,5,8,1,11,0,6,16,10,1,4,2,12532,12566,16
Task 12532,Job 1,10,6,1,6,0,11,16,5,1,3,2,12532,12566,4
Task 12533,Job 0,9,5,4,7,1,13,16,3,4,1,1,12533,12566,15
Task 12533,Job 1,14,7,1,11,0,15,25,10,1,4,2,12533,12566,16
Task 12534,Job 0,2,7,4,9,1,6,11,5,4,3,2,12534,12567,10
Task 12534,Job 1,7,9,3,9,0,10,16,6,3,3,2,12534,12567,2
Task 12535,Job 0,6,8,3,6,0,9,12,3,3,3,1,12535,12569,7
Task 12535,Job 1,11,4,2,7,0,13,18,5,2,1,2,12535,12569,4
Task 12536,Job 0,3,4,4,8,0,7,11,4,4,2,0,12536,12570,5
Task 12536,Job 1,8,5,3,9,0,11,17,6,3,2,1,12536,12570,8
Task 12537,Job 0,6,10,1,10,0,7,16,9,1,1,1,12537,12570,17
Task 12537,Job 1,11,10,4,9,0,15,20,5,4,4,0,12537,12570,17
Task 12538,Job 0,6,6,3,11,0,9,17,8,3,2,2,12538,12571,2
Task 12538,Job 1,11,7,2,9,1,13,20,7,2,3,0,12538,12571,13
Task 12539,Job 0,5,5,3,10,1,8,15,7,3,3,2,12539,12573,8
Task 12539,Job 1,10,5,2,9,1,12,19,7,2,2,0,12539,12573,19
Task 12540,Job 0,7,5,3,11,0,10,18,8,3,3,0,12540,12574,6
Task 12540,Job 1,12,9,3,7,1,15,19,4,3,4,2,12540,12574,9
Task 12541,Job 0,5,7,1,6,0,6,11,5,1,3,0,12541,12575,12
Task 12541,Job 1,10,10,2,10,0,12,20,8,2,3,0,12541,12575,17
Task 12542,Job 0,7,8,1,6,0,8,13,5,1,1,0,12542,12575,20
Task 12542,Job 1,12,7,1,8,0,13,20,7,1,3,2,12542,12575,7
Task 12543,Job 0,2,5,1,11,0,3,13,10,1,4,0,12543,12576,6
Task 12543,Job 1,7,10,3,8,0,10,15,5,3,4,1,12543,12576,4
Task 12544,Job 0,10,10,4,7,0,14,17,3,4,4,2,12544,12577,20
Task 12544,Job 1,15,7,2,12,0,17,27,10,2,1,2,12544,12577,3
Task 12545,Job 0,6,8,4,12,0,10,18,8,4,3,2,12545,12578,10
Task 12545,Job 1,11,5,3,8,0,14,19,5,3,1,0,12545,12578,19
Task 12546,Job 0,4,5,1,8,0,5,12,7,1,4,0,12546,12580,6
Task 12546,Job 1,9,8,2,9,0,11,18,7,2,3,2,12546,12580,13
Task 12547,Job 0,6,6,4,10,0,10,16,6,4,1,0,12547,12581,4
Task 12547,Job 1,11,5,3,9,0,14,20,6,3,3,0,12547,12581,16
Task 12548,Job 0,5,7,3,6,0,8,11,3,3,1,2,12548,12581,11
Task 12548,Job 1,10,9,1,6,0,11,16,5,1,4,2,12548,12581,16
Task 12549,Job 0,2,5,4,6,0,6,8,2,4,2,2,12549,12582,16
Task 12549,Job 1,7,5,1,8,0,8,15,7,1,2,0,12549,12582,16
Task 12550,Job 0,8,6,2,6,0,10,14,4,2,2,0,12550,12584,18
Task 12550,Job 1,13,6,4,7,0,17,20,3,4,1,2,12550,12584,13
Task 12551,Job 0,1,10,4,7,1,5,8,3,4,4,1,12551,12584,19
Task 12551,Job 1,6,4,3,11,0,9,17,8,3,1,2,12551,12584,18
Task 12552,Job 0,7,7,3,6,0,10,13,3,3,3,2,12552,12585,15
Task 12552,Job 1,12,6,4,12,1,16,24,8,4,3,1,12552,12585,3
Task 12553,Job 0,6,10,2,11,0,8,17,9,2,1,1,12553,12587,6
Task 12553,Job 1,11,10,3,7,1,14,18,4,3,2,0,12553,12587,19
Task 12554,Job 0,4,8,1,8,1,5,12,7,1,4,1,12554,12587,19
Task 12554,Job 1,9,5,3,10,0,12,19,7,3,4,1,12554,12587,3
Task 12555,Job 0,1,5,4,9,1,5,10,5,4,2,2,12555,12588,14
Task 12555,Job 1,6,8,4,10,1,10,16,6,4,2,1,12555,12588,4
Task 12556,Job 0,2,9,1,8,1,3,10,7,1,4,0,12556,12590,12
Task 12556,Job 1,7,10,4,8,0,11,15,4,4,4,0,12556,12590,7
Task 12557,Job 0,1,7,2,7,0,3,8,5,2,1,2,12557,12591,10
Task 12557,Job 1,6,8,4,8,0,10,14,4,4,4,1,12557,12591,3
Task 12558,Job 0,1,10,4,11,0,5,12,7,4,1,2,12558,12592,4
Task 12558,Job 1,6,10,1,8,0,7,14,7,1,4,1,12558,12592,17
Task 12559,Job 0,6,10,4,9,0,10,15,5,4,2,0,12559,12592,20
Task 12559,Job 1,11,6,4,8,0,15,19,4,4,1,0,12559,12592,7
Task 12560,Job 0,1,5,2,11,0,3,12,9,2,2,0,12560,12593,14
Task 12560,Job 1,6,6,3,6,0,9,12,3,3,2,1,12560,12593,3
Task 12561,Job 0,4,6,1,8,0,5,12,7,1,4,2,12561,12594,9
Task 12561,Job 1,9,7,2,9,1,11,18,7,2,1,1,12561,12594,3
Task 12562,Job 0,9,9,2,12,1,11,21,10,2,4,2,12562,12595,2
Task 12562,Job 1,14,4,1,9,0,15,23,8,1,3,2,12562,12595,16
Task 12563,Job 0,7,6,4,7,0,11,14,3,4,1,0,12563,12596,18
Task 12563,Job 1,12,10,3,9,0,15,21,6,3,3,2,12563,12596,8
Task 12564,Job 0,7,6,1,10,1,8,17,9,1,2,0,12564,12597,13
Task 12564,Job 1,12,9,3,10,1,15,22,7,3,3,2,12564,12597,2
Task 12565,Job 0,3,4,2,6,0,5,9,4,2,4,0,12565,12599,12
Task 12565,Job 1,8,7,3,11,0,11,19,8,3,1,1,12565,12599,4
Task 12566,Job 0,3,4,1,6,1,4,9,5,1,4,1,12566,12599,9
Task 12566,Job 1,8,7,3,9,1,11,17,6,3,1,1,12566,12599,11
Task 12567,Job 0,8,7,3,11,0,11,19,8,3,2,2,12567,12601,20
Task 12567,Job 1,13,9,4,6,0,17,19,2,4,2,1,12567,12601,3
Task 12568,Job 0,2,10,1,7,0,3,9,6,1,4,0,12568,12601,8
Task 12568,Job 1,7,9,1,9,0,8,16,8,1,3,1,12568,12601,4
Task 12569,Job 0,10,9,3,11,1,13,21,8,3,4,1,12569,12602,19
Task 12569,Job 1,15,10,3,6,1,18,21,3,3,1,0,12569,12602,9
Task 12570,Job 0,7,4,2,12,0,9,19,10,2,1,2,12570,12603,18
Task 12570,Job 1,12,5,1,12,0,13,24,11,1,2,1,12570,12603,18
Task 12571,Job 0,4,5,1,6,0,5,10,5,1,3,1,12571,12605,5
Task 12571,Job 1,9,4,2,7,1,11,16,5,2,1,0,12571,12605,9
Task 12572,Job 0,2,8,1,7,1,3,9,6,1,4,1,12572,12606,7
Task 12572,Job 1,7,7,2,8,1,9,15,6,2,4,2,12572,12606,16
Task 12573,Job 0,10,4,1,10,1,11,20,9,1,1,2,12573,12607,18
Task 12573,Job 1,15,7,1,11,0,16,26,10,1,2,0,12573,12607,19
Task 12574,Job 0,9,5,1,6,0,10,15,5,1,3,1,12574,12608,18
Task 12574,Job 1,14,10,1,7,1,15,21,6,1,4,1,12574,12608,9
Task 12575,Job 0,1,5,1,8,0,2,9,7,1,4,1,12575,12609,3
Task 12575,Job 1,6,5,1,7,1,7,13,6,1,4,2,12575,12609,4
Task 12576,Job 0,6,7,3,11,0,9,17,8,3,4,0,12576,12609,19
Task 12576,Job 1,11,8,3,11,0,14,22,8,3,3,2,12576,12609,2
Task 12577,Job 0,5,5,2,12,0,7,17,10,2,1,0,12577,12611,19
Task 12577,Job 1,10,4,4,7,0,14,17,3,4,4,1,12577,12611,13
Task 12578,Job 0,9,9,3,7,1,12,16,4,3,3,2,12578,12611,16
Task 12578,Job 1,14,9,3,8,1,17,22,5,3,4,1,12578,12611,9
Task 12579,Job 0,4,10,4,8,1,8,12,4,4,4,2,12579,12613,9
Task 12579,Job 1,9,10,1,6,0,10,15,5,1,2,1,12579,12613,7
Task 12580,Job 0,7,6,1,9,0,8,16,8,1,4,1,12580,12614,12
Task 12580,Job 1,12,9,2,10,0,14,22,8,2,1,0,12580,12614,15
Task 12581,Job 0,8,10,3,10,0,11,18,7,3,1,2,12581,12614,2
Task 12581,Job 1,13,6,1,8,0,14,21,7,1,2,0,12581,12614,4
Task 12582,Job 0,3,10,4,11,1,7,14,7,4,3,1,12582,12615,14
Task 12582,Job 1,8,8,1,6,0,9,14,5,1,4,0,12582,12615,11
Task 12583,Job 0,3,7,4,8,1,7,11,4,4,2,0,12583,12617,20
Task 12583,Job 1,8,10,4,9,0,12,17,5,4,1,2,12583,12617,19
Task 12584,Job 0,6,9,4,8,1,10,14,4,4,1,1,12584,12618,16
Task 12584,Job 1,11,8,4,11,0,15,22,7,4,1,0,12584,12618,19
Task 12585,Job 0,3,8,4,11,0,7,14,7,4,4,1,12585,12619,2
Task 12585,Job 1,8,5,1,7,0,9,15,6,1,4,2,12585,12619,10
Task 12586,Job 0,6,10,2,9,0,8,15,7,2,4,0,12586,12620,7
Task 12586,Job 1,11,7,3,12,0,14,23,9,3,3,1,12586,12620,10
Task 12587,Job 0,4,9,3,11,0,7,15,8,3,1,2,12587,12620,18
Task 12587,Job 1,9,5,3,11,0,12,20,8,3,3,0,12587,12620,19
Task 12588,Job 0,7,10,1,7,1,8,14,6,1,4,1,12588,12621,18
Task 12588,Job 1,12,8,3,9,0,15,21,6,3,4,2,12588,12621,13
Task 12589,Job 0,3,7,1,7,1,4,10,6,1,1,1,12589,12622,13
Task 12589,Job 1,8,10,3,6,0,11,14,3,3,4,0,12589,12622,6
Task 12590,Job 0,3,9,3,9,0,6,12,6,3,3,2,12590,12623,16
Task 12590,Job 1,8,7,3,9,0,11,17,6,3,1,2,12590,12623,16
Task 12591,Job 0,3,8,4,7,0,7,10,3,4,2,2,12591,12624,15
Task 12591,Job 1,8,5,1,8,0,9,16,7,1,4,1,12591,12624,4
Task 12592,Job 0,2,8,3,11,1,5,13,8,3,3,1,12592,12626,14
Task 12592,Job 1,7,7,1,8,1,8,15,7,1,1,1,12592,12626,4
Task 12593,Job 0,5,6,1,8,0,6,13,7,1,2,2,12593,12627,15
Task 12593,Job 1,10,9,4,6,1,14,16,2,4,4,0,12593,12627,10
Task 12594,Job 0,6,10,1,10,0,7,16,9,1,4,0,12594,12628,9
Task 12594,Job 1,11,5,1,7,0,12,18,6,1,1,0,12594,12628,16
Task 12595,Job 0,2,8,3,12,0,5,14,9,3,3,2,12595,12629,6
Task 12595,Job 1,7,9,3,10,0,10,17,7,3,2,1,12595,12629,16
Task 12596,Job 0,3,7,2,6,1,5,9,4,2,1,0,12596,12630,20
Task 12596,Job 1,8,4,1,7,0,9,15,6,1,3,1,12596,12630,4
Task 12597,Job 0,4,9,4,12,0,8,16,8,4,3,1,12597,12630,4
Task 12597,Job 1,9,10,1,9,1,10,18,8,1,4,0,12597,12630,18
Task 12598,Job 0,9,8,2,7,1,11,16,5,2,1,0,12598,12632,13
Task 12598,Job 1,14,7,4,6,0,18,20,2,4,4,0,12598,12632,13
Task 12599,Job 0,7,8,3,12,0,10,19,9,3,2,0,12599,12632,12
Task 12599,Job 1,12,9,3,12,1,15,24,9,3,3,1,12599,12632,14
Task 12600,Job 0,5,4,3,9,0,8,14,6,3,3,2,12600,12633,16
Task 12600,Job 1,10,5,1,12,1,11,22,11,1,1,2,12600,12633,6
Task 12601,Job 0,3,10,3,12,0,6,15,9,3,3,1,12601,12635,14
Task 12601,Job 1,8,7,3,7,0,11,15,4,3,2,0,12601,12635,11
Task 12602,Job 0,1,6,1,12,1,2,13,11,1,1,1,12602,12635,15
Task 12602,Job 1,6,7,3,12,0,9,18,9,3,2,2,12602,12635,10
Task 12603,Job 0,9,10,3,11,0,12,20,8,3,1,0,12603,12637,16
Task 12603,Job 1,14,9,3,9,0,17,23,6,3,3,0,12603,12637,17
Task 12604,Job 0,7,4,1,12,0,8,19,11,1,1,1,12604,12638,20
Task 12604,Job 1,12,7,2,8,0,14,20,6,2,4,1,12604,12638,14
Task 12605,Job 0,3,8,1,7,1,4,10,6,1,3,2,12605,12638,4
Task 12605,Job 1,8,9,3,7,0,11,15,4,3,4,0,12605,12638,19
Task 12606,Job 0,7,8,4,6,1,11,13,2,4,3,0,12606,12640,20
Task 12606,Job 1,12,8,4,6,0,16,18,2,4,4,2,12606,12640,10
Task 12607,Job 0,8,5,4,7,0,12,15,3,4,2,0,12607,12641,10
Task 12607,Job 1,13,4,4,12,0,17,25,8,4,1,2,12607,12641,2
Task 12608,Job 0,5,9,2,8,0,7,13,6,2,2,2,12608,12642,18
Task 12608,Job 1,10,6,1,7,0,11,17,6,1,2,0,12608,12642,10
Task 12609,Job 0,3,10,3,7,1,6,10,4,3,2,2,12609,12642,13
Task 12609,Job 1,8,8,1,11,0,9,19,10,1,2,0,12609,12642,19
Task 12610,Job 0,10,8,1,10,1,11,20,9,1,1,1,12610,12644,13
Task 12610,Job 1,15,7,3,12,1,18,27,9,3,4,1,12610,12644,9
Task 12611,Job 0,1,4,3,6,0,4,7,3,3,4,0,12611,12644,19
Task 12611,Job 1,6,7,2,6,0,8,12,4,2,3,2,12611,12644,5
Task 12612,Job 0,7,4,3,11,0,10,18,8,3,3,0,12612,12646,7
Task 12612,Job 1,12,9,4,6,1,16,18,2,4,4,1,12612,12646,14
Task 12613,Job 0,1,9,1,11,1,2,12,10,1,3,2,12613,12647,16
Task 12613,Job 1,6,5,4,10,1,10,16,6,4,1,0,12613,12647,2
Task 12614,Job 0,8,6,4,8,0,12,16,4,4,4,2,12614,12648,12
Task 12614,Job 1,13,6,2,6,0,15,19,4,2,1,0,12614,12648,20
Task 12615,Job 0,8,5,1,11,1,9,19,10,1,3,1,12615,12648,2
Task 12615,Job 1,13,8,4,12,1,17,25,8,4,1,0,12615,12648,9
Task 12616,Job 0,3,9,1,7,0,4,10,6,1,4,1,12616,12650,5
Task 12616,Job 1,8,7,3,7,0,11,15,4,3,4,2,12616,12650,6
Task 12617,Job 0,10,7,1,10,0,11,20,9,1,4,2,12617,12650,15
Task 12617,Job 1,15,5,4,6,0,19,21,2,4,3,1,12617,12650,4
Task 12618,Job 0,9,4,2,10,0,11,19,8,2,2,0,12618,12651,7
Task 12618,Job 1,14,4,1,12,0,15,26,11,1,1,1,12618,12651,16
Task 12619,Job 0,4,6,3,12,1,7,16,9,3,1,1,12619,12653,9
Task 12619,Job 1,9,9,1,12,0,10,21,11,1,4,0,12619,12653,16
Task 12620,Job 0,1,10,3,6,0,4,7,3,3,3,1,12620,12653,2
Task 12620,Job 1,6,5,3,6,0,9,12,3,3,3,1,12620,12653,16
Task 12621,Job 0,2,10,4,11,0,6,13,7,4,2,2,12621,12655,17
Task 12621,Job 1,7,7,1,11,0,8,18,10,1,2,0,12621,12655,17
Task 12622,Job 0,9,10,3,12,1,12,21,9,3,4,2,12622,12655,20
Task 12622,Job 1,14,4,1,9,0,15,23,8,1,2,0,12622,12655,13
Task 12623,Job 0,6,8,2,12,1,8,18,10,2,2,1,12623,12656,13
Task 12623,Job 1,11,9,3,8,1,14,19,5,3,2,1,12623,12656,6
Task 12624,Job 0,10,5,4,9,1,14,19,5,4,3,0,12624,12657,13
Task 12624,Job 1,15,5,1,7,0,16,22,6,1,3,1,12624,12657,18
Task 12625,Job 0,9,4,1,9,0,10,18,8,1,2,1,12625,12659,9
Task 12625,Job 1,14,9,2,6,0,16,20,4,2,1,0,12625,12659,20
Task 12626,Job 0,6,9,1,10,0,7,16,9,1,4,2,12626,12660,15
Task 12626,Job 1,11,9,1,11,0,12,22,10,1,2,1,12626,12660,3
Task 12627,Job 0,4,8,4,12,0,8,16,8,4,3,2,12627,12661,17
Task 12627,Job 1,9,4,4,8,1,13,17,4,4,3,2,12627,12661,9
Task 12628,Job 0,6,10,1,7,0,7,13,6,1,1,2,12628,12661,9
Task 12628,Job 1,11,5,3,7,0,14,18,4,3,4,2,12628,12661,13
Task 12629,Job 0,2,9,1,6,1,3,8,5,1,2,1,12629,12662,15
Task 12629,Job 1,7,9,4,12,0,11,19,8,4,2,0,12629,12662,20
Task 12630,Job 0,7,8,2,9,0,9,16,7,2,1,0,12630,12664,9
Task 12630,Job 1,12,5,3,11,1,15,23,8,3,4,0,12630,12664,6
Task 12631,Job 0,1,5,4,12,0,5,13,8,4,3,1,12631,12665,3
Task 12631,Job 1,6,8,3,6,0,9,12,3,3,4,2,12631,12665,14
Task 12632,Job 0,5,7,1,10,1,6,15,9,1,3,0,12632,12665,6
Task 12632,Job 1,10,5,3,8,1,13,18,5,3,2,0,12632,12665,9
Task 12633,Job 0,7,6,4,12,0,11,19,8,4,2,0,12633,12666,15
Task 12633,Job 1,12,5,4,11,1,16,23,7,4,2,2,12633,12666,5
Task 12634,Job 0,8,10,4,6,1,12,14,2,4,3,0,12634,12667,15
Task 12634,Job 1,13,9,3,12,1,16,25,9,3,3,2,12634,12667,14
Task 12635,Job 0,8,9,1,8,0,9,16,7,1,4,0,12635,12668,5
Task 12635,Job 1,13,8,4,9,0,17,22,5,4,1,2,12635,12668,4
Task 12636,Job 0,6,10,1,6,1,7,12,5,1,3,2,12636,12669,3
Task 12636,Job 1,11,9,2,8,0,13,19,6,2,4,2,12636,12669,18
Task 12637,Job 0,4,7,2,9,1,6,13,7,2,3,2,12637,12671,20
Task 12637,Job 1,9,7,2,6,1,11,15,4,2,1,2,12637,12671,6
Task 12638,Job 0,7,6,1,10,0,8,17,9,1,4,1,12638,12672,7
Task 12638,Job 1,12,5,3,7,0,15,19,4,3,3,0,12638,12672,6
Task 12639,Job 0,4,7,2,11,0,6,15,9,2,4,2,12639,12672,15
Task 12639,Job 1,9,9,2,9,0,11,18,7,2,2,1,12639,12672,9
Task 12640,Job 0,6,5,3,10,0,9,16,7,3,2,0,12640,12673,20
Task 12640,Job 1,11,10,4,7,1,15,18,3,4,2,1,12640,12673,15
Task 12641,Job 0,9,4,3,7,1,12,16,4,3,3,1,12641,12675,6
Task 12641,Job 1,14,7,2,11,1,16,25,9,2,4,2,12641,12675,8
Task 12642,Job 0,6,8,1,11,0,7,17,10,1,4,1,12642,12676,18
Task 12642,Job 1,11,9,4,8,0,15,19,4,4,1,2,12642,12676,12
Task 12643,Job 0,1,9,4,9,0,5,10,5,4,4,2,12643,12677,11
Task 12643,Job 1,6,4,1,10,0,7,16,9,1,3,0,12643,12677,5
Task 12644,Job 0,2,7,4,10,1,6,12,6,4,3,1,12644,12678,13
Task 12644,Job 1,7,7,3,12,0,10,19,9,3,3,1,12644,12678,4
Task 12645,Job 0,9,10,4,8,1,13,17,4,4,4,2,12645,12678,19
Task 12645,Job 1,14,10,1,7,1,15,21,6,1,2,0,12645,12678,14
Task 12646,Job 0,2,6,1,9,0,3,11,8,1,2,0,12646,12680,15
Task 12646,Job 1,7,5,4,6,1,11,13,2,4,3,0,12646,12680,18
Task 12647,Job 0,10,5,2,6,0,12,16,4,2,2,0,12647,12680,6
Task 12647,Job 1,15,10,3,11,1,18,26,8,3,4,0,12647,12680,10
Task 12648,Job 0,2,7,2,7,0,4,9,5,2,1,0,12648,12681,16
Task 12648,Job 1,7,6,2,12,0,9,19,10,2,3,0,12648,12681,19
Task 12649,Job 0,8,10,2,11,0,10,19,9,2,3,2,12649,12682,12
Task 12649,Job 1,13,8,4,8,0,17,21,4,4,4,1,12649,12682,7
Task 12650,Job 0,8,8,1,7,0,9,15,6,1,3,1,12650,12684,17
Task 12650,Job 1,13,7,3,8,1,16,21,5,3,1,1,12650,12684,18
Task 12651,Job 0,9,4,1,12,0,10,21,11,1,3,2,12651,12684,19
Task 12651,Job 1,14,9,2,9,0,16,23,7,2,3,0,12651,12684,18
Task 12652,Job 0,10,10,3,7,0,13,17,4,3,3,1,12652,12685,3
Task 12652,Job 1,15,9,4,11,0,19,26,7,4,2,1,12652,12685,8
Task 12653,Job 0,3,8,1,10,1,4,13,9,1,3,2,12653,12686,12
Task 12653,Job 1,8,10,1,9,0,9,17,8,1,1,0,12653,12686,20
Task 12654,Job 0,2,9,4,10,0,6,12,6,4,4,0,12654,12687,6
Task 12654,Job 1,7,8,4,11,0,11,18,7,4,3,2,12654,12687,9
Task 12655,Job 0,10,5,2,10,0,12,20,8,2,1,2,12655,12688,17
Task 12655,Job 1,15,5,4,12,0,19,27,8,4,2,2,12655,12688,5
Task 12656,Job 0,8,7,2,7,0,10,15,5,2,4,1,12656,12690,15
Task 12656,Job 1,13,6,3,11,0,16,24,8,3,3,0,12656,12690,15
Task 12657,Job 0,7,6,2,10,0,9,17,8,2,4,1,12657,12691,3
Task 12657,Job 1,12,6,3,11,0,15,23,8,3,3,2,12657,12691,11
Task 12658,Job 0,1,7,2,9,0,3,10,7,2,3,2,12658,12692,7
Task 12658,Job 1,6,9,3,12,1,9,18,9,3,3,1,12658,12692,8
Task 12659,Job 0,9,7,1,8,0,10,17,7,1,1,2,12659,12693,4
Task 12659,Job 1,14,4,2,12,0,16,26,10,2,1,2,12659,12693,7
Task 12660,Job 0,9,7,3,8,0,12,17,5,3,2,1,12660,12693,10
Task 12660,Job 1,14,5,4,12,0,18,26,8,4,3,2,12660,12693,15
Task 12661,Job 0,1,5,2,12,1,3,13,10,2,4,1,12661,12695,2
Task 12661,Job 1,6,6,2,10,1,8,16,8,2,1,0,12661,12695,16
Task 12662,Job 0,10,10,1,9,0,11,19,8,1,2,0,12662,12696,3
Task 12662,Job 1,15,6,4,12,0,19,27,8,4,3,2,12662,12696,10
Task 12663,Job 0,8,9,4,6,0,12,14,2,4,4,0,12663,12697,13
Task 12663,Job 1,13,7,1,7,0,14,20,6,1,4,0,12663,12697,5
Task 12664,Job 0,4,7,1,7,0,5,11,6,1,4,0,12664,12697,11
Task 12664,Job 1,9,6,1,6,1,10,15,5,1,3,2,12664,12697,6
Task 12665,Job 0,4,5,4,6,1,8,10,2,4,3,0,12665,12698,12
Task 12665,Job 1,9,8,3,10,0,12,19,7,3,2,1,12665,12698,18
Task 12666,Job 0,3,9,2,12,0,5,15,10,2,1,2,12666,12699,16
Task 12666,Job 1,8,4,3,10,0,11,18,7,3,1,0,12666,12699,5
Task 12667,Job 0,1,5,1,10,0,2,11,9,1,2,1,12667,12701,20
Task 12667,Job 1,6,10,2,10,0,8,16,8,2,4,0,12667,12701,14
Task 12668,Job 0,8,9,1,11,0,9,19,10,1,2,0,12668,12701,16
Task 12668,Job 1,13,8,2,8,1,15,21,6,2,4,0,12668,12701,7
Task 12669,Job 0,3,4,4,6,0,7,9,2,4,1,2,12669,12702,19
Task 12669,Job 1,8,6,1,7,1,9,15,6,1,2,1,12669,12702,8
Task 12670,Job 0,1,5,3,7,0,4,8,4,3,2,0,12670,12703,7
Task 12670,Job 1,6,10,3,8,1,9,14,5,3,2,2,12670,12703,14
Task 12671,Job 0,2,6,3,12,0,5,14,9,3,3,2,12671,12705,13
Task 12671,Job 1,7,5,1,9,0,8,16,8,1,2,1,12671,12705,13
Task 12672,Job 0,6,10,3,6,0,9,12,3,3,4,2,12672,12705,6
Task 12672,Job 1,11,10,1,12,1,12,23,11,1,1,2,12672,12705,20
Task 12673,Job 0,1,9,3,12,0,4,13,9,3,4,2,12673,12707,17
Task 12673,Job 1,6,6,1,10,0,7,16,9,1,2,0,12673,12707,11
Task 12674,Job 0,5,4,1,7,1,6,12,6,1,1,2,12674,12708,6
Task 12674,Job 1,10,7,4,8,0,14,18,4,4,2,0,12674,12708,8
Task 12675,Job 0,4,6,3,11,0,7,15,8,3,4,1,12675,12708,11
Task 12675,Job 1,9,7,1,10,0,10,19,9,1,2,2,12675,12708,2
Task 12676,Job 0,1,4,4,7,0,5,8,3,4,4,0,12676,12710,14
Task 12676,Job 1,6,10,1,6,0,7,12,5,1,4,0,12676,12710,10
Task 12677,Job 0,4,4,2,8,0,6,12,6,2,4,0,12677,12710,10
Task 12677,Job 1,9,7,3,7,0,12,16,4,3,2,1,12677,12710,7
Task 12678,Job 0,8,8,4,8,0,12,16,4,4,3,1,12678,12711,17
Task 12678,Job 1,13,8,4,8,1,17,21,4,4,4,1,12678,12711,13
Task 12679,Job 0,4,10,4,8,0,8,12,4,4,2,1,12679,12712,9
Task 12679,Job 1,9,8,2,9,0,11,18,7,2,2,2,12679,12712,19
Task 12680,Job 0,2,6,2,10,0,4,12,8,2,2,0,12680,12714,2
Task 12680,Job 1,7,7,2,6,0,9,13,4,2,3,2,12680,12714,15
Task 12681,Job 0,7,8,2,11,0,9,18,9,2,1,2,12681,12715,12
Task 12681,Job 1,12,7,1,11,1,13,23,10,1,1,0,12681,12715,4
Task 12682,Job 0,10,9,1,6,0,11,16,5,1,2,0,12682,12715,11
Task 12682,Job 1,15,8,4,11,0,19,26,7,4,1,0,12682,12715,8
Task 12683,Job 0,8,8,4,12,0,12,20,8,4,1,1,12683,12716,5
Task 12683,Job 1,13,10,1,12,1,14,25,11,1,1,0,12683,12716,5
Task 12684,Job 0,3,10,3,10,1,6,13,7,3,4,0,12684,12717,16
Task 12684,Job 1,8,10,1,11,0,9,19,10,1,2,2,12684,12717,8
Task 12685,Job 0,10,4,1,10,1,11,20,9,1,3,1,12685,12719,2
Task 12685,Job 1,15,6,3,10,0,18,25,7,3,4,1,12685,12719,9
Task 12686,Job 0,9,9,1,7,0,10,16,6,1,3,2,12686,12720,17
Task 12686,Job 1,14,4,3,12,0,17,26,9,3,1,0,12686,12720,15
Task 12687,Job 0,1,5,1,6,0,2,7,5,1,2,0,12687,12721,3
Task 12687,Job 1,6,8,4,9,0,10,15,5,4,2,2,12687,12721,5
Task 12688,Job 0,2,10,1,12,0,3,14,11,1,1,2,12688,12721,10
Task 12688,Job 1,7,4,1,6,0,8,13,5,1,2,1,12688,12721,11
Task 12689,Job 0,5,10,1,10,0,6,15,9,1,4,1,12689,12723,14
Task 12689,Job 1,10,9,2,7,0,12,17,5,2,4,2,12689,12723,15
Task 12690,Job 0,7,7,3,12,0,10,19,9,3,2,2,12690,12724,4
Task 12690,Job 1,12,6,4,10,0,16,22,6,4,3,2,12690,12724,7
Task 12691,Job 0,3,10,3,11,0,6,14,8,3,4,1,12691,12725,5
Task 12691,Job 1,8,5,1,6,0,9,14,5,1,2,1,12691,12725,6
Task 12692,Job 0,1,5,4,8,0,5,9,4,4,3,2,12692,12725,15
Task 12692,Job 1,6,6,4,9,0,10,15,5,4,1,0,12692,12725,12
Task 12693,Job 0,4,7,2,11,1,6,15,9,2,2,2,12693,12726,11
Task 12693,Job 1,9,8,4,11,0,13,20,7,4,2,0,12693,12726,14
Task 12694,Job 0,3,4,2,11,0,5,14,9,2,1,1,12694,12728,13
Task 12694,Job 1,8,10,1,10,0,9,18,9,1,4,1,12694,12728,9
Task 12695,Job 0,4,6,1,11,0,5,15,10,1,1,2,12695,12728,17
Task 12695,Job 1,9,5,2,10,0,11,19,8,2,2,1,12695,12728,3
Task 12696,Job 0,3,8,4,11,0,7,14,7,4,4,1,12696,12730,4
Task 12696,Job 1,8,6,1,6,1,9,14,5,1,2,0,12696,12730,12
Task 12697,Job 0,8,10,2,11,0,10,19,9,2,4,2,12697,12730,13
Task 12697,Job 1,13,5,1,6,1,14,19,5,1,4,2,12697,12730,10
Task 12698,Job 0,6,4,3,12,0,9,18,9,3,4,1,12698,12732,17
Task 12698,Job 1,11,7,1,11,1,12,22,10,1,2,0,12698,12732,4
Task 12699,Job 0,1,7,2,10,0,3,11,8,2,3,2,12699,12733,7
Task 12699,Job 1,6,4,3,8,0,9,14,5,3,4,0,12699,12733,17
Task 12700,Job 0,2,4,1,11,0,3,13,10,1,4,1,12700,12733,11
Task 12700,Job 1,7,5,2,10,0,9,17,8,2,1,0,12700,12733,7
Task 12701,Job 0,10,5,4,7,0,14,17,3,4,1,2,12701,12735,20
Task 12701,Job 1,15,8,2,6,1,17,21,4,2,3,2,12701,12735,16
Task 12702,Job 0,4,9,3,6,0,7,10,3,3,2,0,12702,12736,16
Task 12702,Job 1,9,8,3,9,1,12,18,6,3,3,0,12702,12736,8
Task 12703,Job 0,8,8,3,7,1,11,15,4,3,3,0,12703,12736,9
Task 12703,Job 1,13,6,1,7,1,14,20,6,1,2,0,12703,12736,10
Task 12704,Job 0,10,9,3,8,0,13,18,5,3,4,1,12704,12738,14
Task 12704,Job 1,15,4,1,9,0,16,24,8,1,4,0,12704,12738,7
Task 12705,Job 0,4,10,2,9,1,6,13,7,2,4,0,12705,12738,11
Task 12705,Job 1,9,9,1,7,1,10,16,6,1,2,1,12705,12738,4
Task 12706,Job 0,5,10,3,12,1,8,17,9,3,2,2,12706,12740,12
Task 12706,Job 1,10,10,2,7,0,12,17,5,2,1,1,12706,12740,19
Task 12707,Job 0,1,4,2,12,0,3,13,10,2,1,1,12707,12741,7
Task 12707,Job 1,6,8,2,11,0,8,17,9,2,2,1,12707,12741,3
Task 12708,Job 0,8,7,3,10,1,11,18,7,3,2,1,12708,12741,16
Task 12708,Job 1,13,8,4,9,0,17,22,5,4,4,0,12708,12741,2
Task 12709,Job 0,3,10,1,10,1,4,13,9,1,3,1,12709,12742,9
Task 12709,Job 1,8,6,4,9,0,12,17,5,4,4,0,12709,12742,17
Task 12710,Job 0,7,10,3,11,0,10,18,8,3,2,0,12710,12744,17
Task 12710,Job 1,12,8,3,7,0,15,19,4,3,2,1,12710,12744,17
Task 12711,Job 0,9,8,4,12,1,13,21,8,4,4,1,12711,12745,6
Task 12711,Job 1,14,5,4,9,1,18,23,5,4,1,1,12711,12745,12
Task 12712,Job 0,10,5,3,7,0,13,17,4,3,4,0,12712,12745,6
Task 12712,Job 1,15,9,2,9,1,17,24,7,2,2,2,12712,12745,14
Task 12713,Job 0,10,10,1,11,0,11,21,10,1,1,1,12713,12746,13
Task 12713,Job 1,15,4,1,7,0,16,22,6,1,1,0,12713,12746,8
Task 12714,Job 0,2,6,3,12,0,5,14,9,3,4,0,12714,12747,3
Task 12714,Job 1,7,5,2,12,0,9,19,10,2,4,2,12714,12747,20
Task 12715,Job 0,10,9,2,10,1,12,20,8,2,4,1,12715,12749,11
Task 12715,Job 1,15,7,2,11,1,17,26,9,2,2,0,12715,12749,6
Task 12716,Job 0,7,6,2,6,0,9,13,4,2,1,2,12716,12750,16
Task 12716,Job 1,12,8,2,8,0,14,20,6,2,3,2,12716,12750,19
Task 12717,Job 0,5,5,2,11,1,7,16,9,2,4,2,12717,12751,6
Task 12717,Job 1,10,9,2,9,0,12,19,7,2,2,2,12717,12751,3
Task 12718,Job 0,3,8,2,8,0,5,11,6,2,4,2,12718,12752,3
Task 12718,Job 1,8,5,2,7,0,10,15,5,2,2,1,12718,12752,14
Task 12719,Job 0,4,10,1,10,0,5,14,9,1,4,2,12719,12753,18
Task 12719,Job 1,9,7,3,8,1,12,17,5,3,4,2,12719,12753,19
Task 12720,Job 0,8,4,4,9,1,12,17,5,4,2,1,12720,12754,17
Task 12720,Job 1,13,5,2,9,1,15,22,7,2,3,1,12720,12754,18
Task 12721,Job 0,7,10,4,12,1,11,19,8,4,4,0,12721,12755,11
Task 12721,Job 1,12,9,3,6,0,15,18,3,3,1,1,12721,12755,18
Task 12722,Job 0,5,6,3,11,0,8,16,8,3,3,1,12722,12756,13
Task 12722,Job 1,10,5,4,11,0,14,21,7,4,1,2,12722,12756,20
Task 12723,Job 0,6,7,4,10,1,10,16,6,4,4,1,12723,12756,10
Task 12723,Job 1,11,6,3,7,0,14,18,4,3,2,0,12723,12756,12
Task 12724,Job 0,6,7,4,7,1,10,13,3,4,4,0,12724,12758,12
Task 12724,Job 1,11,6,1,12,0,12,23,11,1,4,1,12724,12758,4
Task 12725,Job 0,8,4,1,9,1,9,17,8,1,2,0,12725,12758,13
Task 12725,Job 1,13,9,2,12,0,15,25,10,2,1,2,12725,12758,20
Task 12726,Job 0,3,7,2,6,0,5,9,4,2,2,2,12726,12760,12
Task 12726,Job 1,8,10,2,9,1,10,17,7,2,4,1,12726,12760,9
Task 12727,Job 0,5,9,4,11,0,9,16,7,4,1,0,12727,12760,2
Task 12727,Job 1,10,9,2,10,0,12,20,8,2,2,1,12727,12760,16
Task 12728,Job 0,3,5,4,10,0,7,13,6,4,2,2,12728,12761,12
Task 12728,Job 1,8,5,1,7,0,9,15,6,1,1,0,12728,12761,17
Task 12729,Job 0,6,9,2,10,0,8,16,8,2,3,2,12729,12762,5
Task 12729,Job 1,11,9,3,9,0,14,20,6,3,4,0,12729,12762,20
Task 12730,Job 0,5,7,4,6,0,9,11,2,4,4,1,12730,12764,11
Task 12730,Job 1,10,6,4,7,0,14,17,3,4,1,1,12730,12764,12
Task 12731,Job 0,9,10,1,10,0,10,19,9,1,4,0,12731,12765,16
Task 12731,Job 1,14,9,1,12,1,15,26,11,1,3,2,12731,12765,20
Task 12732,Job 0,9,6,4,7,0,13,16,3,4,3,0,12732,12765,19
Task 12732,Job 1,14,6,3,9,0,17,23,6,3,3,0,12732,12765,18
Task 12733,Job 0,10,8,3,12,0,13,22,9,3,3,2,12733,12766,2
Task 12733,Job 1,15,7,4,10,0,19,25,6,4,4,1,12733,12766,7
Task 12734,Job 0,2,7,2,12,1,4,14,10,2,4,0,12734,12768,19
Task 12734,Job 1,7,6,1,6,0,8,13,5,1,3,0,12734,12768,4
Task 12735,Job 0,1,5,3,6,1,4,7,3,3,4,0,12735,12769,6
Task 12735,Job 1,6,9,3,9,0,9,15,6,3,1,0,12735,12769,8
Task 12736,Job 0,9,7,1,7,0,10,16,6,1,4,0,12736,12770,16
Task 12736,Job 1,14,9,1,6,0,15,20,5,1,4,2,12736,12770,16
Task 12737,Job 0,8,5,2,12,1,10,20,10,2,1,0,12737,12770,17
Task 12737,Job 1,13,8,4,12,0,17,25,8,4,3,0,12737,12770,5
Task 12738,Job 0,2,4,3,12,0,5,14,9,3,3,1,12738,12772,9
Task 12738,Job 1,7,9,4,7,1,11,14,3,4,1,0,12738,12772,15
Task 12739,Job 0,9,10,3,8,0,12,17,5,3,1,0,12739,12772,5
Task 12739,Job 1,14,4,2,8,0,16,22,6,2,3,2,12739,12772,14
Task 12740,Job 0,1,10,3,12,0,4,13,9,3,2,0,12740,12774,11
Task 12740,Job 1,6,9,2,7,1,8,13,5,2,2,2,12740,12774,18
Task 12741,Job 0,7,6,3,7,0,10,14,4,3,1,1,12741,12774,13
Task 12741,Job 1,12,8,2,7,0,14,19,5,2,3,1,12741,12774,5
Task 12742,Job 0,3,5,1,7,1,4,10,6,1,3,2,12742,12776,10
Task 12742,Job 1,8,4,4,12,1,12,20,8,4,1,2,12742,12776,20
Task 12743,Job 0,5,10,3,11,1,8,16,8,3,4,1,12743,12776,19
Task 12743,Job 1,10,4,3,8,0,13,18,5,3,4,0,12743,12776,5
Task 12744,Job 0,8,7,2,7,0,10,15,5,2,1,0,12744,12777,16
Task 12744,Job 1,13,7,3,7,0,16,20,4,3,1,1,12744,12777,7
Task 12745,Job 0,4,6,4,11,0,8,15,7,4,2,2,12745,12779,12
Task 12745,Job 1,9,4,4,6,0,13,15,2,4,4,2,12745,12779,19
Task 12746,Job 0,9,7,3,9,0,12,18,6,3,3,2,12746,12779,5
Task 12746,Job 1,14,6,1,10,0,15,24,9,1,2,1,12746,12779,4
Task 12747,Job 0,3,6,2,7,0,5,10,5,2,1,1,12747,12780,14
Task 12747,Job 1,8,8,3,10,0,11,18,7,3,3,2,12747,12780,2
Task 12748,Job 0,10,10,3,11,0,13,21,8,3,1,0,12748,12782,13
Task 12748,Job 1,15,4,1,8,0,16,23,7,1,1,0,12748,12782,2
Task 12749,Job 0,2,10,3,8,1,5,10,5,3,2,2,12749,12783,20
Task 12749,Job 1,7,8,2,7,0,9,14,5,2,4,2,12749,12783,13
Task 12750,Job 0,4,9,4,11,0,8,15,7,4,2,0,12750,12783,8
Task 12750,Job 1,9,7,2,9,1,11,18,7,2,3,2,12750,12783,20
Task 12751,Job 0,6,9,3,10,0,9,16,7,3,2,1,12751,12785,16
Task 12751,Job 1,11,9,4,9,1,15,20,5,4,4,0,12751,12785,13
Task 12752,Job 0,7,6,4,6,0,11,13,2,4,4,1,12752,12786,10
Task 12752,Job 1,12,10,4,12,0,16,24,8,4,4,2,12752,12786,10
Task 12753,Job 0,7,9,4,12,0,11,19,8,4,1,0,12753,12787,3
Task 12753,Job 1,12,5,3,6,1,15,18,3,3,1,1,12753,12787,11
Task 12754,Job 0,6,7,3,6,0,9,12,3,3,1,1,12754,12788,19
Task 12754,Job 1,11,8,1,7,1,12,18,6,1,4,2,12754,12788,11
Task 12755,Job 0,5,4,3,10,1,8,15,7,3,2,1,12755,12789,6
Task 12755,Job 1,10,8,1,11,1,11,21,10,1,2,2,12755,12789,8
Task 12756,Job 0,2,4,2,11,0,4,13,9,2,4,1,12756,12790,3
Task 12756,Job 1,7,9,1,7,0,8,14,6,1,4,2,12756,12790,20
Task 12757,Job 0,2,5,1,7,0,3,9,6,1,3,0,12757,12791,8
Task 12757,Job 1,7,6,2,12,0,9,19,10,2,4,0,12757,12791,12
Task 12758,Job 0,3,4,4,7,1,7,10,3,4,2,2,12758,12791,10
Task 12758,Job 1,8,9,2,12,0,10,20,10,2,4,2,12758,12791,15
Task 12759,Job 0,1,10,3,9,0,4,10,6,3,2,1,12759,12792,20
Task 12759,Job 1,6,4,2,11,0,8,17,9,2,2,2,12759,12792,11
Task 12760,Job 0,5,7,3,10,0,8,15,7,3,4,0,12760,12793,6
Task 12760,Job 1,10,6,4,7,1,14,17,3,4,3,1,12760,12793,8
Task 12761,Job 0,2,7,4,8,0,6,10,4,4,3,2,12761,12795,15
Task 12761,Job 1,7,6,1,8,0,8,15,7,1,2,1,12761,12795,6
Task 12762,Job 0,2,6,1,12,0,3,14,11,1,1,0,12762,12796,9
Task 12762,Job 1,7,9,1,9,0,8,16,8,1,2,2,12762,12796,2
Task 12763,Job 0,5,8,4,10,0,9,15,6,4,1,0,12763,12796,15
Task 12763,Job 1,10,8,3,9,1,13,19,6,3,3,0,12763,12796,16
Task 12764,Job 0,10,4,1,10,0,11,20,9,1,4,1,12764,12797,19
Task 12764,Job 1,15,8,2,7,0,17,22,5,2,4,1,12764,12797,10
Task 12765,Job 0,1,5,3,10,0,4,11,7,3,2,1,12765,12798,5
Task 12765,Job 1,6,6,2,11,1,8,17,9,2,1,1,12765,12798,5
Task 12766,Job 0,9,9,4,10,1,13,19,6,4,2,1,12766,12800,3
Task 12766,Job 1,14,10,2,10,0,16,24,8,2,4,1,12766,12800,5
Task 12767,Job 0,5,9,2,11,0,7,16,9,2,2,2,12767,12801,8
Task 12767,Job 1,10,4,1,8,0,11,18,7,1,4,0,12767,12801,18
Task 12768,Job 0,6,9,1,9,0,7,15,8,1,3,0,12768,12802,16
Task 12768,Job 1,11,4,1,12,1,12,23,11,1,3,0,12768,12802,5
Task 12769,Job 0,4,7,4,12,0,8,16,8,4,2,2,12769,12802,16
Task 12769,Job 1,9,10,2,8,0,11,17,6,2,2,0,12769,12802,2
Task 12770,Job 0,2,5,1,7,0,3,9,6,1,2,0,12770,12803,19
Task 12770,Job 1,7,5,3,6,0,10,13,3,3,2,1,12770,12803,19
Task 12771,Job 0,3,9,3,9,0,6,12,6,3,2,1,12771,12804,3
Task 12771,Job 1,8,4,2,8,0,10,16,6,2,1,2,12771,12804,8
Task 12772,Job 0,1,9,3,7,1,4,8,4,3,2,1,12772,12806,19
Task 12772,Job 1,6,10,2,6,0,8,12,4,2,3,1,12772,12806,17
Task 12773,Job 0,2,10,4,11,0,6,13,7,4,3,0,12773,12807,17
Task 12773,Job 1,7,10,2,10,1,9,17,8,2,2,0,12773,12807,15
Task 12774,Job 0,3,10,2,9,0,5,12,7,2,4,2,12774,12808,6
Task 12774,Job 1,8,10,3,8,0,11,16,5,3,1,0,12774,12808,8
Task 12775,Job 0,6,6,3,6,1,9,12,3,3,1,0,12775,12809,18
Task 12775,Job 1,11,7,2,8,0,13,19,6,2,4,0,12775,12809,10
Task 12776,Job 0,4,8,1,12,0,5,16,11,1,3,0,12776,12810,9
Task 12776,Job 1,9,4,2,10,0,11,19,8,2,1,2,12776,12810,16
Task 12777,Job 0,6,5,2,9,0,8,15,7,2,2,1,12777,12811,16
Task 12777,Job 1,11,7,4,9,0,15,20,5,4,1,0,12777,12811,17
Task 12778,Job 0,2,10,4,9,0,6,11,5,4,2,1,12778,12812,4
Task 12778,Job 1,7,7,1,11,0,8,18,10,1,1,0,12778,12812,4
Task 12779,Job 0,1,4,3,12,0,4,13,9,3,4,0,12779,12813,3
Task 12779,Job 1,6,10,1,11,0,7,17,10,1,3,0,12779,12813,20
Task 12780,Job 0,2,6,2,10,0,4,12,8,2,4,0,12780,12814,11
Task 12780,Job 1,7,8,1,6,0,8,13,5,1,3,2,12780,12814,4
Task 12781,Job 0,7,10,4,6,1,11,13,2,4,2,0,12781,12814,14
Task 12781,Job 1,12,10,2,12,0,14,24,10,2,3,1,12781,12814,3
Task 12782,Job 0,6,4,1,9,0,7,15,8,1,2,1,12782,12816,6
Task 12782,Job 1,11,6,3,8,0,14,19,5,3,3,0,12782,12816,6
Task 12783,Job 0,6,8,3,10,0,9,16,7,3,4,2,12783,12817,10
Task 12783,Job 1,11,10,4,11,0,15,22,7,4,2,0,12783,12817,13
Task 12784,Job 0,10,8,1,9,0,11,19,8,1,1,2,12784,12817,17
Task 12784,Job 1,15,4,2,12,1,17,27,10,2,2,0,12784,12817,11
Task 12785,Job 0,3,6,3,8,1,6,11,5,3,3,2,12785,12818,6
Task 12785,Job 1,8,9,3,11,0,11,19,8,3,2,2,12785,12818,10
Task 12786,Job 0,3,5,4,7,0,7,10,3,4,1,2,12786,12819,14
Task 12786,Job 1,8,5,3,10,1,11,18,7,3,4,1,12786,12819,11
Task 12787,Job 0,5,10,1,10,0,6,15,9,1,2,1,12787,12821,4
Task 12787,Job 1,10,6,2,10,0,12,20,8,2,3,1,12787,12821,10
Task 12788,Job 0,3,7,3,7,0,6,10,4,3,1,2,12788,12821,3
Task 12788,Job 1,8,10,3,10,1,11,18,7,3,3,0,12788,12821,9
Task 12789,Job 0,10,6,2,7,0,12,17,5,2,4,1,12789,12822,13
Task 12789,Job 1,15,6,4,6,0,19,21,2,4,3,1,12789,12822,7
Task 12790,Job 0,2,5,4,9,0,6,11,5,4,1,2,12790,12824,2
Task 12790,Job 1,7,7,2,6,0,9,13,4,2,4,0,12790,12824,10
Task 12791,Job 0,5,8,4,12,0,9,17,8,4,1,0,12791,12825,19
Task 12791,Job 1,10,5,1,11,1,11,21,10,1,2,0,12791,12825,20
Task 12792,Job 0,2,4,1,9,0,3,11,8,1,4,0,12792,12826,2
Task 12792,Job 1,7,4,2,7,0,9,14,5,2,3,2,12792,12826,7
Task 12793,Job 0,8,5,4,8,1,12,16,4,4,3,0,12793,12827,7
Task 12793,Job 1,13,10,4,12,1,17,25,8,4,1,0,12793,12827,7
Task 12794,Job 0,10,8,1,10,0,11,20,9,1,4,0,12794,12827,2
Task 12794,Job 1,15,6,1,8,1,16,23,7,1,3,2,12794,12827,18
Task 12795,Job 0,5,10,3,11,1,8,16,8,3,1,0,12795,12829,18
Task 12795,Job 1,10,9,4,7,0,14,17,3,4,1,1,12795,12829,19
Task 12796,Job 0,7,10,2,11,0,9,18,9,2,1,0,12796,12829,9
Task 12796,Job 1,12,5,1,7,1,13,19,6,1,1,1,12796,12829,8
Task 12797,Job 0,8,7,2,8,0,10,16,6,2,1,2,12797,12830,5
Task 12797,Job 1,13,5,1,12,0,14,25,11,1,2,1,12797,12830,19
Task 12798,Job 0,9,10,2,8,1,11,17,6,2,2,0,12798,12832,7
Task 12798,Job 1,14,7,3,12,1,17,26,9,3,2,1,12798,12832,15
Task 12799,Job 0,4,4,4,10,0,8,14,6,4,1,2,12799,12832,10
Task 12799,Job 1,9,8,3,7,0,12,16,4,3,2,1,12799,12832,8
Task 12800,Job 0,2,10,4,11,0,6,13,7,4,4,0,12800,12833,17
Task 12800,Job 1,7,10,4,6,1,11,13,2,4,3,1,12800,12833,19
Task 12801,Job 0,6,10,1,7,0,7,13,6,1,1,2,12801,12835,11
Task 12801,Job 1,11,4,1,10,1,12,21,9,1,3,2,12801,12835,15
Task 12802,Job 0,1,10,3,6,0,4,7,3,3,4,0,12802,12836,11
Task 12802,Job 1,6,10,3,11,0,9,17,8,3,2,0,12802,12836,10
Task 12803,Job 0,9,5,2,8,0,11,17,6,2,4,0,12803,12836,17
Task 12803,Job 1,14,7,4,9,0,18,23,5,4,2,1,12803,12836,16
Task 12804,Job 0,8,4,1,12,0,9,20,11,1,4,0,12804,12837,6
Task 12804,Job 1,13,10,3,8,0,16,21,5,3,3,1,12804,12837,4
Task 12805,Job 0,6,5,2,11,0,8,17,9,2,1,2,12805,12838,18
Task 12805,Job 1,11,8,1,12,0,12,23,11,1,1,1,12805,12838,14
Task 12806,Job 0,2,10,4,6,0,6,8,2,4,1,0,12806,12840,3
Task 12806,Job 1,7,4,4,6,0,11,13,2,4,4,2,12806,12840,7
Task 12807,Job 0,9,4,1,10,0,10,19,9,1,4,1,12807,12841,15
Task 12807,Job 1,14,5,4,6,0,18,20,2,4,3,0,12807,12841,15
Task 12808,Job 0,7,7,1,7,0,8,14,6,1,2,1,12808,12841,9
Task 12808,Job 1,12,4,4,8,1,16,20,4,4,3,1,12808,12841,3
Task 12809,Job 0,1,10,2,6,0,3,7,4,2,2,0,12809,12842,2
Task 12809,Job 1,6,4,3,10,0,9,16,7,3,2,2,12809,12842,14
Task 12810,Job 0,6,5,4,12,0,10,18,8,4,3,0,12810,12844,13
Task 12810,Job 1,11,10,1,8,0,12,19,7,1,1,2,12810,12844,18
Task 12811,Job 0,6,6,2,12,0,8,18,10,2,4,2,12811,12844,17
Task 12811,Job 1,11,6,2,8,0,13,19,6,2,1,1,12811,12844,13
Task 12812,Job 0,7,10,4,7,0,11,14,3,4,2,2,12812,12846,18
Task 12812,Job 1,12,8,4,12,0,16,24,8,4,3,2,12812,12846,2
Task 12813,Job 0,8,5,4,10,1,12,18,6,4,1,2,12813,12847,15
Task 12813,Job 1,13,6,1,8,0,14,21,7,1,4,1,12813,12847,20
Task 12814,Job 0,6,5,1,8,0,7,14,7,1,2,0,12814,12848,7
Task 12814,Job 1,11,10,4,7,1,15,18,3,4,2,0,12814,12848,2
Task 12815,Job 0,8,4,1,8,0,9,16,7,1,3,2,12815,12849,18
Task 12815,Job 1,13,4,1,6,0,14,19,5,1,4,0,12815,12849,11
Task 12816,Job 0,1,7,4,7,0,5,8,3,4,3,0,12816,12849,5
Task 12816,Job 1,6,9,3,7,0,9,13,4,3,3,1,12816,12849,17
Task 12817,Job 0,9,9,4,9,0,13,18,5,4,1,0,12817,12851,12
Task 12817,Job 1,14,6,4,6,0,18,20,2,4,4,1,12817,12851,19
Task 12818,Job 0,4,7,3,9,1,7,13,6,3,1,0,12818,12852,7
Task 12818,Job 1,9,5,2,11,0,11,20,9,2,1,0,12818,12852,3
Task 12819,Job 0,10,9,3,12,0,13,22,9,3,4,0,12819,12853,6
Task 12819,Job 1,15,5,3,12,0,18,27,9,3,4,2,12819,12853,6
Task 12820,Job 0,10,7,1,9,1,11,19,8,1,1,1,12820,12853,13
Task 12820,Job 1,15,8,2,9,0,17,24,7,2,1,0,12820,12853,13
Task 12821,Job 0,9,10,2,9,0,11,18,7,2,2,1,12821,12854,19
Task 12821,Job 1,14,6,1,9,0,15,23,8,1,2,2,12821,12854,13
Task 12822,Job 0,9,10,2,12,0,11,21,10,2,3,2,12822,12855,3
Task 12822,Job 1,14,6,1,12,0,15,26,11,1,4,1,12822,12855,20
Task 12823,Job 0,6,10,2,11,1,8,17,9,2,3,2,12823,12856,18
Task 12823,Job 1,11,7,4,12,0,15,23,8,4,1,1,12823,12856,13
Task 12824,Job 0,2,7,2,8,0,4,10,6,2,3,1,12824,12858,15
Task 12824,Job 1,7,9,2,10,0,9,17,8,2,3,1,12824,12858,14
Task 12825,Job 0,7,7,2,12,0,9,19,10,2,1,0,12825,12859,19
Task 12825,Job 1,12,5,2,12,0,14,24,10,2,1,0,12825,12859,20
Task 12826,Job 0,8,4,4,7,0,12,15,3,4,1,0,12826,12859,9
Task 12826,Job 1,13,9,1,12,0,14,25,11,1,1,0,12826,12859,16
Task 12827,Job 0,4,4,3,9,0,7,13,6,3,4,2,12827,12861,8
Task 12827,Job 1,9,8,4,9,0,13,18,5,4,1,0,12827,12861,10
Task 12828,Job 0,7,6,4,7,0,11,14,3,4,3,1,12828,12861,2
Task 12828,Job 1,12,4,4,10,1,16,22,6,4,1,1,12828,12861,15
Task 12829,Job 0,9,9,2,10,0,11,19,8,2,3,2,12829,12863,7
Task 12829,Job 1,14,9,4,8,1,18,22,4,4,4,1,12829,12863,18
Task 12830,Job 0,8,10,1,9,1,9,17,8,1,2,0,12830,12863,19
Task 12830,Job 1,13,7,2,12,0,15,25,10,2,4,1,12830,12863,7
Task 12831,Job 0,3,8,2,9,0,5,12,7,2,1,2,12831,12865,19
Task 12831,Job 1,8,10,3,7,0,11,15,4,3,3,2,12831,12865,5
Task 12832,Job 0,3,6,3,10,0,6,13,7,3,3,0,12832,12866,16
Task 12832,Job 1,8,6,1,8,0,9,16,7,1,3,2,12832,12866,12
Task 12833,Job 0,1,9,4,11,0,5,12,7,4,2,2,12833,12866,5
Task 12833,Job 1,6,9,3,8,0,9,14,5,3,3,2,12833,12866,3
Task 12834,Job 0,4,8,2,10,1,6,14,8,2,2,0,12834,12868,7
Task 12834,Job 1,9,5,2,6,0,11,15,4,2,1,2,12834,12868,5
Task 12835,Job 0,6,7,2,12,0,8,18,10,2,2,2,12835,12869,16
Task 12835,Job 1,11,5,1,12,0,12,23,11,1,1,0,12835,12869,3
Task 12836,Job 0,1,4,2,10,1,3,11,8,2,3,0,12836,12870,18
Task 12836,Job 1,6,8,2,6,0,8,12,4,2,3,1,12836,12870,17
Task 12837,Job 0,4,8,2,9,0,6,13,7,2,2,1,12837,12870,7
Task 12837,Job 1,9,8,3,10,0,12,19,7,3,3,1,12837,12870,12
Task 12838,Job 0,8,10,4,10,0,12,18,6,4,1,1,12838,12871,11
Task 12838,Job 1,13,10,4,11,1,17,24,7,4,3,1,12838,12871,3
Task 12839,Job 0,8,6,2,12,0,10,20,10,2,3,0,12839,12872,14
Task 12839,Job 1,13,7,4,12,0,17,25,8,4,4,1,12839,12872,7
Task 12840,Job 0,10,4,4,10,0,14,20,6,4,1,0,12840,12873,10
Task 12840,Job 1,15,5,1,7,0,16,22,6,1,2,1,12840,12873,15
Task 12841,Job 0,6,6,2,11,0,8,17,9,2,1,1,12841,12875,5
Task 12841,Job 1,11,7,4,9,0,15,20,5,4,1,1,12841,12875,4
Task 12842,Job 0,6,8,1,11,1,7,17,10,1,1,0,12842,12876,16
Task 12842,Job 1,11,10,1,7,0,12,18,6,1,4,2,12842,12876,4
Task 12843,Job 0,9,9,4,8,0,13,17,4,4,3,2,12843,12877,9
Task 12843,Job 1,14,9,3,11,1,17,25,8,3,3,0,12843,12877,13
Task 12844,Job 0,6,4,1,10,0,7,16,9,1,1,0,12844,12878,2
Task 12844,Job 1,11,5,2,9,0,13,20,7,2,4,1,12844,12878,8
Task 12845,Job 0,3,7,4,12,1,7,15,8,4,2,1,12845,12879,6
Task 12845,Job 1,8,10,4,10,0,12,18,6,4,4,2,12845,12879,19
Task 12846,Job 0,3,10,3,12,1,6,15,9,3,4,0,12846,12879,2
Task 12846,Job 1,8,9,4,11,0,12,19,7,4,1,0,12846,12879,13
Task 12847,Job 0,9,10,4,7,0,13,16,3,4,3,0,12847,12881,3
Task 12847,Job 1,14,5,4,10,0,18,24,6,4,1,1,12847,12881,17
Task 12848,Job 0,1,10,4,12,0,5,13,8,4,4,0,12848,12881,11
Task 12848,Job 1,6,6,2,10,0,8,16,8,2,2,0,12848,12881,9
Task 12849,Job 0,6,5,4,9,0,10,15,5,4,2,0,12849,12883,20
Task 12849,Job 1,11,10,4,12,0,15,23,8,4,2,0,12849,12883,15
Task 12850,Job 0,8,9,3,9,0,11,17,6,3,4,2,12850,12883,14
Task 12850,Job 1,13,10,4,9,0,17,22,5,4,3,1,12850,12883,5
Task 12851,Job 0,8,9,1,11,1,9,19,10,1,3,1,12851,12885,2
Task 12851,Job 1,13,7,4,11,1,17,24,7,4,4,2,12851,12885,16
Task 12852,Job 0,3,4,3,12,0,6,15,9,3,2,0,12852,12885,18
Task 12852,Job 1,8,7,4,9,0,12,17,5,4,1,2,12852,12885,13
Task 12853,Job 0,8,8,2,9,0,10,17,7,2,1,1,12853,12886,6
Task 12853,Job 1,13,5,3,8,1,16,21,5,3,3,1,12853,12886,3
Task 12854,Job 0,9,4,1,11,0,10,20,10,1,3,0,12854,12887,11
Task 12854,Job 1,14,10,2,8,0,16,22,6,2,1,0,12854,12887,15
Task 12855,Job 0,7,9,1,6,0,8,13,5,1,1,0,12855,12889,8
Task 12855,Job 1,12,10,3,8,1,15,20,5,3,4,2,12855,12889,12
Task 12856,Job 0,8,4,4,10,0,12,18,6,4,3,1,12856,12890,2
Task 12856,Job 1,13,6,3,7,0,16,20,4,3,4,0,12856,12890,18
Task 12857,Job 0,10,9,4,6,0,14,16,2,4,1,1,12857,12891,7
Task 12857,Job 1,15,9,1,11,0,16,26,10,1,3,2,12857,12891,2
Task 12858,Job 0,5,9,4,6,0,9,11,2,4,2,2,12858,12892,20
Task 12858,Job 1,10,6,4,8,1,14,18,4,4,1,2,12858,12892,14
Task 12859,Job 0,5,10,3,12,1,8,17,9,3,3,1,12859,12892,5
Task 12859,Job 1,10,6,3,7,1,13,17,4,3,4,2,12859,12892,8
Task 12860,Job 0,8,8,2,9,0,10,17,7,2,1,2,12860,12894,18
Task 12860,Job 1,13,4,3,10,0,16,23,7,3,4,2,12860,12894,2
Task 12861,Job 0,1,5,4,11,1,5,12,7,4,2,2,12861,12894,7
Task 12861,Job 1,6,4,4,11,1,10,17,7,4,4,1,12861,12894,11
Task 12862,Job 0,8,7,4,9,0,12,17,5,4,2,2,12862,12896,15
Task 12862,Job 1,13,4,3,9,0,16,22,6,3,4,2,12862,12896,19
Task 12863,Job 0,2,5,1,9,1,3,11,8,1,4,1,12863,12896,12
Task 12863,Job 1,7,6,2,9,1,9,16,7,2,3,2,12863,12896,5
Task 12864,Job 0,7,4,3,10,1,10,17,7,3,3,2,12864,12897,11
Task 12864,Job 1,12,7,3,9,1,15,21,6,3,3,2,12864,12897,18
Task 12865,Job 0,4,5,1,8,0,5,12,7,1,2,1,12865,12899,15
Task 12865,Job 1,9,6,3,10,0,12,19,7,3,3,0,12865,12899,15
Task 12866,Job 0,1,10,3,7,1,4,8,4,3,2,1,12866,12899,7
Task 12866,Job 1,6,4,1,8,0,7,14,7,1,1,1,12866,12899,8
Task 12867,Job 0,4,8,2,7,0,6,11,5,2,3,2,12867,12900,3
Task 12867,Job 1,9,8,2,12,0,11,21,10,2,4,2,12867,12900,9
Task 12868,Job 0,4,5,1,11,0,5,15,10,1,2,2,12868,12902,13
Task 12868,Job 1,9,6,4,9,0,13,18,5,4,1,0,12868,12902,14
Task 12869,Job 0,3,5,1,12,0,4,15,11,1,3,2,12869,12903,14
Task 12869,Job 1,8,6,2,11,0,10,19,9,2,3,1,12869,12903,11
Task 12870,Job 0,7,8,1,9,0,8,16,8,1,3,2,12870,12903,8
Task 12870,Job 1,12,8,2,10,0,14,22,8,2,1,1,12870,12903,15
Task 12871,Job 0,1,4,1,7,0,2,8,6,1,4,1,12871,12905,15
Task 12871,Job 1,6,4,3,7,1,9,13,4,3,3,1,12871,12905,19
Task 12872,Job 0,3,6,3,6,1,6,9,3,3,3,1,12872,12905,9
Task 12872,Job 1,8,8,3,9,0,11,17,6,3,2,2,12872,12905,9
Task 12873,Job 0,9,9,4,6,0,13,15,2,4,3,1,12873,12906,9
Task 12873,Job 1,14,8,1,9,0,15,23,8,1,2,2,12873,12906,14
Task 12874,Job 0,1,10,4,11,0,5,12,7,4,4,1,12874,12908,12
Task 12874,Job 1,6,6,3,7,0,9,13,4,3,4,0,12874,12908,13
Task 12875,Job 0,10,6,4,8,0,14,18,4,4,1,2,12875,12909,7
Task 12875,Job 1,15,9,2,12,0,17,27,10,2,4,0,12875,12909,16
Task 12876,Job 0,7,4,3,11,0,10,18,8,3,2,1,12876,12910,13
Task 12876,Job 1,12,8,3,8,0,15,20,5,3,2,2,12876,12910,3
Task 12877,Job 0,3,5,2,11,0,5,14,9,2,4,2,12877,12910,17
Task 12877,Job 1,8,5,1,9,0,9,17,8,1,4,0,12877,12910,18
Task 12878,Job 0,2,10,4,6,0,6,8,2,4,1,0,12878,12911,10
Task 12878,Job 1,7,10,1,10,0,8,17,9,1,2,0,12878,12911,11
Task 12879,Job 0,6,6,1,7,0,7,13,6,1,1,2,12879,12913,18
Task 12879,Job 1,11,9,2,10,0,13,21,8,2,4,2,12879,12913,16
Task 12880,Job 0,7,8,4,8,0,11,15,4,4,4,0,12880,12914,4
Task 12880,Job 1,12,9,4,7,0,16,19,3,4,2,0,12880,12914,19
Task 12881,Job 0,7,9,4,9,0,11,16,5,4,3,1,12881,12915,20
Task 12881,Job 1,12,9,4,9,0,16,21,5,4,4,0,12881,12915,14
Task 12882,Job 0,6,4,3,8,0,9,14,5,3,2,1,12882,12915,2
Task 12882,Job 1,11,8,3,9,0,14,20,6,3,4,1,12882,12915,12
Task 12883,Job 0,4,10,1,8,0,5,12,7,1,4,1,12883,12916,15
Task 12883,Job 1,9,6,1,12,0,10,21,11,1,2,0,12883,12916,16
Task 12884,Job 0,10,5,1,12,1,11,22,11,1,2,2,12884,12917,17
Task 12884,Job 1,15,10,4,8,0,19,23,4,4,2,2,12884,12917,8
Task 12885,Job 0,3,8,2,7,0,5,10,5,2,3,0,12885,12918,10
Task 12885,Job 1,8,4,3,9,0,11,17,6,3,4,1,12885,12918,17
Task 12886,Job 0,3,7,2,8,0,5,11,6,2,3,1,12886,12919,15
Task 12886,Job 1,8,9,2,9,1,10,17,7,2,2,2,12886,12919,13
Task 12887,Job 0,5,6,3,9,0,8,14,6,3,3,0,12887,12921,19
Task 12887,Job 1,10,8,3,11,0,13,21,8,3,3,0,12887,12921,2
Task 12888,Job 0,9,10,1,10,0,10,19,9,1,4,1,12888,12921,19
Task 12888,Job 1,14,6,2,9,0,16,23,7,2,3,0,12888,12921,18
Task 12889,Job 0,8,6,4,10,0,12,18,6,4,1,1,12889,12923,12
Task 12889,Job 1,13,9,4,11,0,17,24,7,4,3,0,12889,12923,6
Task 12890,Job 0,10,4,4,8,0,14,18,4,4,4,1,12890,12923,20
Task 12890,Job 1,15,10,2,7,0,17,22,5,2,2,2,12890,12923,6
Task 12891,Job 0,4,6,4,10,0,8,14,6,4,4,1,12891,12925,18
Task 12891,Job 1,9,10,2,9,0,11,18,7,2,1,2,12891,12925,10
Task 12892,Job 0,3,7,2,10,0,5,13,8,2,4,0,12892,12925,14
Task 12892,Job 1,8,10,1,11,0,9,19,10,1,1,0,12892,12925,15
Task 12893,Job 0,2,6,4,10,0,6,12,6,4,2,2,12893,12927,2
Task 12893,Job 1,7,7,3,6,0,10,13,3,3,1,2,12893,12927,2
Task 12894,Job 0,2,5,4,9,0,6,11,5,4,1,1,12894,12927,2
Task 12894,Job 1,7,7,2,11,0,9,18,9,2,1,2,12894,12927,8
Task 12895,Job 0,5,5,1,8,0,6,13,7,1,3,0,12895,12928,14
Task 12895,Job 1,10,10,2,11,0,12,21,9,2,4,0,12895,12928,15
Task 12896,Job 0,9,5,3,6,0,12,15,3,3,4,2,12896,12929,6
Task 12896,Job 1,14,6,4,7,1,18,21,3,4,3,1,12896,12929,20
Task 12897,Job 0,6,6,1,10,0,7,16,9,1,4,1,12897,12930,3
Task 12897,Job 1,11,4,4,10,0,15,21,6,4,3,0,12897,12930,14
Task 12898,Job 0,4,6,4,8,1,8,12,4,4,4,2,12898,12932,2
Task 12898,Job 1,9,6,1,6,0,10,15,5,1,3,1,12898,12932,11
Task 12899,Job 0,4,5,3,9,0,7,13,6,3,2,0,12899,12932,13
Task 12899,Job 1,9,7,3,7,0,12,16,4,3,3,1,12899,12932,15
Task 12900,Job 0,10,8,1,8,0,11,18,7,1,3,2,12900,12934,7
Task 12900,Job 1,15,10,2,10,0,17,25,8,2,2,0,12900,12934,9
Task 12901,Job 0,7,6,4,9,1,11,16,5,4,2,2,12901,12934,5
Task 12901,Job 1,12,5,1,10,0,13,22,9,1,4,0,12901,12934,9
Task 12902,Job 0,3,10,3,11,0,6,14,8,3,4,1,12902,12935,2
Task 12902,Job 1,8,9,2,12,0,10,20,10,2,4,1,12902,12935,9
Task 12903,Job 0,2,5,1,7,1,3,9,6,1,3,2,12903,12937,2
Task 12903,Job 1,7,4,2,11,1,9,18,9,2,2,1,12903,12937,15
Task 12904,Job 0,9,8,4,10,0,13,19,6,4,1,2,12904,12938,14
Task 12904,Job 1,14,10,1,12,0,15,26,11,1,3,0,12904,12938,13
Task 12905,Job 0,5,7,4,6,0,9,11,2,4,1,2,12905,12938,2
Task 12905,Job 1,10,8,2,9,0,12,19,7,2,1,0,12905,12938,10
Task 12906,Job 0,3,7,3,9,1,6,12,6,3,2,1,12906,12940,14
Task 12906,Job 1,8,7,2,9,1,10,17,7,2,1,2,12906,12940,5
Task 12907,Job 0,5,9,1,10,1,6,15,9,1,2,0,12907,12940,12
Task 12907,Job 1,10,7,4,8,0,14,18,4,4,1,1,12907,12940,16
Task 12908,Job 0,9,5,3,6,1,12,15,3,3,1,2,12908,12941,9
Task 12908,Job 1,14,9,4,6,0,18,20,2,4,4,2,12908,12941,9
Task 12909,Job 0,1,8,1,11,1,2,12,10,1,3,1,12909,12942,15
Task 12909,Job 1,6,7,1,10,0,7,16,9,1,1,2,12909,12942,13
Task 12910,Job 0,4,10,3,12,0,7,16,9,3,2,0,12910,12944,13
Task 12910,Job 1,9,6,3,11,0,12,20,8,3,3,2,12910,12944,4
Task 12911,Job 0,9,6,2,10,1,11,19,8,2,1,2,12911,12945,11
Task 12911,Job 1,14,7,1,6,0,15,20,5,1,3,0,12911,12945,20
Task 12912,Job 0,5,5,2,11,0,7,16,9,2,2,0,12912,12946,17
Task 12912,Job 1,10,7,3,6,1,13,16,3,3,1,0,12912,12946,2
Task 12913,Job 0,2,10,3,7,0,5,9,4,3,2,0,12913,12946,14
Task 12913,Job 1,7,5,4,11,0,11,18,7,4,1,1,12913,12946,12
Task 12914,Job 0,2,7,3,8,0,5,10,5,3,4,0,12914,12947,4
Task 12914,Job 1,7,6,2,12,0,9,19,10,2,4,2,12914,12947,17
Task 12915,Job 0,2,10,2,12,0,4,14,10,2,4,1,12915,12949,11
Task 12915,Job 1,7,7,2,6,1,9,13,4,2,4,0,12915,12949,4
Task 12916,Job 0,10,9,2,7,0,12,17,5,2,1,2,12916,12950,19
Task 12916,Job 1,15,6,2,7,0,17,22,5,2,4,1,12916,12950,7
Task 12917,Job 0,1,8,4,6,0,5,7,2,4,1,2,12917,12951,2
Task 12917,Job 1,6,5,2,9,1,8,15,7,2,3,0,12917,12951,11
Task 12918,Job 0,5,4,2,7,0,7,12,5,2,2,1,12918,12951,4
Task 12918,Job 1,10,9,3,6,0,13,16,3,3,4,2,12918,12951,8
Task 12919,Job 0,1,9,4,6,0,5,7,2,4,1,1,12919,12952,9
Task 12919,Job 1,6,9,3,7,1,9,13,4,3,3,1,12919,12952,5
Task 12920,Job 0,10,4,2,9,0,12,19,7,2,3,1,12920,12953,18
Task 12920,Job 1,15,4,1,10,0,16,25,9,1,3,2,12920,12953,17
Task 12921,Job 0,7,4,3,10,0,10,17,7,3,3,2,12921,12954,16
Task 12921,Job 1,12,7,4,7,0,16,19,3,4,3,2,12921,12954,10
Task 12922,Job 0,10,6,3,7,0,13,17,4,3,1,1,12922,12955,11
Task 12922,Job 1,15,4,4,10,0,19,25,6,4,2,1,12922,12955,12
Task 12923,Job 0,5,9,4,11,0,9,16,7,4,3,0,12923,12957,18
Task 12923,Job 1,10,9,2,11,1,12,21,9,2,2,1,12923,12957,14
Task 12924,Job 0,4,4,3,12,0,7,16,9,3,4,2,12924,12958,18
Task 12924,Job 1,9,9,1,6,0,10,15,5,1,1,2,12924,12958,3
Task 12925,Job 0,10,4,3,10,0,13,20,7,3,4,1,12925,12958,3
Task 12925,Job 1,15,9,4,9,0,19,24,5,4,3,0,12925,12958,19
Task 12926,Job 0,6,4,2,7,0,8,13,5,2,3,1,12926,12959,10
Task 12926,Job 1,11,5,4,8,0,15,19,4,4,4,2,12926,12959,9
Task 12927,Job 0,4,10,4,9,0,8,13,5,4,4,1,12927,12961,8
Task 12927,Job 1,9,9,3,11,0,12,20,8,3,4,1,12927,12961,10
Task 12928,Job 0,9,7,2,7,1,11,16,5,2,1,0,12928,12962,5
Task 12928,Job 1,14,6,3,8,0,17,22,5,3,1,2,12928,12962,14
Task 12929,Job 0,1,8,1,7,0,2,8,6,1,3,1,12929,12962,16
Task 12929,Job 1,6,4,3,12,0,9,18,9,3,4,1,12929,12962,18
Task 12930,Job 0,2,7,2,9,0,4,11,7,2,4,1,12930,12964,19
Task 12930,Job 1,7,10,1,12,1,8,19,11,1,2,2,12930,12964,8
Task 12931,Job 0,6,9,2,10,0,8,16,8,2,4,0,12931,12965,4
Task 12931,Job 1,11,7,2,9,1,13,20,7,2,3,1,12931,12965,12
Task 12932,Job 0,8,8,3,8,1,11,16,5,3,4,1,12932,12966,19
Task 12932,Job 1,13,5,2,11,1,15,24,9,2,2,2,12932,12966,3
Task 12933,Job 0,7,9,3,7,0,10,14,4,3,3,2,12933,12966,7
Task 12933,Job 1,12,8,2,10,0,14,22,8,2,3,1,12933,12966,15
Task 12934,Job 0,7,6,3,7,0,10,14,4,3,4,2,12934,12967,9
Task 12934,Job 1,12,10,1,6,0,13,18,5,1,3,2,12934,12967,14
Task 12935,Job 0,6,4,2,6,0,8,12,4,2,1,0,12935,12968,13
Task 12935,Job 1,11,10,1,7,0,12,18,6,1,3,2,12935,12968,2
Task 12936,Job 0,4,6,2,6,1,6,10,4,2,4,2,12936,12970,13
Task 12936,Job 1,9,9,2,12,0,11,21,10,2,2,2,12936,12970,6
Task 12937,Job 0,10,7,3,11,0,13,21,8,3,1,0,12937,12971,10
Task 12937,Job 1,15,4,4,7,0,19,22,3,4,2,0,12937,12971,3
Task 12938,Job 0,3,4,2,11,0,5,14,9,2,3,0,12938,12971,7
Task 12938,Job 1,8,6,3,7,0,11,15,4,3,1,1,12938,12971,13
Task 12939,Job 0,9,9,3,12,1,12,21,9,3,3,0,12939,12973,13
Task 12939,Job 1,14,7,2,7,0,16,21,5,2,2,0,12939,12973,14
Task 12940,Job 0,6,6,4,10,0,10,16,6,4,3,2,12940,12973,19
Task 12940,Job 1,11,6,2,12,0,13,23,10,2,1,0,12940,12973,5
Task 12941,Job 0,7,4,3,7,0,10,14,4,3,3,2,12941,12974,11
Task 12941,Job 1,12,7,2,11,1,14,23,9,2,2,1,12941,12974,2
Task 12942,Job 0,2,6,1,12,0,3,14,11,1,4,0,12942,12975,20
Task 12942,Job 1,7,4,4,8,0,11,15,4,4,3,2,12942,12975,2
Task 12943,Job 0,4,8,2,7,0,6,11,5,2,4,0,12943,12976,20
Task 12943,Job 1,9,10,1,10,0,10,19,9,1,2,2,12943,12976,7
Task 12944,Job 0,4,9,1,9,1,5,13,8,1,1,1,12944,12978,13
Task 12944,Job 1,9,10,3,6,0,12,15,3,3,3,0,12944,12978,4
Task 12945,Job 0,7,8,4,7,0,11,14,3,4,3,1,12945,12978,2
Task 12945,Job 1,12,9,3,12,1,15,24,9,3,1,0,12945,12978,16
Task 12946,Job 0,7,9,4,6,1,11,13,2,4,4,1,12946,12980,15
Task 12946,Job 1,12,9,3,6,1,15,18,3,3,2,2,12946,12980,10
Task 12947,Job 0,9,7,2,10,0,11,19,8,2,3,2,12947,12981,4
Task 12947,Job 1,14,8,2,10,0,16,24,8,2,3,1,12947,12981,4
Task 12948,Job 0,6,5,1,10,1,7,16,9,1,3,2,12948,12982,3
Task 12948,Job 1,11,4,1,12,0,12,23,11,1,2,0,12948,12982,19
Task 12949,Job 0,2,6,3,10,1,5,12,7,3,2,1,12949,12982,10
Task 12949,Job 1,7,6,1,10,0,8,17,9,1,2,0,12949,12982,9
Task 12950,Job 0,1,5,4,10,1,5,11,6,4,2,2,12950,12984,8
Task 12950,Job 1,6,7,3,8,0,9,14,5,3,4,2,12950,12984,10
Task 12951,Job 0,9,6,3,9,0,12,18,6,3,2,0,12951,12985,14
Task 12951,Job 1,14,7,4,6,0,18,20,2,4,1,0,12951,12985,18
Task 12952,Job 0,2,9,1,12,1,3,14,11,1,2,2,12952,12985,20
Task 12952,Job 1,7,6,3,6,1,10,13,3,3,4,2,12952,12985,10
Task 12953,Job 0,3,4,3,11,0,6,14,8,3,1,1,12953,12987,16
Task 12953,Job 1,8,5,3,9,0,11,17,6,3,4,1,12953,12987,8
Task 12954,Job 0,1,5,4,9,1,5,10,5,4,3,2,12954,12987,12
Task 12954,Job 1,6,5,2,11,0,8,17,9,2,2,2,12954,12987,5
Task 12955,Job 0,10,6,2,11,1,12,21,9,2,4,2,12955,12989,17
Task 12955,Job 1,15,10,1,12,1,16,27,11,1,2,1,12955,12989,9
Task 12956,Job 0,2,10,1,6,1,3,8,5,1,3,2,12956,12990,5
Task 12956,Job 1,7,4,3,12,1,10,19,9,3,1,2,12956,12990,2
Task 12957,Job 0,6,4,2,6,1,8,12,4,2,4,0,12957,12991,10
Task 12957,Job 1,11,8,1,11,0,12,22,10,1,4,1,12957,12991,17
Task 12958,Job 0,10,4,1,11,0,11,21,10,1,2,1,12958,12991,19
Task 12958,Job 1,15,6,1,6,0,16,21,5,1,4,2,12958,12991,13
Task 12959,Job 0,9,4,2,8,0,11,17,6,2,4,1,12959,12993,18
Task 12959,Job 1,14,10,4,7,0,18,21,3,4,1,0,12959,12993,19
Task 12960,Job 0,10,10,4,10,0,14,20,6,4,4,2,12960,12994,18
Task 12960,Job 1,15,7,4,9,1,19,24,5,4,4,0,12960,12994,15
Task 12961,Job 0,9,5,1,7,0,10,16,6,1,1,1,12961,12994,7
Task 12961,Job 1,14,5,4,11,0,18,25,7,4,2,2,12961,12994,11
Task 12962,Job 0,3,10,3,8,0,6,11,5,3,4,0,12962,12995,7
Task 12962,Job 1,8,6,3,8,0,11,16,5,3,2,2,12962,12995,16
Task 12963,Job 0,7,7,2,10,1,9,17,8,2,4,1,12963,12997,14
Task 12963,Job 1,12,7,1,12,0,13,24,11,1,3,1,12963,12997,7
Task 12964,Job 0,9,10,2,12,0,11,21,10,2,2,0,12964,12998,4
Task 12964,Job 1,14,8,1,7,1,15,21,6,1,1,0,12964,12998,16
Task 12965,Job 0,4,9,1,8,0,5,12,7,1,3,2,12965,12998,8
Task 12965,Job 1,9,5,1,6,0,10,15,5,1,4,1,12965,12998,3
Task 12966,Job 0,6,8,3,12,0,9,18,9,3,4,0,12966,12999,3
Task 12966,Job 1,11,7,2,7,1,13,18,5,2,3,0,12966,12999,18
Task 12967,Job 0,10,5,1,6,1,11,16,5,1,4,1,12967,13001,19
Task 12967,Job 1,15,10,3,10,0,18,25,7,3,3,0,12967,13001,7
Task 12968,Job 0,1,5,1,10,0,2,11,9,1,4,1,12968,13001,19
Task 12968,Job 1,6,4,3,10,0,9,16,7,3,2,2,12968,13001,4
Task 12969,Job 0,6,9,2,10,1,8,16,8,2,4,0,12969,13003,9
Task 12969,Job 1,11,6,3,11,0,14,22,8,3,2,1,12969,13003,9
Task 12970,Job 0,1,8,1,7,0,2,8,6,1,2,1,12970,13003,14
Task 12970,Job 1,6,6,2,8,0,8,14,6,2,2,2,12970,13003,13
Task 12971,Job 0,1,7,4,9,0,5,10,5,4,1,1,12971,13004,3
Task 12971,Job 1,6,10,3,11,1,9,17,8,3,1,1,12971,13004,13
Task 12972,Job 0,5,5,2,10,0,7,15,8,2,2,0,12972,13005,5
Task 12972,Job 1,10,5,1,8,0,11,18,7,1,1,2,12972,13005,4
Task 12973,Job 0,8,5,1,12,0,9,20,11,1,3,0,12973,13006,19
Task 12973,Job 1,13,10,1,12,0,14,25,11,1,2,0,12973,13006,9
Task 12974,Job 0,5,4,3,9,1,8,14,6,3,3,1,12974,13008,14
Task 12974,Job 1,10,4,2,7,1,12,17,5,2,3,1,12974,13008,10
Task 12975,Job 0,3,8,3,7,0,6,10,4,3,2,1,12975,13009,10
Task 12975,Job 1,8,5,4,10,0,12,18,6,4,3,2,12975,13009,11
Task 12976,Job 0,8,10,3,12,0,11,20,9,3,1,0,12976,13009,3
Task 12976,Job 1,13,6,1,6,0,14,19,5,1,3,1,12976,13009,20
Task 12977,Job 0,10,8,3,10,0,13,20,7,3,4,2,12977,13011,20
Task 12977,Job 1,15,8,1,9,0,16,24,8,1,1,1,12977,13011,3
Task 12978,Job 0,5,9,4,11,0,9,16,7,4,4,2,12978,13012,7
Task 12978,Job 1,10,8,2,9,0,12,19,7,2,4,1,12978,13012,12
Task 12979,Job 0,9,5,2,10,0,11,19,8,2,3,0,12979,13013,9
Task 12979,Job 1,14,7,2,10,1,16,24,8,2,3,0,12979,13013,14
Task 12980,Job 0,4,7,2,7,1,6,11,5,2,1,1,12980,13013,10
Task 12980,Job 1,9,6,3,9,0,12,18,6,3,3,1,12980,13013,12
Task 12981,Job 0,2,5,1,9,0,3,11,8,1,4,0,12981,13015,18
Task 12981,Job 1,7,8,4,12,1,11,19,8,4,4,2,12981,13015,20
Task 12982,Job 0,3,8,2,8,0,5,11,6,2,1,0,12982,13016,12
Task 12982,Job 1,8,7,3,7,0,11,15,4,3,3,2,12982,13016,11
Task 12983,Job 0,3,8,2,10,0,5,13,8,2,3,2,12983,13016,11
Task 12983,Job 1,8,6,4,6,0,12,14,2,4,4,1,12983,13016,19
Task 12984,Job 0,10,8,1,7,1,11,17,6,1,1,1,12984,13018,4
Task 12984,Job 1,15,10,3,10,1,18,25,7,3,4,0,12984,13018,13
Task 12985,Job 0,8,7,3,11,1,11,19,8,3,3,1,12985,13019,9
Task 12985,Job 1,13,10,1,10,1,14,23,9,1,1,2,12985,13019,10
Task 12986,Job 0,8,4,4,9,0,12,17,5,4,3,0,12986,13019,15
Task 12986,Job 1,13,7,4,9,0,17,22,5,4,2,2,12986,13019,16
Task 12987,Job 0,3,9,2,9,0,5,12,7,2,4,0,12987,13020,10
Task 12987,Job 1,8,5,4,6,0,12,14,2,4,4,0,12987,13020,11
Task 12988,Job 0,2,5,2,9,0,4,11,7,2,3,2,12988,13021,5
Task 12988,Job 1,7,8,3,9,1,10,16,6,3,1,1,12988,13021,10
Task 12989,Job 0,3,10,3,11,1,6,14,8,3,3,0,12989,13022,13
Task 12989,Job 1,8,4,4,6,0,12,14,2,4,3,0,12989,13022,14
Task 12990,Job 0,7,10,2,12,0,9,19,10,2,2,0,12990,13023,8
Task 12990,Job 1,12,4,1,8,1,13,20,7,1,4,0,12990,13023,14
Task 12991,Job 0,4,9,2,9,1,6,13,7,2,3,2,12991,13025,10
Task 12991,Job 1,9,10,1,10,0,10,19,9,1,4,1,12991,13025,6
Task 12992,Job 0,1,5,4,11,0,5,12,7,4,4,2,12992,13025,7
Task 12992,Job 1,6,10,3,7,0,9,13,4,3,1,0,12992,13025,2
Task 12993,Job 0,5,5,4,11,1,9,16,7,4,3,1,12993,13026,5
Task 12993,Job 1,10,5,4,7,1,14,17,3,4,4,2,12993,13026,5
Task 12994,Job 0,7,5,3,11,0,10,18,8,3,3,2,12994,13028,9
Task 12994,Job 1,12,8,3,12,0,15,24,9,3,2,0,12994,13028,11
Task 12995,Job 0,2,7,1,11,0,3,13,10,1,1,0,12995,13028,8
Task 12995,Job 1,7,6,1,9,0,8,16,8,1,3,1,12995,13028,3
Task 12996,Job 0,8,5,3,6,0,11,14,3,3,2,2,12996,13029,2
Task 12996,Job 1,13,10,3,9,0,16,22,6,3,3,2,12996,13029,12
Task 12997,Job 0,3,5,2,9,0,5,12,7,2,3,0,12997,13031,12
Task 12997,Job 1,8,7,3,6,0,11,14,3,3,4,1,12997,13031,6
Task 12998,Job 0,9,10,2,8,0,11,17,6,2,1,1,12998,13031,15
Task 12998,Job 1,14,9,3,6,1,17,20,3,3,4,2,12998,13031,19
Task 12999,Job 0,10,6,1,7,1,11,17,6,1,3,1,12999,13033,19
Task 12999,Job 1,15,9,1,9,0,16,24,8,1,4,0,12999,13033,3
Task 13000,Job 0,7,5,4,10,0,11,17,6,4,1,0,13000,13033,17
Task 13000,Job 1,12,4,2,12,0,14,24,10,2,2,2,13000,13033,7
Task 13001,Job 0,8,8,4,7,1,12,15,3,4,1,0,13001,13034,5
Task 13001,Job 1,13,10,3,12,0,16,25,9,3,4,2,13001,13034,14
Task 13002,Job 0,7,10,2,7,0,9,14,5,2,3,0,13002,13036,3
Task 13002,Job 1,12,8,4,7,0,16,19,3,4,1,0,13002,13036,8
Task 13003,Job 0,3,4,4,8,0,7,11,4,4,4,1,13003,13037,4
Task 13003,Job 1,8,8,3,8,1,11,16,5,3,4,2,13003,13037,5
Task 13004,Job 0,2,6,4,11,0,6,13,7,4,1,0,13004,13038,4
Task 13004,Job 1,7,10,4,6,0,11,13,2,4,3,2,13004,13038,10
Task 13005,Job 0,2,8,1,9,0,3,11,8,1,4,2,13005,13039,13
Task 13005,Job 1,7,6,2,9,0,9,16,7,2,3,1,13005,13039,10
Task 13006,Job 0,3,5,3,11,1,6,14,8,3,3,2,13006,13039,9
Task 13006,Job 1,8,6,4,12,0,12,20,8,4,4,2,13006,13039,19
Task 13007,Job 0,7,9,2,9,0,9,16,7,2,3,2,13007,13040,9
Task 13007,Job 1,12,9,3,12,0,15,24,9,3,2,0,13007,13040,4
Task 13008,Job 0,8,4,3,6,0,11,14,3,3,3,2,13008,13042,13
Task 13008,Job 1,13,4,2,8,0,15,21,6,2,2,2,13008,13042,9
Task 13009,Job 0,3,10,2,7,0,5,10,5,2,3,2,13009,13043,17
Task 13009,Job 1,8,4,1,11,0,9,19,10,1,1,2,13009,13043,5
Task 13010,Job 0,9,7,2,8,1,11,17,6,2,3,1,13010,13044,8
Task 13010,Job 1,14,10,4,7,0,18,21,3,4,3,1,13010,13044,4
Task 13011,Job 0,1,9,4,11,0,5,12,7,4,3,2,13011,13044,15
Task 13011,Job 1,6,10,2,11,0,8,17,9,2,3,0,13011,13044,6
Task 13012,Job 0,4,8,2,8,0,6,12,6,2,1,2,13012,13046,11
Task 13012,Job 1,9,9,1,11,1,10,20,10,1,3,2,13012,13046,11
Task 13013,Job 0,2,10,4,6,1,6,8,2,4,4,2,13013,13046,19
Task 13013,Job 1,7,8,2,11,0,9,18,9,2,2,2,13013,13046,17
Task 13014,Job 0,6,6,4,8,0,10,14,4,4,1,0,13014,13048,8
Task 13014,Job 1,11,8,3,10,0,14,21,7,3,2,2,13014,13048,12
Task 13015,Job 0,6,9,1,12,0,7,18,11,1,2,2,13015,13049,12
Task 13015,Job 1,11,9,2,7,0,13,18,5,2,4,1,13015,13049,4
Task 13016,Job 0,10,9,1,6,0,11,16,5,1,1,2,13016,13050,11
Task 13016,Job 1,15,7,2,6,0,17,21,4,2,1,2,13016,13050,17
Task 13017,Job 0,2,10,4,6,1,6,8,2,4,3,0,13017,13051,8
Task 13017,Job 1,7,9,1,9,1,8,16,8,1,1,2,13017,13051,8
Task 13018,Job 0,5,8,1,6,0,6,11,5,1,4,0,13018,13051,5
Task 13018,Job 1,10,5,1,6,0,11,16,5,1,4,1,13018,13051,17
Task 13019,Job 0,7,5,4,11,0,11,18,7,4,3,0,13019,13052,8
Task 13019,Job 1,12,4,3,11,0,15,23,8,3,1,0,13019,13052,5
Task 13020,Job 0,10,4,4,12,1,14,22,8,4,1,0,13020,13053,2
Task 13020,Job 1,15,7,4,7,0,19,22,3,4,3,0,13020,13053,12
Task 13021,Job 0,9,6,4,11,0,13,20,7,4,4,2,13021,13055,10
Task 13021,Job 1,14,6,3,8,0,17,22,5,3,4,1,13021,13055,19
Task 13022,Job 0,5,6,3,12,1,8,17,9,3,4,1,13022,13056,15
Task 13022,Job 1,10,9,1,11,1,11,21,10,1,2,2,13022,13056,2
Task 13023,Job 0,9,9,2,11,0,11,20,9,2,3,2,13023,13057,8
Task 13023,Job 1,14,8,1,9,1,15,23,8,1,1,2,13023,13057,7
Task 13024,Job 0,10,5,3,8,0,13,18,5,3,4,1,13024,13058,19
Task 13024,Job 1,15,8,3,9,1,18,24,6,3,4,0,13024,13058,20
Task 13025,Job 0,2,6,4,8,0,6,10,4,4,2,1,13025,13059,13
Task 13025,Job 1,7,5,3,7,0,10,14,4,3,2,1,13025,13059,13
Task 13026,Job 0,1,9,4,6,0,5,7,2,4,2,0,13026,13060,18
Task 13026,Job 1,6,9,1,11,0,7,17,10,1,2,1,13026,13060,7
Task 13027,Job 0,4,6,4,11,0,8,15,7,4,4,2,13027,13060,5
Task 13027,Job 1,9,9,3,8,0,12,17,5,3,2,0,13027,13060,2
Task 13028,Job 0,5,10,2,7,1,7,12,5,2,2,2,13028,13062,18
Task 13028,Job 1,10,4,4,8,0,14,18,4,4,1,0,13028,13062,19
Task 13029,Job 0,7,5,1,6,0,8,13,5,1,2,0,13029,13062,17
Task 13029,Job 1,12,10,1,7,0,13,19,6,1,4,1,13029,13062,2
Task 13030,Job 0,1,10,2,8,0,3,9,6,2,3,0,13030,13064,10
Task 13030,Job 1,6,7,4,10,0,10,16,6,4,3,0,13030,13064,16
Task 13031,Job 0,8,8,1,7,0,9,15,6,1,1,1,13031,13064,11
Task 13031,Job 1,13,5,1,10,0,14,23,9,1,3,0,13031,13064,12
Task 13032,Job 0,5,7,3,11,0,8,16,8,3,2,0,13032,13065,8
Task 13032,Job 1,10,8,4,12,0,14,22,8,4,4,2,13032,13065,2
Task 13033,Job 0,2,6,4,9,0,6,11,5,4,3,2,13033,13066,17
Task 13033,Job 1,7,9,2,8,0,9,15,6,2,1,0,13033,13066,4
Task 13034,Job 0,2,7,2,10,0,4,12,8,2,1,0,13034,13068,4
Task 13034,Job 1,7,10,1,8,1,8,15,7,1,1,1,13034,13068,13
Task 13035,Job 0,10,6,2,10,1,12,20,8,2,1,0,13035,13068,10
Task 13035,Job 1,15,9,2,10,0,17,25,8,2,1,2,13035,13068,16
Task 13036,Job 0,10,9,4,9,0,14,19,5,4,1,2,13036,13070,3
Task 13036,Job 1,15,9,4,6,0,19,21,2,4,1,0,13036,13070,11
Task 13037,Job 0,10,10,3,10,0,13,20,7,3,2,1,13037,13070,15
Task 13037,Job 1,15,6,3,6,0,18,21,3,3,3,1,13037,13070,5
Task 13038,Job 0,8,9,4,9,1,12,17,5,4,1,0,13038,13071,12
Task 13038,Job 1,13,6,3,9,0,16,22,6,3,2,1,13038,13071,4
Task 13039,Job 0,4,9,4,9,0,8,13,5,4,3,2,13039,13072,16
Task 13039,Job 1,9,4,4,7,0,13,16,3,4,3,2,13039,13072,16
Task 13040,Job 0,9,6,4,7,1,13,16,3,4,3,1,13040,13073,4
Task 13040,Job 1,14,7,2,6,0,16,20,4,2,2,0,13040,13073,12
Task 13041,Job 0,1,4,3,9,0,4,10,6,3,2,0,13041,13075,20
Task 13041,Job 1,6,4,3,9,0,9,15,6,3,3,2,13041,13075,13
Task 13042,Job 0,5,8,2,8,0,7,13,6,2,1,2,13042,13076,12
Task 13042,Job 1,10,7,2,9,1,12,19,7,2,2,1,13042,13076,12
Task 13043,Job 0,9,5,1,6,0,10,15,5,1,1,1,13043,13077,9
Task 13043,Job 1,14,9,1,10,0,15,24,9,1,4,1,13043,13077,13
Task 13044,Job 0,4,7,4,8,0,8,12,4,4,1,1,13044,13078,20
Task 13044,Job 1,9,6,3,12,0,12,21,9,3,3,0,13044,13078,14
Task 13045,Job 0,6,7,1,11,1,7,17,10,1,2,1,13045,13078,6
Task 13045,Job 1,11,10,3,6,1,14,17,3,3,2,0,13045,13078,3
Task 13046,Job 0,4,8,2,10,0,6,14,8,2,2,1,13046,13080,2
Task 13046,Job 1,9,10,2,12,0,11,21,10,2,3,1,13046,13080,16
Task 13047,Job 0,9,4,4,11,1,13,20,7,4,3,2,13047,13081,15
Task 13047,Job 1,14,7,4,7,1,18,21,3,4,2,0,13047,13081,12
Task 13048,Job 0,2,4,2,7,0,4,9,5,2,4,1,13048,13081,9
Task 13048,Job 1,7,10,4,10,0,11,17,6,4,3,2,13048,13081,14
Task 13049,Job 0,1,8,3,10,0,4,11,7,3,3,2,13049,13083,7
Task 13049,Job 1,6,8,2,7,0,8,13,5,2,2,1,13049,13083,19
Task 13050,Job 0,8,9,2,8,1,10,16,6,2,4,1,13050,13084,3
Task 13050,Job 1,13,8,2,7,0,15,20,5,2,2,0,13050,13084,7
Task 13051,Job 0,9,9,3,12,1,12,21,9,3,4,0,13051,13084,3
Task 13051,Job 1,14,9,1,7,0,15,21,6,1,3,0,13051,13084,10
Task 13052,Job 0,9,5,4,8,0,13,17,4,4,4,2,13052,13085,3
Task 13052,Job 1,14,5,4,7,1,18,21,3,4,4,2,13052,13085,13
Task 13053,Job 0,1,7,2,11,0,3,12,9,2,1,0,13053,13086,14
Task 13053,Job 1,6,7,3,10,0,9,16,7,3,1,2,13053,13086,15
Task 13054,Job 0,10,7,1,7,0,11,17,6,1,1,1,13054,13088,16
Task 13054,Job 1,15,9,4,9,0,19,24,5,4,3,1,13054,13088,6
Task 13055,Job 0,8,4,1,11,1,9,19,10,1,2,2,13055,13089,5
Task 13055,Job 1,13,8,2,10,0,15,23,8,2,1,2,13055,13089,20
Task 13056,Job 0,3,8,4,11,1,7,14,7,4,1,1,13056,13090,6
Task 13056,Job 1,8,8,1,12,0,9,20,11,1,1,0,13056,13090,19
Task 13057,Job 0,4,9,3,7,0,7,11,4,3,2,2,13057,13090,5
Task 13057,Job 1,9,9,3,7,0,12,16,4,3,4,0,13057,13090,18
Task 13058,Job 0,10,10,4,10,0,14,20,6,4,1,2,13058,13091,2
Task 13058,Job 1,15,9,4,11,0,19,26,7,4,1,0,13058,13091,18
Task 13059,Job 0,2,5,3,8,0,5,10,5,3,1,2,13059,13093,15
Task 13059,Job 1,7,8,3,12,0,10,19,9,3,2,2,13059,13093,11
Task 13060,Job 0,8,5,2,8,0,10,16,6,2,1,1,13060,13094,13
Task 13060,Job 1,13,9,4,12,0,17,25,8,4,4,0,13060,13094,3
Task 13061,Job 0,9,9,1,6,0,10,15,5,1,1,2,13061,13094,10
Task 13061,Job 1,14,7,2,10,0,16,24,8,2,4,1,13061,13094,13
Task 13062,Job 0,3,5,1,8,1,4,11,7,1,4,1,13062,13096,8
Task 13062,Job 1,8,7,2,9,0,10,17,7,2,2,0,13062,13096,17
Task 13063,Job 0,8,6,4,6,1,12,14,2,4,4,0,13063,13097,6
Task 13063,Job 1,13,7,4,11,0,17,24,7,4,1,0,13063,13097,9
Task 13064,Job 0,8,9,4,9,0,12,17,5,4,3,1,13064,13098,13
Task 13064,Job 1,13,9,2,10,0,15,23,8,2,2,1,13064,13098,20
Task 13065,Job 0,5,10,4,9,1,9,14,5,4,3,0,13065,13098,5
Task 13065,Job 1,10,6,1,9,0,11,19,8,1,4,2,13065,13098,15
Task 13066,Job 0,8,5,3,6,0,11,14,3,3,3,1,13066,13099,16
Task 13066,Job 1,13,6,1,7,1,14,20,6,1,4,1,13066,13099,14
Task 13067,Job 0,5,5,4,11,0,9,16,7,4,2,0,13067,13100,8
Task 13067,Job 1,10,10,2,12,1,12,22,10,2,3,0,13067,13100,4
Task 13068,Job 0,10,9,4,8,1,14,18,4,4,1,2,13068,13101,19
Task 13068,Job 1,15,9,3,6,0,18,21,3,3,1,2,13068,13101,5
Task 13069,Job 0,3,5,4,8,0,7,11,4,4,1,2,13069,13102,12
Task 13069,Job 1,8,8,4,12,0,12,20,8,4,3,2,13069,13102,8
Task 13070,Job 0,8,5,1,8,0,9,16,7,1,1,1,13070,13103,14
Task 13070,Job 1,13,7,3,6,1,16,19,3,3,1,2,13070,13103,7
Task 13071,Job 0,8,5,4,10,0,12,18,6,4,4,2,13071,13104,18
Task 13071,Job 1,13,8,1,6,0,14,19,5,1,2,1,13071,13104,18
Task 13072,Job 0,10,6,4,12,0,14,22,8,4,1,0,13072,13106,7
Task 13072,Job 1,15,5,1,10,0,16,25,9,1,3,1,13072,13106,9
Task 13073,Job 0,2,4,3,10,0,5,12,7,3,2,1,13073,13106,13
Task 13073,Job 1,7,4,3,11,0,10,18,8,3,2,0,13073,13106,19
Task 13074,Job 0,10,10,4,12,1,14,22,8,4,3,0,13074,13107,4
Task 13074,Job 1,15,6,4,8,0,19,23,4,4,1,1,13074,13107,10
Task 13075,Job 0,7,7,4,7,0,11,14,3,4,2,1,13075,13108,16
Task 13075,Job 1,12,5,1,12,0,13,24,11,1,3,2,13075,13108,16
Task 13076,Job 0,6,9,2,12,0,8,18,10,2,3,1,13076,13110,9
Task 13076,Job 1,11,5,2,9,0,13,20,7,2,1,0,13076,13110,12
Task 13077,Job 0,3,10,1,8,0,4,11,7,1,3,2,13077,13110,5
Task 13077,Job 1,8,8,4,12,0,12,20,8,4,2,0,13077,13110,14
Task 13078,Job 0,3,6,1,10,0,4,13,9,1,4,1,13078,13112,4
Task 13078,Job 1,8,8,3,10,1,11,18,7,3,4,1,13078,13112,20
Task 13079,Job 0,7,9,3,7,0,10,14,4,3,2,2,13079,13112,11
Task 13079,Job 1,12,8,1,8,0,13,20,7,1,4,2,13079,13112,15
Task 13080,Job 0,10,8,4,11,1,14,21,7,4,3,0,13080,13113,14
Task 13080,Job 1,15,8,1,12,0,16,27,11,1,2,1,13080,13113,7
Task 13081,Job 0,7,7,3,10,0,10,17,7,3,3,0,13081,13114,4
Task 13081,Job 1,12,8,2,12,0,14,24,10,2,1,0,13081,13114,7
Task 13082,Job 0,5,8,2,9,0,7,14,7,2,3,1,13082,13116,3
Task 13082,Job 1,10,6,1,10,0,11,20,9,1,3,2,13082,13116,9
Task 13083,Job 0,2,4,4,12,0,6,14,8,4,2,1,13083,13116,7
Task 13083,Job 1,7,7,1,6,1,8,13,5,1,1,2,13083,13116,10
Task 13084,Job 0,10,9,3,11,0,13,21,8,3,2,1,13084,13117,3
Task 13084,Job 1,15,8,1,8,0,16,23,7,1,3,1,13084,13117,17
Task 13085,Job 0,4,10,3,10,1,7,14,7,3,4,1,13085,13119,18
Task 13085,Job 1,9,8,4,11,0,13,20,7,4,4,1,13085,13119,20
Task 13086,Job 0,1,10,3,9,0,4,10,6,3,3,0,13086,13120,5
Task 13086,Job 1,6,4,1,9,0,7,15,8,1,1,1,13086,13120,9
Task 13087,Job 0,6,4,3,11,0,9,17,8,3,2,2,13087,13120,2
Task 13087,Job 1,11,10,1,8,0,12,19,7,1,1,2,13087,13120,9
Task 13088,Job 0,4,9,3,7,1,7,11,4,3,1,2,13088,13121,20
Task 13088,Job 1,9,4,4,6,0,13,15,2,4,3,1,13088,13121,12
Task 13089,Job 0,5,10,3,12,0,8,17,9,3,1,1,13089,13123,13
Task 13089,Job 1,10,10,4,6,1,14,16,2,4,1,2,13089,13123,13
Task 13090,Job 0,3,5,1,11,0,4,14,10,1,2,2,13090,13123,5
Task 13090,Job 1,8,4,2,8,0,10,16,6,2,4,2,13090,13123,11
Task 13091,Job 0,5,8,3,10,1,8,15,7,3,1,2,13091,13125,20
Task 13091,Job 1,10,6,1,6,1,11,16,5,1,1,0,13091,13125,8
Task 13092,Job 0,7,7,4,11,0,11,18,7,4,3,1,13092,13125,13
Task 13092,Job 1,12,6,1,6,0,13,18,5,1,3,2,13092,13125,3
Task 13093,Job 0,9,7,3,9,0,12,18,6,3,1,0,13093,13126,16
Task 13093,Job 1,14,6,2,9,0,16,23,7,2,1,0,13093,13126,18
Task 13094,Job 0,9,4,4,6,1,13,15,2,4,2,1,13094,13127,14
Task 13094,Job 1,14,8,3,8,0,17,22,5,3,2,1,13094,13127,6
Task 13095,Job 0,4,8,4,9,0,8,13,5,4,1,2,13095,13129,6
Task 13095,Job 1,9,6,4,11,0,13,20,7,4,2,1,13095,13129,2
Task 13096,Job 0,8,4,4,7,0,12,15,3,4,4,0,13096,13130,6
Task 13096,Job 1,13,10,1,12,0,14,25,11,1,4,2,13096,13130,2
Task 13097,Job 0,5,5,2,7,0,7,12,5,2,4,2,13097,13131,13
Task 13097,Job 1,10,8,1,7,1,11,17,6,1,1,0,13097,13131,20
Task 13098,Job 0,10,9,4,6,0,14,16,2,4,4,1,13098,13131,20
Task 13098,Job 1,15,5,3,6,1,18,21,3,3,4,2,13098,13131,2
Task 13099,Job 0,1,5,4,8,1,5,9,4,4,2,2,13099,13132,20
Task 13099,Job 1,6,5,3,12,0,9,18,9,3,2,0,13099,13132,8
Task 13100,Job 0,7,10,1,12,0,8,19,11,1,1,2,13100,13133,16
Task 13100,Job 1,12,5,4,8,0,16,20,4,4,3,1,13100,13133,11
Task 13101,Job 0,7,7,1,10,0,8,17,9,1,1,0,13101,13134,8
Task 13101,Job 1,12,7,2,6,1,14,18,4,2,1,0,13101,13134,16
Task 13102,Job 0,4,4,4,12,1,8,16,8,4,1,2,13102,13136,8
Task 13102,Job 1,9,10,4,10,0,13,19,6,4,3,2,13102,13136,9
Task 13103,Job 0,5,8,3,7,0,8,12,4,3,2,0,13103,13137,3
Task 13103,Job 1,10,9,3,12,0,13,22,9,3,2,0,13103,13137,20
Task 13104,Job 0,2,10,2,9,0,4,11,7,2,4,0,13104,13137,16
Task 13104,Job 1,7,7,2,7,0,9,14,5,2,3,0,13104,13137,14
Task 13105,Job 0,10,4,2,12,0,12,22,10,2,2,1,13105,13139,2
Task 13105,Job 1,15,8,3,7,0,18,22,4,3,4,1,13105,13139,20
Task 13106,Job 0,1,9,4,11,0,5,12,7,4,3,2,13106,13140,18
Task 13106,Job 1,6,5,4,12,0,10,18,8,4,4,0,13106,13140,9
Task 13107,Job 0,4,8,3,12,1,7,16,9,3,2,1,13107,13141,19
Task 13107,Job 1,9,4,2,10,0,11,19,8,2,3,0,13107,13141,12
Task 13108,Job 0,8,4,2,12,0,10,20,10,2,2,1,13108,13142,13
Task 13108,Job 1,13,9,2,9,1,15,22,7,2,3,2,13108,13142,4
Task 13109,Job 0,7,9,2,9,0,9,16,7,2,2,2,13109,13142,3
Task 13109,Job 1,12,9,3,12,0,15,24,9,3,1,1,13109,13142,19
Task 13110,Job 0,9,10,4,11,1,13,20,7,4,3,0,13110,13143,15
Task 13110,Job 1,14,5,3,11,0,17,25,8,3,2,0,13110,13143,14
Task 13111,Job 0,8,4,4,11,0,12,19,7,4,2,1,13111,13145,7
Task 13111,Job 1,13,4,1,9,0,14,22,8,1,4,2,13111,13145,11
Task 13112,Job 0,2,4,2,7,0,4,9,5,2,1,0,13112,13146,18
Task 13112,Job 1,7,9,4,10,0,11,17,6,4,3,1,13112,13146,9
Task 13113,Job 0,2,4,2,7,0,4,9,5,2,3,2,13113,13146,16
Task 13113,Job 1,7,8,4,11,0,11,18,7,4,1,2,13113,13146,19
Task 13114,Job 0,10,10,3,8,0,13,18,5,3,4,2,13114,13147,5
Task 13114,Job 1,15,9,4,6,0,19,21,2,4,4,1,13114,13147,3
Task 13115,Job 0,5,6,2,10,0,7,15,8,2,1,2,13115,13149,13
Task 13115,Job 1,10,10,3,12,0,13,22,9,3,1,1,13115,13149,14
Task 13116,Job 0,4,4,1,10,0,5,14,9,1,1,1,13116,13150,17
Task 13116,Job 1,9,5,1,11,0,10,20,10,1,4,1,13116,13150,18
Task 13117,Job 0,9,9,1,9,0,10,18,8,1,1,1,13117,13150,15
Task 13117,Job 1,14,10,3,6,0,17,20,3,3,2,1,13117,13150,4
Task 13118,Job 0,2,4,1,11,0,3,13,10,1,3,0,13118,13152,8
Task 13118,Job 1,7,7,3,12,0,10,19,9,3,1,2,13118,13152,13
Task 13119,Job 0,7,8,2,6,0,9,13,4,2,4,2,13119,13152,11
Task 13119,Job 1,12,6,2,6,0,14,18,4,2,3,2,13119,13152,10
Task 13120,Job 0,2,7,3,10,0,5,12,7,3,2,1,13120,13154,12
Task 13120,Job 1,7,4,4,8,0,11,15,4,4,2,1,13120,13154,18
Task 13121,Job 0,8,7,1,11,1,9,19,10,1,3,0,13121,13155,15
Task 13121,Job 1,13,7,1,12,1,14,25,11,1,1,2,13121,13155,10
Task 13122,Job 0,8,10,1,9,1,9,17,8,1,3,2,13122,13155,8
Task 13122,Job 1,13,6,2,7,0,15,20,5,2,4,0,13122,13155,11
Task 13123,Job 0,6,4,3,10,0,9,16,7,3,2,0,13123,13157,8
Task 13123,Job 1,11,7,2,8,1,13,19,6,2,3,0,13123,13157,6
Task 13124,Job 0,5,6,3,11,0,8,16,8,3,2,1,13124,13157,12
Task 13124,Job 1,10,8,1,12,0,11,22,11,1,4,2,13124,13157,18
Task 13125,Job 0,10,7,4,8,0,14,18,4,4,3,1,13125,13158,7
Task 13125,Job 1,15,4,3,7,0,18,22,4,3,4,2,13125,13158,20
Task 13126,Job 0,6,7,3,12,0,9,18,9,3,3,2,13126,13159,2
Task 13126,Job 1,11,7,1,7,1,12,18,6,1,4,0,13126,13159,16
Task 13127,Job 0,7,10,1,10,0,8,17,9,1,4,0,13127,13160,3
Task 13127,Job 1,12,9,4,11,0,16,23,7,4,2,2,13127,13160,20
Task 13128,Job 0,1,5,2,9,0,3,10,7,2,3,1,13128,13161,4
Task 13128,Job 1,6,4,2,9,1,8,15,7,2,4,1,13128,13161,15
Task 13129,Job 0,7,7,2,9,0,9,16,7,2,3,1,13129,13162,7
Task 13129,Job 1,12,7,2,8,0,14,20,6,2,3,0,13129,13162,18
Task 13130,Job 0,7,6,1,9,1,8,16,8,1,2,1,13130,13164,12
Task 13130,Job 1,12,9,1,10,0,13,22,9,1,1,0,13130,13164,19
Task 13131,Job 0,3,9,2,10,0,5,13,8,2,4,1,13131,13164,8
Task 13131,Job 1,8,6,4,11,0,12,19,7,4,1,1,13131,13164,13
Task 13132,Job 0,1,5,3,6,0,4,7,3,3,4,0,13132,13166,9
Task 13132,Job 1,6,9,2,7,0,8,13,5,2,1,1,13132,13166,18
Task 13133,Job 0,10,9,2,11,0,12,21,9,2,3,2,13133,13167,18
Task 13133,Job 1,15,9,4,10,0,19,25,6,4,2,0,13133,13167,8
Task 13134,Job 0,7,5,1,8,1,8,15,7,1,1,0,13134,13168,10
Task 13134,Job 1,12,8,1,6,0,13,18,5,1,2,2,13134,13168,20
Task 13135,Job 0,2,9,2,10,0,4,12,8,2,3,0,13135,13169,11
Task 13135,Job 1,7,8,3,10,0,10,17,7,3,2,1,13135,13169,16
Task 13136,Job 0,1,8,2,9,0,3,10,7,2,3,0,13136,13170,10
Task 13136,Job 1,6,4,1,6,1,7,12,5,1,4,2,13136,13170,9
Task 13137,Job 0,7,8,2,10,1,9,17,8,2,1,2,13137,13171,15
Task 13137,Job 1,12,5,4,9,0,16,21,5,4,3,0,13137,13171,7
Task 13138,Job 0,7,8,4,6,0,11,13,2,4,4,0,13138,13172,18
Task 13138,Job 1,12,10,1,12,0,13,24,11,1,1,2,13138,13172,3
Task 13139,Job 0,1,5,3,10,1,4,11,7,3,2,1,13139,13172,13
Task 13139,Job 1,6,8,2,10,1,8,16,8,2,3,2,13139,13172,18
Task 13140,Job 0,6,9,4,8,0,10,14,4,4,1,0,13140,13173,7
Task 13140,Job 1,11,5,4,10,1,15,21,6,4,2,2,13140,13173,19
Task 13141,Job 0,10,7,3,11,0,13,21,8,3,4,2,13141,13175,6
Task 13141,Job 1,15,5,3,10,1,18,25,7,3,3,1,13141,13175,16
Task 13142,Job 0,2,10,3,11,0,5,13,8,3,2,0,13142,13176,20
Task 13142,Job 1,7,6,1,12,1,8,19,11,1,1,0,13142,13176,18
Task 13143,Job 0,3,6,1,11,1,4,14,10,1,4,1,13143,13177,9
Task 13143,Job 1,8,10,4,8,0,12,16,4,4,3,2,13143,13177,5
Task 13144,Job 0,10,8,1,10,0,11,20,9,1,1,0,13144,13177,12
Task 13144,Job 1,15,4,2,8,0,17,23,6,2,3,1,13144,13177,16
Task 13145,Job 0,2,4,1,9,0,3,11,8,1,3,0,13145,13179,11
Task 13145,Job 1,7,7,3,7,0,10,14,4,3,4,1,13145,13179,15
Task 13146,Job 0,4,4,2,8,0,6,12,6,2,2,1,13146,13179,15
Task 13146,Job 1,9,6,3,11,1,12,20,8,3,4,1,13146,13179,5
Task 13147,Job 0,4,10,4,11,1,8,15,7,4,1,0,13147,13181,19
Task 13147,Job 1,9,7,1,7,0,10,16,6,1,2,1,13147,13181,6
Task 13148,Job 0,4,4,4,11,0,8,15,7,4,2,0,13148,13181,18
Task 13148,Job 1,9,4,1,12,1,10,21,11,1,4,2,13148,13181,7
Task 13149,Job 0,2,5,2,7,1,4,9,5,2,2,1,13149,13183,13
Task 13149,Job 1,7,10,4,9,1,11,16,5,4,2,1,13149,13183,16
Task 13150,Job 0,2,4,1,8,1,3,10,7,1,1,1,13150,13184,3
Task 13150,Job 1,7,10,1,8,1,8,15,7,1,4,2,13150,13184,9
Task 13151,Job 0,2,9,1,6,1,3,8,5,1,2,1,13151,13185,17
Task 13151,Job 1,7,4,1,9,0,8,16,8,1,3,0,13151,13185,17
Task 13152,Job 0,5,8,3,10,0,8,15,7,3,2,2,13152,13185,14
Task 13152,Job 1,10,10,2,6,1,12,16,4,2,1,2,13152,13185,8
Task 13153,Job 0,10,4,1,8,0,11,18,7,1,3,1,13153,13186,20
Task 13153,Job 1,15,8,4,11,0,19,26,7,4,1,1,13153,13186,7
Task 13154,Job 0,9,6,2,6,1,11,15,4,2,2,1,13154,13187,3
Task 13154,Job 1,14,5,4,7,0,18,21,3,4,3,1,13154,13187,5
Task 13155,Job 0,9,9,1,10,0,10,19,9,1,2,1,13155,13189,10
Task 13155,Job 1,14,6,4,9,0,18,23,5,4,1,2,13155,13189,13
Task 13156,Job 0,2,5,3,7,0,5,9,4,3,4,2,13156,13189,13
Task 13156,Job 1,7,9,4,9,1,11,16,5,4,4,1,13156,13189,10
Task 13157,Job 0,9,8,3,8,0,12,17,5,3,2,1,13157,13190,15
Task 13157,Job 1,14,4,3,9,0,17,23,6,3,3,0,13157,13190,7
Task 13158,Job 0,6,6,4,7,0,10,13,3,4,2,0,13158,13192,19
Task 13158,Job 1,11,5,2,10,0,13,21,8,2,2,1,13158,13192,2
Task 13159,Job 0,4,5,3,8,0,7,12,5,3,1,2,13159,13192,8
Task 13159,Job 1,9,8,2,10,1,11,19,8,2,2,0,13159,13192,4
Task 13160,Job 0,5,10,3,11,0,8,16,8,3,3,2,13160,13194,10
Task 13160,Job 1,10,7,3,9,0,13,19,6,3,1,2,13160,13194,15
Task 13161,Job 0,2,6,1,12,1,3,14,11,1,3,1,13161,13194,17
Task 13161,Job 1,7,9,2,9,0,9,16,7,2,1,2,13161,13194,5
Task 13162,Job 0,9,6,2,7,1,11,16,5,2,2,2,13162,13195,13
Task 13162,Job 1,14,7,3,12,0,17,26,9,3,2,2,13162,13195,9
Task 13163,Job 0,1,9,4,8,0,5,9,4,4,2,2,13163,13196,16
Task 13163,Job 1,6,10,1,8,0,7,14,7,1,3,0,13163,13196,12
Task 13164,Job 0,1,4,1,10,0,2,11,9,1,2,2,13164,13198,15
Task 13164,Job 1,6,4,1,10,0,7,16,9,1,3,2,13164,13198,19
Task 13165,Job 0,1,10,3,10,0,4,11,7,3,4,0,13165,13198,15
Task 13165,Job 1,6,4,3,10,1,9,16,7,3,4,1,13165,13198,12
Task 13166,Job 0,8,5,2,11,0,10,19,9,2,3,0,13166,13200,19
Task 13166,Job 1,13,9,2,6,0,15,19,4,2,1,2,13166,13200,20
Task 13167,Job 0,3,7,2,12,0,5,15,10,2,1,1,13167,13200,6
Task 13167,Job 1,8,10,2,9,0,10,17,7,2,2,0,13167,13200,10
Task 13168,Job 0,5,5,2,6,0,7,11,4,2,4,1,13168,13202,14
Task 13168,Job 1,10,7,4,10,0,14,20,6,4,4,0,13168,13202,2
Task 13169,Job 0,6,6,3,6,0,9,12,3,3,1,0,13169,13203,10
Task 13169,Job 1,11,7,1,10,0,12,21,9,1,3,1,13169,13203,8
Task 13170,Job 0,10,5,3,9,0,13,19,6,3,1,0,13170,13203,14
Task 13170,Job 1,15,10,2,6,0,17,21,4,2,2,1,13170,13203,11
Task 13171,Job 0,3,4,3,11,0,6,14,8,3,4,1,13171,13204,11
Task 13171,Job 1,8,7,4,10,0,12,18,6,4,2,0,13171,13204,18
Task 13172,Job 0,9,9,1,12,0,10,21,11,1,3,0,13172,13205,17
Task 13172,Job 1,14,9,1,8,0,15,22,7,1,1,0,13172,13205,11
Task 13173,Job 0,9,10,1,9,1,10,18,8,1,1,0,13173,13206,16
Task 13173,Job 1,14,4,3,6,0,17,20,3,3,3,2,13173,13206,16
Task 13174,Job 0,7,4,2,9,1,9,16,7,2,2,0,13174,13207,10
Task 13174,Job 1,12,8,3,12,1,15,24,9,3,1,2,13174,13207,13
Task 13175,Job 0,5,9,2,7,0,7,12,5,2,2,0,13175,13209,5
Task 13175,Job 1,10,10,4,6,0,14,16,2,4,3,0,13175,13209,18
Task 13176,Job 0,7,8,2,9,0,9,16,7,2,4,0,13176,13209,14
Task 13176,Job 1,12,7,4,6,1,16,18,2,4,4,0,13176,13209,7
Task 13177,Job 0,1,10,1,10,1,2,11,9,1,3,2,13177,13211,11
Task 13177,Job 1,6,6,1,9,0,7,15,8,1,1,2,13177,13211,18
Task 13178,Job 0,1,10,2,12,0,3,13,10,2,3,0,13178,13211,9
Task 13178,Job 1,6,10,1,6,0,7,12,5,1,3,1,13178,13211,19
Task 13179,Job 0,6,7,1,12,1,7,18,11,1,4,0,13179,13212,9
Task 13179,Job 1,11,10,3,8,0,14,19,5,3,4,2,13179,13212,16
Task 13180,Job 0,9,8,4,9,1,13,18,5,4,3,1,13180,13213,8
Task 13180,Job 1,14,5,3,12,1,17,26,9,3,1,0,13180,13213,13
Task 13181,Job 0,7,10,2,7,1,9,14,5,2,4,1,13181,13215,13
Task 13181,Job 1,12,9,2,8,0,14,20,6,2,3,1,13181,13215,12
Task 13182,Job 0,5,10,4,8,0,9,13,4,4,2,1,13182,13215,10
Task 13182,Job 1,10,10,3,6,1,13,16,3,3,2,2,13182,13215,5
Task 13183,Job 0,1,9,4,12,0,5,13,8,4,3,1,13183,13217,6
Task 13183,Job 1,6,4,2,7,0,8,13,5,2,2,1,13183,13217,16
Task 13184,Job 0,9,6,2,12,1,11,21,10,2,2,1,13184,13217,4
Task 13184,Job 1,14,8,4,8,1,18,22,4,4,4,2,13184,13217,11
Task 13185,Job 0,3,6,4,8,0,7,11,4,4,4,2,13185,13218,6
Task 13185,Job 1,8,5,2,7,0,10,15,5,2,2,1,13185,13218,3
Task 13186,Job 0,8,6,1,6,0,9,14,5,1,1,0,13186,13219,12
Task 13186,Job 1,13,6,1,8,0,14,21,7,1,3,0,13186,13219,8
Task 13187,Job 0,2,8,1,6,0,3,8,5,1,4,0,13187,13220,17
Task 13187,Job 1,7,5,4,10,0,11,17,6,4,1,1,13187,13220,16
Task 13188,Job 0,5,9,3,8,0,8,13,5,3,1,0,13188,13221,8
Task 13188,Job 1,10,8,2,6,0,12,16,4,2,3,2,13188,13221,16
Task 13189,Job 0,2,7,4,6,0,6,8,2,4,2,2,13189,13222,16
Task 13189,Job 1,7,7,1,7,1,8,14,6,1,4,1,13189,13222,16
Task 13190,Job 0,2,8,3,7,1,5,9,4,3,3,0,13190,13223,19
Task 13190,Job 1,7,7,2,10,1,9,17,8,2,3,0,13190,13223,20
Task 13191,Job 0,9,6,2,9,1,11,18,7,2,2,0,13191,13225,2
Task 13191,Job 1,14,7,4,10,0,18,24,6,4,1,1,13191,13225,14
Task 13192,Job 0,7,4,3,7,1,10,14,4,3,1,0,13192,13225,4
Task 13192,Job 1,12,7,3,7,0,15,19,4,3,2,0,13192,13225,15
Task 13193,Job 0,1,8,1,7,0,2,8,6,1,3,2,13193,13227,9
Task 13193,Job 1,6,5,4,9,1,10,15,5,4,3,1,13193,13227,9
Task 13194,Job 0,8,7,4,7,1,12,15,3,4,2,2,13194,13227,10
Task 13194,Job 1,13,4,4,11,0,17,24,7,4,1,0,13194,13227,19
Task 13195,Job 0,1,6,1,10,0,2,11,9,1,1,1,13195,13228,17
Task 13195,Job 1,6,9,2,7,0,8,13,5,2,3,2,13195,13228,14
Task 13196,Job 0,10,4,4,6,0,14,16,2,4,1,0,13196,13230,8
Task 13196,Job 1,15,9,3,10,0,18,25,7,3,4,1,13196,13230,14
Task 13197,Job 0,3,7,1,10,0,4,13,9,1,4,0,13197,13231,16
Task 13197,Job 1,8,8,3,10,1,11,18,7,3,2,0,13197,13231,6
Task 13198,Job 0,2,9,2,12,0,4,14,10,2,1,0,13198,13231,15
Task 13198,Job 1,7,10,3,9,0,10,16,6,3,3,2,13198,13231,14
Task 13199,Job 0,6,9,3,9,0,9,15,6,3,3,0,13199,13232,18
Task 13199,Job 1,11,5,3,12,0,14,23,9,3,1,2,13199,13232,17
Task 13200,Job 0,9,9,1,9,1,10,18,8,1,4,1,13200,13233,14
Task 13200,Job 1,14,6,4,9,0,18,23,5,4,1,0,13200,13233,5
Task 13201,Job 0,2,5,2,8,1,4,10,6,2,3,1,13201,13235,16
Task 13201,Job 1,7,6,3,9,0,10,16,6,3,1,1,13201,13235,3
Task 13202,Job 0,5,7,3,6,1,8,11,3,3,1,2,13202,13236,7
Task 13202,Job 1,10,7,1,12,0,11,22,11,1,4,2,13202,13236,18
Task 13203,Job 0,2,10,3,6,0,5,8,3,3,3,0,13203,13236,20
Task 13203,Job 1,7,5,1,7,0,8,14,6,1,3,2,13203,13236,8
Task 13204,Job 0,2,9,1,7,0,3,9,6,1,4,2,13204,13237,19
Task 13204,Job 1,7,4,3,10,1,10,17,7,3,2,1,13204,13237,8
Task 13205,Job 0,6,9,4,8,0,10,14,4,4,4,2,13205,13238,20
Task 13205,Job 1,11,6,4,10,0,15,21,6,4,2,1,13205,13238,19
Task 13206,Job 0,6,7,1,8,0,7,14,7,1,3,0,13206,13239,15
Task 13206,Job 1,11,5,4,6,0,15,17,2,4,4,2,13206,13239,18
Task 13207,Job 0,4,4,4,11,0,8,15,7,4,1,2,13207,13240,14
Task 13207,Job 1,9,9,2,7,0,11,16,5,2,1,0,13207,13240,5
Task 13208,Job 0,9,7,1,8,0,10,17,7,1,2,1,13208,13242,15
Task 13208,Job 1,14,5,2,7,0,16,21,5,2,1,2,13208,13242,14
Task 13209,Job 0,5,4,4,9,0,9,14,5,4,3,0,13209,13243,5
Task 13209,Job 1,10,4,4,8,0,14,18,4,4,4,1,13209,13243,2
Task 13210,Job 0,2,6,2,9,0,4,11,7,2,4,1,13210,13244,12
Task 13210,Job 1,7,9,3,7,0,10,14,4,3,4,1,13210,13244,7
Task 13211,Job 0,8,8,2,9,0,10,17,7,2,1,1,13211,13245,20
Task 13211,Job 1,13,4,2,7,0,15,20,5,2,1,2,13211,13245,13
Task 13212,Job 0,2,10,3,6,0,5,8,3,3,2,2,13212,13246,12
Task 13212,Job 1,7,5,1,8,0,8,15,7,1,3,1,13212,13246,20
Task 13213,Job 0,3,7,2,8,0,5,11,6,2,3,2,13213,13247,18
Task 13213,Job 1,8,7,4,10,0,12,18,6,4,4,2,13213,13247,18
Task 13214,Job 0,1,7,3,10,0,4,11,7,3,3,1,13214,13247,11
Task 13214,Job 1,6,10,1,11,0,7,17,10,1,2,2,13214,13247,8
Task 13215,Job 0,4,4,4,9,0,8,13,5,4,3,1,13215,13249,3
Task 13215,Job 1,9,7,4,10,0,13,19,6,4,2,1,13215,13249,12
Task 13216,Job 0,1,9,1,9,0,2,10,8,1,2,2,13216,13250,8
Task 13216,Job 1,6,5,4,6,0,10,12,2,4,4,2,13216,13250,12
Task 13217,Job 0,4,5,3,9,0,7,13,6,3,3,1,13217,13251,11
Task 13217,Job 1,9,6,3,11,1,12,20,8,3,2,2,13217,13251,13
Task 13218,Job 0,10,8,2,8,0,12,18,6,2,2,2,13218,13251,3
Task 13218,Job 1,15,7,3,7,1,18,22,4,3,2,2,13218,13251,7
Task 13219,Job 0,1,10,1,10,0,2,11,9,1,4,0,13219,13252,15
Task 13219,Job 1,6,10,2,8,0,8,14,6,2,1,2,13219,13252,20
Task 13220,Job 0,3,4,1,8,0,4,11,7,1,1,2,13220,13254,16
Task 13220,Job 1,8,8,1,12,0,9,20,11,1,3,0,13220,13254,16
Task 13221,Job 0,7,9,3,11,1,10,18,8,3,2,0,13221,13254,9
Task 13221,Job 1,12,9,3,6,0,15,18,3,3,3,1,13221,13254,13
Task 13222,Job 0,5,5,3,6,1,8,11,3,3,3,1,13222,13255,15
Task 13222,Job 1,10,4,2,7,0,12,17,5,2,1,2,13222,13255,12
Task 13223,Job 0,3,8,2,12,0,5,15,10,2,2,2,13223,13257,2
Task 13223,Job 1,8,6,1,8,1,9,16,7,1,4,0,13223,13257,4
Task 13224,Job 0,7,7,4,8,0,11,15,4,4,1,0,13224,13257,3
Task 13224,Job 1,12,7,4,7,0,16,19,3,4,2,2,13224,13257,18
Task 13225,Job 0,2,6,2,11,0,4,13,9,2,2,1,13225,13259,20
Task 13225,Job 1,7,5,4,11,0,11,18,7,4,2,2,13225,13259,14
Task 13226,Job 0,2,5,3,10,0,5,12,7,3,3,2,13226,13260,20
Task 13226,Job 1,7,10,2,7,0,9,14,5,2,3,1,13226,13260,4
Task 13227,Job 0,9,8,4,6,0,13,15,2,4,2,2,13227,13260,11
Task 13227,Job 1,14,6,1,10,0,15,24,9,1,3,1,13227,13260,4
Task 13228,Job 0,10,9,2,9,0,12,19,7,2,4,2,13228,13261,16
Task 13228,Job 1,15,6,2,10,0,17,25,8,2,3,1,13228,13261,18
Task 13229,Job 0,1,5,1,8,1,2,9,7,1,4,1,13229,13262,3
Task 13229,Job 1,6,9,2,10,0,8,16,8,2,1,1,13229,13262,3
Task 13230,Job 0,9,6,2,11,0,11,20,9,2,2,0,13230,13263,13
Task 13230,Job 1,14,7,3,9,0,17,23,6,3,3,2,13230,13263,7
Task 13231,Job 0,8,6,2,6,0,10,14,4,2,4,0,13231,13265,3
Task 13231,Job 1,13,9,3,9,1,16,22,6,3,4,2,13231,13265,3
Task 13232,Job 0,4,6,2,7,0,6,11,5,2,4,0,13232,13265,5
Task 13232,Job 1,9,8,3,12,1,12,21,9,3,2,0,13232,13265,2
Task 13233,Job 0,3,9,4,11,0,7,14,7,4,4,0,13233,13266,12
Task 13233,Job 1,8,8,2,7,0,10,15,5,2,2,0,13233,13266,15
Task 13234,Job 0,10,4,1,6,1,11,16,5,1,2,2,13234,13267,20
Task 13234,Job 1,15,7,3,12,0,18,27,9,3,2,2,13234,13267,20
Task 13235,Job 0,10,4,4,10,0,14,20,6,4,2,1,13235,13268,15
Task 13235,Job 1,15,7,2,11,0,17,26,9,2,3,1,13235,13268,20
Task 13236,Job 0,7,8,1,10,0,8,17,9,1,4,2,13236,13269,5
Task 13236,Job 1,12,9,2,9,0,14,21,7,2,3,2,13236,13269,9
Task 13237,Job 0,10,5,4,10,0,14,20,6,4,1,0,13237,13271,2
Task 13237,Job 1,15,6,2,9,0,17,24,7,2,4,1,13237,13271,12
Task 13238,Job 0,1,9,2,7,1,3,8,5,2,3,0,13238,13272,20
Task 13238,Job 1,6,6,1,12,0,7,18,11,1,1,1,13238,13272,8
Task 13239,Job 0,1,8,4,9,0,5,10,5,4,1,0,13239,13273,3
Task 13239,Job 1,6,5,2,8,0,8,14,6,2,3,1,13239,13273,18
Task 13240,Job 0,4,10,3,6,0,7,10,3,3,3,0,13240,13274,12
Task 13240,Job 1,9,4,3,12,0,12,21,9,3,3,0,13240,13274,8
Task 13241,Job 0,5,6,4,7,0,9,12,3,4,4,1,13241,13275,11
Task 13241,Job 1,10,6,1,12,0,11,22,11,1,1,2,13241,13275,7
Task 13242,Job 0,1,9,1,12,0,2,13,11,1,3,0,13242,13275,5
Task 13242,Job 1,6,4,2,9,0,8,15,7,2,3,2,13242,13275,5
Task 13243,Job 0,3,6,3,9,1,6,12,6,3,2,1,13243,13276,18
Task 13243,Job 1,8,5,2,8,0,10,16,6,2,2,2,13243,13276,12
Task 13244,Job 0,7,4,3,9,0,10,16,6,3,3,0,13244,13277,12
Task 13244,Job 1,12,10,2,9,0,14,21,7,2,3,2,13244,13277,15
Task 13245,Job 0,2,8,2,8,0,4,10,6,2,4,1,13245,13278,2
Task 13245,Job 1,7,5,3,7,1,10,14,4,3,2,2,13245,13278,19
Task 13246,Job 0,5,4,4,8,0,9,13,4,4,4,0,13246,13280,2
Task 13246,Job 1,10,8,4,10,0,14,20,6,4,3,1,13246,13280,20
Task 13247,Job 0,10,8,1,8,0,11,18,7,1,1,2,13247,13280,7
Task 13247,Job 1,15,7,3,7,1,18,22,4,3,2,0,13247,13280,9
Task 13248,Job 0,6,7,2,12,0,8,18,10,2,4,2,13248,13282,20
Task 13248,Job 1,11,9,2,12,1,13,23,10,2,4,0,13248,13282,7
Task 13249,Job 0,5,5,1,6,0,6,11,5,1,3,0,13249,13283,19
Task 13249,Job 1,10,4,4,8,0,14,18,4,4,3,0,13249,13283,17
Task 13250,Job 0,4,6,2,11,1,6,15,9,2,4,1,13250,13284,8
Task 13250,Job 1,9,10,2,7,0,11,16,5,2,3,2,13250,13284,18
Task 13251,Job 0,2,7,1,9,0,3,11,8,1,3,1,13251,13284,2
Task 13251,Job 1,7,10,1,8,1,8,15,7,1,3,1,13251,13284,18
Task 13252,Job 0,8,5,1,12,1,9,20,11,1,1,1,13252,13285,8
Task 13252,Job 1,13,6,3,7,0,16,20,4,3,4,0,13252,13285,5
Task 13253,Job 0,2,8,3,11,1,5,13,8,3,1,1,13253,13286,11
Task 13253,Job 1,7,10,3,8,0,10,15,5,3,4,2,13253,13286,7
Task 13254,Job 0,7,4,1,7,0,8,14,6,1,4,1,13254,13288,19
Task 13254,Job 1,12,10,3,7,0,15,19,4,3,1,0,13254,13288,12
Task 13255,Job 0,5,10,1,8,0,6,13,7,1,4,2,13255,13289,5
Task 13255,Job 1,10,10,2,7,0,12,17,5,2,3,1,13255,13289,12
Task 13256,Job 0,4,7,2,12,1,6,16,10,2,1,2,13256,13289,11
Task 13256,Job 1,9,9,3,10,1,12,19,7,3,4,0,13256,13289,2
Task 13257,Job 0,1,9,4,12,0,5,13,8,4,2,1,13257,13291,8
Task 13257,Job 1,6,9,1,7,1,7,13,6,1,4,1,13257,13291,6
Task 13258,Job 0,6,7,2,7,0,8,13,5,2,3,0,13258,13292,18
Task 13258,Job 1,11,4,3,9,1,14,20,6,3,4,1,13258,13292,7
Task 13259,Job 0,8,7,1,7,1,9,15,6,1,4,0,13259,13292,8
Task 13259,Job 1,13,10,4,8,0,17,21,4,4,2,0,13259,13292,17
Task 13260,Job 0,10,5,2,10,0,12,20,8,2,4,1,13260,13293,16
Task 13260,Job 1,15,8,3,12,0,18,27,9,3,4,0,13260,13293,8
Task 13261,Job 0,5,4,4,6,1,9,11,2,4,4,2,13261,13295,14
Task 13261,Job 1,10,10,1,7,0,11,17,6,1,2,2,13261,13295,6
Task 13262,Job 0,7,6,1,10,1,8,17,9,1,4,0,13262,13296,18
Task 13262,Job 1,12,7,3,10,0,15,22,7,3,2,0,13262,13296,20
Task 13263,Job 0,1,6,2,8,0,3,9,6,2,3,1,13263,13296,15
Task 13263,Job 1,6,8,1,10,0,7,16,9,1,3,1,13263,13296,10
Task 13264,Job 0,4,4,2,11,0,6,15,9,2,4,1,13264,13297,13
Task 13264,Job 1,9,9,2,9,0,11,18,7,2,3,2,13264,13297,8
Task 13265,Job 0,3,4,2,12,0,5,15,10,2,4,2,13265,13298,2
Task 13265,Job 1,8,7,4,11,1,12,19,7,4,1,2,13265,13298,14
Task 13266,Job 0,4,4,4,11,1,8,15,7,4,1,2,13266,13300,16
Task 13266,Job 1,9,8,1,8,1,10,17,7,1,3,0,13266,13300,8
Task 13267,Job 0,7,10,3,8,0,10,15,5,3,2,2,13267,13301,18
Task 13267,Job 1,12,7,4,7,0,16,19,3,4,4,0,13267,13301,20
Task 13268,Job 0,9,10,2,6,0,11,15,4,2,1,0,13268,13302,6
Task 13268,Job 1,14,10,4,6,0,18,20,2,4,3,2,13268,13302,20
Task 13269,Job 0,8,7,4,10,0,12,18,6,4,3,0,13269,13303,8
Task 13269,Job 1,13,10,1,9,0,14,22,8,1,4,0,13269,13303,13
Task 13270,Job 0,5,6,2,12,1,7,17,10,2,4,2,13270,13303,9
Task 13270,Job 1,10,6,2,10,0,12,20,8,2,4,2,13270,13303,12
Task 13271,Job 0,7,9,1,11,1,8,18,10,1,4,0,13271,13304,4
Task 13271,Job 1,12,6,1,8,0,13,20,7,1,4,1,13271,13304,20
Task 13272,Job 0,4,9,2,11,0,6,15,9,2,4,2,13272,13306,13
Task 13272,Job 1,9,9,3,6,0,12,15,3,3,1,1,13272,13306,17
Task 13273,Job 0,1,8,1,8,0,2,9,7,1,4,1,13273,13306,5
Task 13273,Job 1,6,8,2,11,0,8,17,9,2,1,1,13273,13306,7
Task 13274,Job 0,1,7,2,8,0,3,9,6,2,3,1,13274,13307,13
Task 13274,Job 1,6,7,3,10,1,9,16,7,3,4,2,13274,13307,7
Task 13275,Job 0,3,6,1,6,0,4,9,5,1,1,0,13275,13308,12
Task 13275,Job 1,8,7,1,9,0,9,17,8,1,4,1,13275,13308,16
Task 13276,Job 0,4,7,4,8,0,8,12,4,4,3,1,13276,13310,13
Task 13276,Job 1,9,9,2,9,0,11,18,7,2,4,1,13276,13310,4
Task 13277,Job 0,9,7,4,11,0,13,20,7,4,2,2,13277,13311,16
Task 13277,Job 1,14,5,1,6,1,15,20,5,1,2,2,13277,13311,13
Task 13278,Job 0,5,9,3,11,0,8,16,8,3,1,0,13278,13311,6
Task 13278,Job 1,10,7,3,10,0,13,20,7,3,1,2,13278,13311,3
Task 13279,Job 0,7,6,4,9,0,11,16,5,4,2,2,13279,13313,11
Task 13279,Job 1,12,8,1,7,0,13,19,6,1,3,1,13279,13313,15
Task 13280,Job 0,6,4,3,12,0,9,18,9,3,1,0,13280,13314,16
Task 13280,Job 1,11,9,4,9,1,15,20,5,4,1,1,13280,13314,11
Task 13281,Job 0,3,9,1,12,0,4,15,11,1,1,2,13281,13315,4
Task 13281,Job 1,8,9,1,7,0,9,15,6,1,3,0,13281,13315,6
Task 13282,Job 0,2,6,3,12,1,5,14,9,3,2,1,13282,13316,6
Task 13282,Job 1,7,5,3,9,0,10,16,6,3,2,0,13282,13316,16
Task 13283,Job 0,7,10,4,8,1,11,15,4,4,1,0,13283,13316,15
Task 13283,Job 1,12,4,1,7,1,13,19,6,1,1,0,13283,13316,12
Task 13284,Job 0,3,7,3,6,0,6,9,3,3,2,2,13284,13317,17
Task 13284,Job 1,8,10,2,7,1,10,15,5,2,2,1,13284,13317,18
Task 13285,Job 0,8,7,2,8,1,10,16,6,2,4,2,13285,13319,9
Task 13285,Job 1,13,4,4,7,1,17,20,3,4,1,0,13285,13319,6
Task 13286,Job 0,4,10,1,9,0,5,13,8,1,2,2,13286,13319,18
Task 13286,Job 1,9,5,3,12,1,12,21,9,3,4,2,13286,13319,5
Task 13287,Job 0,2,8,4,6,1,6,8,2,4,4,1,13287,13320,19
Task 13287,Job 1,7,9,1,12,1,8,19,11,1,2,2,13287,13320,16
Task 13288,Job 0,8,5,1,8,0,9,16,7,1,1,2,13288,13322,6
Task 13288,Job 1,13,8,3,11,0,16,24,8,3,4,1,13288,13322,6
Task 13289,Job 0,9,7,2,9,0,11,18,7,2,2,1,13289,13323,7
Task 13289,Job 1,14,8,3,7,0,17,21,4,3,2,1,13289,13323,15
Task 13290,Job 0,8,8,3,8,0,11,16,5,3,4,1,13290,13324,11
Task 13290,Job 1,13,5,3,10,0,16,23,7,3,3,2,13290,13324,2
Task 13291,Job 0,6,4,3,7,0,9,13,4,3,4,0,13291,13325,17
Task 13291,Job 1,11,9,3,11,0,14,22,8,3,2,2,13291,13325,9
Task 13292,Job 0,4,4,3,8,0,7,12,5,3,4,1,13292,13325,14
Task 13292,Job 1,9,8,1,11,0,10,20,10,1,4,0,13292,13325,6
Task 13293,Job 0,4,7,3,12,1,7,16,9,3,3,2,13293,13326,18
Task 13293,Job 1,9,6,1,11,0,10,20,10,1,4,2,13293,13326,10
Task 13294,Job 0,4,6,4,12,1,8,16,8,4,3,2,13294,13327,19
Task 13294,Job 1,9,4,2,10,0,11,19,8,2,2,0,13294,13327,18
Task 13295,Job 0,10,7,3,9,1,13,19,6,3,4,0,13295,13328,11
Task 13295,Job 1,15,10,4,9,0,19,24,5,4,3,1,13295,13328,10
Task 13296,Job 0,4,8,2,8,0,6,12,6,2,2,0,13296,13330,10
Task 13296,Job 1,9,7,2,8,0,11,17,6,2,4,0,13296,13330,11
Task 13297,Job 0,9,9,3,6,0,12,15,3,3,4,1,13297,13330,14
Task 13297,Job 1,14,9,1,11,0,15,25,10,1,1,1,13297,13330,19
Task 13298,Job 0,5,4,3,9,0,8,14,6,3,2,2,13298,13332,17
Task 13298,Job 1,10,4,1,12,0,11,22,11,1,1,2,13298,13332,13
Task 13299,Job 0,6,10,2,11,1,8,17,9,2,3,2,13299,13333,13
Task 13299,Job 1,11,7,2,9,1,13,20,7,2,1,2,13299,13333,5
Task 13300,Job 0,9,7,1,7,1,10,16,6,1,3,1,13300,13334,19
Task 13300,Job 1,14,4,1,6,1,15,20,5,1,3,2,13300,13334,18
Task 13301,Job 0,2,8,4,11,0,6,13,7,4,3,1,13301,13335,10
Task 13301,Job 1,7,10,2,12,0,9,19,10,2,3,2,13301,13335,3
Task 13302,Job 0,6,7,1,6,0,7,12,5,1,2,0,13302,13335,4
Task 13302,Job 1,11,8,2,7,1,13,18,5,2,4,2,13302,13335,5
Task 13303,Job 0,6,10,3,11,0,9,17,8,3,2,1,13303,13336,8
Task 13303,Job 1,11,10,1,10,0,12,21,9,1,4,1,13303,13336,6
Task 13304,Job 0,4,6,3,7,0,7,11,4,3,1,0,13304,13338,3
Task 13304,Job 1,9,4,3,7,0,12,16,4,3,3,0,13304,13338,7
Task 13305,Job 0,5,8,1,9,0,6,14,8,1,4,2,13305,13339,19
Task 13305,Job 1,10,6,3,10,0,13,20,7,3,2,1,13305,13339,5
Task 13306,Job 0,3,10,1,6,1,4,9,5,1,1,1,13306,13340,20
Task 13306,Job 1,8,8,4,8,0,12,16,4,4,4,2,13306,13340,11
Task 13307,Job 0,3,9,2,12,0,5,15,10,2,4,0,13307,13341,14
Task 13307,Job 1,8,7,3,7,0,11,15,4,3,3,0,13307,13341,14
Task 13308,Job 0,4,9,3,11,0,7,15,8,3,3,0,13308,13341,12
Task 13308,Job 1,9,9,4,12,0,13,21,8,4,1,1,13308,13341,12
Task 13309,Job 0,8,10,3,6,0,11,14,3,3,2,0,13309,13342,16
Task 13309,Job 1,13,9,4,12,0,17,25,8,4,3,0,13309,13342,5
Task 13310,Job 0,4,7,4,7,0,8,11,3,4,2,2,13310,13343,20
Task 13310,Job 1,9,9,4,10,0,13,19,6,4,3,1,13310,13343,12
Task 13311,Job 0,8,4,4,11,0,12,19,7,4,3,2,13311,13345,16
Task 13311,Job 1,13,8,1,7,1,14,20,6,1,3,1,13311,13345,8
Task 13312,Job 0,3,5,4,6,0,7,9,2,4,1,0,13312,13346,3
Task 13312,Job 1,8,6,2,10,1,10,18,8,2,4,0,13312,13346,14
Task 13313,Job 0,2,9,1,11,0,3,13,10,1,3,0,13313,13347,3
Task 13313,Job 1,7,6,2,7,0,9,14,5,2,3,0,13313,13347,14
Task 13314,Job 0,5,7,2,12,0,7,17,10,2,3,1,13314,13347,9
Task 13314,Job 1,10,8,1,9,1,11,19,8,1,3,2,13314,13347,15
Task 13315,Job 0,9,5,3,7,0,12,16,4,3,4,2,13315,13349,14
Task 13315,Job 1,14,5,4,10,0,18,24,6,4,3,1,13315,13349,14
Task 13316,Job 0,7,5,2,9,0,9,16,7,2,3,2,13316,13350,7
Task 13316,Job 1,12,4,3,8,0,15,20,5,3,4,1,13316,13350,3
Task 13317,Job 0,3,5,1,9,0,4,12,8,1,1,1,13317,13350,10
Task 13317,Job 1,8,7,1,8,0,9,16,7,1,1,1,13317,13350,7
Task 13318,Job 0,2,10,1,6,0,3,8,5,1,1,0,13318,13352,5
Task 13318,Job 1,7,8,3,11,0,10,18,8,3,3,0,13318,13352,15
Task 13319,Job 0,8,7,2,12,0,10,20,10,2,2,1,13319,13352,11
Task 13319,Job 1,13,8,1,11,1,14,24,10,1,4,2,13319,13352,7
Task 13320,Job 0,8,6,1,10,1,9,18,9,1,3,0,13320,13353,8
Task 13320,Job 1,13,6,4,12,0,17,25,8,4,1,1,13320,13353,2
Task 13321,Job 0,10,6,1,8,0,11,18,7,1,2,2,13321,13355,10
Task 13321,Job 1,15,8,3,6,0,18,21,3,3,4,1,13321,13355,8
Task 13322,Job 0,5,9,4,12,1,9,17,8,4,1,2,13322,13356,16
Task 13322,Job 1,10,6,2,10,0,12,20,8,2,2,2,13322,13356,3
Task 13323,Job 0,9,4,4,6,1,13,15,2,4,1,0,13323,13356,13
Task 13323,Job 1,14,10,4,11,0,18,25,7,4,3,2,13323,13356,13
Task 13324,Job 0,6,6,2,11,0,8,17,9,2,4,2,13324,13357,15
Task 13324,Job 1,11,5,2,7,0,13,18,5,2,3,1,13324,13357,2
Task 13325,Job 0,5,8,3,7,0,8,12,4,3,3,0,13325,13359,12
Task 13325,Job 1,10,6,3,12,1,13,22,9,3,3,1,13325,13359,20
Task 13326,Job 0,10,4,4,9,0,14,19,5,4,3,2,13326,13359,3
Task 13326,Job 1,15,7,1,7,0,16,22,6,1,3,0,13326,13359,5
Task 13327,Job 0,6,6,3,7,0,9,13,4,3,3,0,13327,13360,6
Task 13327,Job 1,11,5,3,8,0,14,19,5,3,3,1,13327,13360,14
Task 13328,Job 0,5,8,3,12,1,8,17,9,3,4,2,13328,13361,9
Task 13328,Job 1,10,8,4,6,0,14,16,2,4,3,1,13328,13361,20
Task 13329,Job 0,7,9,4,7,0,11,14,3,4,1,0,13329,13362,12
Task 13329,Job 1,12,4,2,11,0,14,23,9,2,2,0,13329,13362,10
Task 13330,Job 0,1,7,4,11,0,5,12,7,4,4,0,13330,13364,4
Task 13330,Job 1,6,6,2,9,0,8,15,7,2,2,0,13330,13364,10
Task 13331,Job 0,9,4,3,9,0,12,18,6,3,1,1,13331,13364,20
Task 13331,Job 1,14,6,3,12,0,17,26,9,3,3,0,13331,13364,15
Task 13332,Job 0,1,10,4,12,1,5,13,8,4,4,2,13332,13365,19
Task 13332,Job 1,6,5,2,11,1,8,17,9,2,1,2,13332,13365,6
Task 13333,Job 0,6,5,2,7,0,8,13,5,2,3,1,13333,13366,17
Task 13333,Job 1,11,9,3,7,0,14,18,4,3,4,2,13333,13366,15
Task 13334,Job 0,4,8,2,7,0,6,11,5,2,3,2,13334,13368,10
Task 13334,Job 1,9,6,1,7,0,10,16,6,1,1,2,13334,13368,13
Task 13335,Job 0,2,10,2,10,1,4,12,8,2,2,0,13335,13368,2
Task 13335,Job 1,7,9,3,9,0,10,16,6,3,2,1,13335,13368,11
Task 13336,Job 0,2,5,1,11,0,3,13,10,1,2,0,13336,13370,19
Task 13336,Job 1,7,8,3,7,0,10,14,4,3,4,1,13336,13370,17
Task 13337,Job 0,4,5,1,8,1,5,12,7,1,1,0,13337,13371,8
Task 13337,Job 1,9,4,2,8,0,11,17,6,2,3,0,13337,13371,3
Task 13338,Job 0,10,7,2,8,0,12,18,6,2,3,2,13338,13372,15
Task 13338,Job 1,15,4,1,9,1,16,24,8,1,3,2,13338,13372,10
Task 13339,Job 0,9,7,1,7,0,10,16,6,1,1,2,13339,13372,10
Task 13339,Job 1,14,5,3,9,0,17,23,6,3,2,0,13339,13372,7
Task 13340,Job 0,6,9,4,12,0,10,18,8,4,3,1,13340,13373,2
Task 13340,Job 1,11,5,1,7,0,12,18,6,1,1,0,13340,13373,11
Task 13341,Job 0,6,4,1,7,0,7,13,6,1,3,0,13341,13374,3
Task 13341,Job 1,11,4,3,7,0,14,18,4,3,1,0,13341,13374,16
Task 13342,Job 0,1,5,3,9,0,4,10,6,3,2,0,13342,13376,8
Task 13342,Job 1,6,4,1,9,0,7,15,8,1,2,0,13342,13376,16
Task 13343,Job 0,8,9,1,9,0,9,17,8,1,1,0,13343,13376,5
Task 13343,Job 1,13,4,1,7,0,14,20,6,1,4,0,13343,13376,10
Task 13344,Job 0,10,4,1,10,0,11,20,9,1,1,1,13344,13378,7
Task 13344,Job 1,15,10,1,7,0,16,22,6,1,3,2,13344,13378,9
Task 13345,Job 0,4,5,3,8,0,7,12,5,3,1,2,13345,13378,13
Task 13345,Job 1,9,8,4,11,1,13,20,7,4,3,2,13345,13378,3
Task 13346,Job 0,4,5,3,10,1,7,14,7,3,3,0,13346,13379,13
Task 13346,Job 1,9,8,3,7,1,12,16,4,3,4,1,13346,13379,12
Task 13347,Job 0,7,9,4,11,0,11,18,7,4,4,0,13347,13381,5
Task 13347,Job 1,12,4,1,7,1,13,19,6,1,4,2,13347,13381,10
Task 13348,Job 0,3,9,3,10,0,6,13,7,3,1,0,13348,13381,13
Task 13348,Job 1,8,5,2,10,0,10,18,8,2,2,1,13348,13381,5
Task 13349,Job 0,3,9,3,12,1,6,15,9,3,2,0,13349,13383,7
Task 13349,Job 1,8,8,2,8,0,10,16,6,2,4,2,13349,13383,19
Task 13350,Job 0,2,7,2,6,1,4,8,4,2,1,0,13350,13384,3
Task 13350,Job 1,7,10,4,12,0,11,19,8,4,4,0,13350,13384,7
Task 13351,Job 0,9,8,2,12,0,11,21,10,2,1,0,13351,13385,12
Task 13351,Job 1,14,9,1,9,0,15,23,8,1,1,0,13351,13385,8
Task 13352,Job 0,1,7,1,7,0,2,8,6,1,2,2,13352,13386,19
Task 13352,Job 1,6,8,4,10,1,10,16,6,4,3,0,13352,13386,14
Task 13353,Job 0,9,10,1,6,0,10,15,5,1,3,1,13353,13386,5
Task 13353,Job 1,14,8,4,11,0,18,25,7,4,1,1,13353,13386,16
Task 13354,Job 0,7,8,2,11,0,9,18,9,2,1,0,13354,13387,9
Task 13354,Job 1,12,10,2,10,1,14,22,8,2,2,2,13354,13387,3
Task 13355,Job 0,5,5,2,11,0,7,16,9,2,4,2,13355,13389,2
Task 13355,Job 1,10,9,4,10,1,14,20,6,4,4,2,13355,13389,11
Task 13356,Job 0,9,6,4,8,0,13,17,4,4,3,0,13356,13389,6
Task 13356,Job 1,14,9,2,9,1,16,23,7,2,1,2,13356,13389,9
Task 13357,Job 0,6,9,3,6,0,9,12,3,3,2,2,13357,13390,6
Task 13357,Job 1,11,6,2,9,0,13,20,7,2,2,1,13357,13390,2
Task 13358,Job 0,1,6,3,12,0,4,13,9,3,1,1,13358,13392,11
Task 13358,Job 1,6,4,3,6,0,9,12,3,3,3,2,13358,13392,16
Task 13359,Job 0,7,7,3,6,0,10,13,3,3,1,1,13359,13393,12
Task 13359,Job 1,12,4,3,11,0,15,23,8,3,2,2,13359,13393,2
Task 13360,Job 0,8,6,4,12,0,12,20,8,4,2,0,13360,13394,11
Task 13360,Job 1,13,10,2,6,0,15,19,4,2,3,2,13360,13394,20
Task 13361,Job 0,4,9,1,9,0,5,13,8,1,3,1,13361,13394,5
Task 13361,Job 1,9,4,1,11,0,10,20,10,1,1,0,13361,13394,17
Task 13362,Job 0,7,4,1,7,0,8,14,6,1,3,0,13362,13395,2
Task 13362,Job 1,12,8,2,12,1,14,24,10,2,4,0,13362,13395,3
Task 13363,Job 0,8,6,3,12,0,11,20,9,3,4,2,13363,13397,6
Task 13363,Job 1,13,9,3,6,0,16,19,3,3,4,1,13363,13397,6
Task 13364,Job 0,6,10,3,10,0,9,16,7,3,3,1,13364,13398,16
Task 13364,Job 1,11,7,4,7,0,15,18,3,4,4,1,13364,13398,20
Task 13365,Job 0,3,4,1,10,1,4,13,9,1,2,0,13365,13399,14
Task 13365,Job 1,8,5,4,10,0,12,18,6,4,2,1,13365,13399,4
Task 13366,Job 0,5,4,1,10,1,6,15,9,1,3,0,13366,13399,9
Task 13366,Job 1,10,6,4,9,0,14,19,5,4,4,0,13366,13399,12
Task 13367,Job 0,2,10,1,6,0,3,8,5,1,2,1,13367,13401,20
Task 13367,Job 1,7,9,1,8,0,8,15,7,1,1,2,13367,13401,2
Task 13368,Job 0,2,10,1,8,0,3,10,7,1,3,0,13368,13401,7
Task 13368,Job 1,7,8,1,6,1,8,13,5,1,3,1,13368,13401,18
Task 13369,Job 0,6,9,3,10,1,9,16,7,3,4,1,13369,13403,19
Task 13369,Job 1,11,4,3,9,0,14,20,6,3,3,1,13369,13403,13
Task 13370,Job 0,6,9,4,12,0,10,18,8,4,3,1,13370,13404,12
Task 13370,Job 1,11,10,1,10,0,12,21,9,1,2,2,13370,13404,7
Task 13371,Job 0,4,7,2,8,1,6,12,6,2,2,2,13371,13404,20
Task 13371,Job 1,9,9,1,10,0,10,19,9,1,2,0,13371,13404,9
Task 13372,Job 0,8,9,4,9,0,12,17,5,4,1,1,13372,13405,4
Task 13372,Job 1,13,10,3,12,0,16,25,9,3,4,1,13372,13405,6
Task 13373,Job 0,7,10,4,12,0,11,19,8,4,1,0,13373,13406,10
Task 13373,Job 1,12,9,1,10,0,13,22,9,1,1,1,13373,13406,18
Task 13374,Job 0,1,10,1,6,0,2,7,5,1,1,2,13374,13408,2
Task 13374,Job 1,6,9,4,11,0,10,17,7,4,1,0,13374,13408,17
Task 13375,Job 0,5,7,4,12,1,9,17,8,4,4,2,13375,13409,7
Task 13375,Job 1,10,9,2,12,1,12,22,10,2,3,0,13375,13409,2
Task 13376,Job 0,9,10,1,9,0,10,18,8,1,1,0,13376,13409,15
Task 13376,Job 1,14,9,3,7,1,17,21,4,3,2,2,13376,13409,11
Task 13377,Job 0,5,5,2,11,1,7,16,9,2,2,0,13377,13411,11
Task 13377,Job 1,10,10,4,7,0,14,17,3,4,4,1,13377,13411,7
Task 13378,Job 0,5,5,3,8,0,8,13,5,3,4,2,13378,13411,8
Task 13378,Job 1,10,4,4,10,0,14,20,6,4,4,1,13378,13411,16
Task 13379,Job 0,5,4,4,8,0,9,13,4,4,1,0,13379,13412,19
Task 13379,Job 1,10,4,4,7,1,14,17,3,4,3,1,13379,13412,18
Task 13380,Job 0,4,10,4,9,0,8,13,5,4,1,2,13380,13413,11
Task 13380,Job 1,9,9,3,7,0,12,16,4,3,1,0,13380,13413,13
Task 13381,Job 0,2,5,2,8,0,4,10,6,2,4,1,13381,13415,20
Task 13381,Job 1,7,10,3,8,0,10,15,5,3,1,2,13381,13415,14
Task 13382,Job 0,9,10,1,12,1,10,21,11,1,4,0,13382,13415,16
Task 13382,Job 1,14,9,1,11,0,15,25,10,1,4,1,13382,13415,17
Task 13383,Job 0,10,9,2,7,0,12,17,5,2,3,1,13383,13417,15
Task 13383,Job 1,15,10,3,10,1,18,25,7,3,3,1,13383,13417,17
Task 13384,Job 0,4,7,1,9,1,5,13,8,1,4,2,13384,13417,9
Task 13384,Job 1,9,8,3,6,1,12,15,3,3,1,1,13384,13417,11
Task 13385,Job 0,3,5,2,11,0,5,14,9,2,3,2,13385,13418,13
Task 13385,Job 1,8,10,2,10,0,10,18,8,2,4,2,13385,13418,15
Task 13386,Job 0,2,7,1,11,0,3,13,10,1,3,1,13386,13419,6
Task 13386,Job 1,7,4,4,7,0,11,14,3,4,2,2,13386,13419,3
Task 13387,Job 0,1,5,4,6,0,5,7,2,4,1,1,13387,13421,16
Task 13387,Job 1,6,4,3,12,1,9,18,9,3,1,1,13387,13421,16
Task 13388,Job 0,1,6,4,8,0,5,9,4,4,1,2,13388,13421,16
Task 13388,Job 1,6,7,3,6,0,9,12,3,3,4,1,13388,13421,18
Task 13389,Job 0,5,6,1,10,0,6,15,9,1,4,0,13389,13422,5
Task 13389,Job 1,10,5,3,9,0,13,19,6,3,4,1,13389,13422,14
Task 13390,Job 0,8,6,2,11,0,10,19,9,2,1,0,13390,13423,8
Task 13390,Job 1,13,8,3,9,0,16,22,6,3,4,0,13390,13423,2
Task 13391,Job 0,2,7,4,8,0,6,10,4,4,4,0,13391,13424,15
Task 13391,Job 1,7,7,4,11,0,11,18,7,4,3,2,13391,13424,15
Task 13392,Job 0,7,4,1,7,1,8,14,6,1,2,1,13392,13425,19
Task 13392,Job 1,12,6,4,6,0,16,18,2,4,4,2,13392,13425,6
Task 13393,Job 0,1,7,2,12,0,3,13,10,2,3,0,13393,13427,2
Task 13393,Job 1,6,9,2,7,0,8,13,5,2,2,0,13393,13427,2
Task 13394,Job 0,7,7,4,7,0,11,14,3,4,2,1,13394,13428,6
Task 13394,Job 1,12,8,2,11,0,14,23,9,2,1,2,13394,13428,12
Task 13395,Job 0,7,10,2,9,1,9,16,7,2,3,0,13395,13428,8
Task 13395,Job 1,12,9,2,11,0,14,23,9,2,1,1,13395,13428,20
Task 13396,Job 0,8,10,3,8,1,11,16,5,3,2,0,13396,13429,13
Task 13396,Job 1,13,8,3,9,0,16,22,6,3,1,2,13396,13429,3
Task 13397,Job 0,7,10,2,9,0,9,16,7,2,1,2,13397,13431,11
Task 13397,Job 1,12,7,4,11,0,16,23,7,4,4,2,13397,13431,8
Task 13398,Job 0,5,9,4,10,0,9,15,6,4,4,1,13398,13432,3
Task 13398,Job 1,10,4,3,8,0,13,18,5,3,2,0,13398,13432,14
Task 13399,Job 0,1,7,1,6,0,2,7,5,1,4,1,13399,13432,2
Task 13399,Job 1,6,5,4,9,0,10,15,5,4,2,2,13399,13432,16
Task 13400,Job 0,9,4,2,9,0,11,18,7,2,4,2,13400,13434,13
Task 13400,Job 1,14,5,2,6,0,16,20,4,2,3,1,13400,13434,2
Task 13401,Job 0,8,10,1,12,0,9,20,11,1,1,0,13401,13434,5
Task 13401,Job 1,13,9,3,11,1,16,24,8,3,3,0,13401,13434,8
Task 13402,Job 0,3,4,3,6,1,6,9,3,3,1,2,13402,13435,6
Task 13402,Job 1,8,8,3,9,0,11,17,6,3,4,2,13402,13435,9
Task 13403,Job 0,1,6,2,7,0,3,8,5,2,3,2,13403,13437,17
Task 13403,Job 1,6,4,3,9,1,9,15,6,3,4,2,13403,13437,13
Task 13404,Job 0,8,7,3,9,0,11,17,6,3,3,2,13404,13437,17
Task 13404,Job 1,13,7,1,6,0,14,19,5,1,2,1,13404,13437,15
Task 13405,Job 0,7,4,4,7,0,11,14,3,4,3,2,13405,13438,2
Task 13405,Job 1,12,4,2,10,1,14,22,8,2,1,0,13405,13438,16
Task 13406,Job 0,6,10,3,10,0,9,16,7,3,1,2,13406,13439,3
Task 13406,Job 1,11,7,3,10,1,14,21,7,3,3,2,13406,13439,2
Task 13407,Job 0,3,9,3,10,1,6,13,7,3,4,0,13407,13440,10
Task 13407,Job 1,8,8,3,8,0,11,16,5,3,2,1,13407,13440,12
Task 13408,Job 0,2,6,3,8,0,5,10,5,3,3,2,13408,13441,16
Task 13408,Job 1,7,9,3,6,0,10,13,3,3,3,2,13408,13441,10
Task 13409,Job 0,7,9,4,11,0,11,18,7,4,4,1,13409,13442,4
Task 13409,Job 1,12,9,2,6,0,14,18,4,2,1,1,13409,13442,19
Task 13410,Job 0,9,9,2,6,1,11,15,4,2,4,0,13410,13444,10
Task 13410,Job 1,14,5,2,8,1,16,22,6,2,4,0,13410,13444,19
Task 13411,Job 0,2,4,3,11,0,5,13,8,3,1,1,13411,13445,16
Task 13411,Job 1,7,9,3,8,0,10,15,5,3,2,1,13411,13445,4
Task 13412,Job 0,5,9,2,10,1,7,15,8,2,3,1,13412,13446,2
Task 13412,Job 1,10,9,2,8,1,12,18,6,2,3,1,13412,13446,15
Task 13413,Job 0,6,10,1,10,0,7,16,9,1,4,2,13413,13447,14
Task 13413,Job 1,11,10,1,7,0,12,18,6,1,3,0,13413,13447,8
Task 13414,Job 0,2,10,1,9,0,3,11,8,1,3,1,13414,13448,18
Task 13414,Job 1,7,5,2,11,0,9,18,9,2,3,0,13414,13448,7
Task 13415,Job 0,2,4,3,11,0,5,13,8,3,4,2,13415,13448,10
Task 13415,Job 1,7,7,1,12,1,8,19,11,1,3,0,13415,13448,16
Task 13416,Job 0,5,8,2,6,0,7,11,4,2,2,0,13416,13450,6
Task 13416,Job 1,10,9,1,10,0,11,20,9,1,1,2,13416,13450,5
Task 13417,Job 0,3,9,1,12,0,4,15,11,1,2,2,13417,13450,20
Task 13417,Job 1,8,10,4,12,0,12,20,8,4,4,1,13417,13450,14
Task 13418,Job 0,4,7,1,8,0,5,12,7,1,1,1,13418,13452,20
Task 13418,Job 1,9,9,3,12,0,12,21,9,3,3,0,13418,13452,13
Task 13419,Job 0,4,9,3,7,0,7,11,4,3,3,1,13419,13452,15
Task 13419,Job 1,9,6,1,12,0,10,21,11,1,4,2,13419,13452,13
Task 13420,Job 0,10,10,4,8,0,14,18,4,4,1,0,13420,13454,3
Task 13420,Job 1,15,10,3,12,1,18,27,9,3,4,0,13420,13454,18
Task 13421,Job 0,3,10,1,11,0,4,14,10,1,4,0,13421,13454,14
Task 13421,Job 1,8,9,4,7,0,12,15,3,4,2,0,13421,13454,9
Task 13422,Job 0,6,5,2,7,0,8,13,5,2,2,1,13422,13455,4
Task 13422,Job 1,11,9,3,6,0,14,17,3,3,4,1,13422,13455,20
Task 13423,Job 0,1,7,2,6,0,3,7,4,2,4,2,13423,13456,2
Task 13423,Job 1,6,9,2,7,0,8,13,5,2,1,1,13423,13456,16
Task 13424,Job 0,10,8,3,7,0,13,17,4,3,3,1,13424,13457,19
Task 13424,Job 1,15,5,2,9,1,17,24,7,2,2,1,13424,13457,10
Task 13425,Job 0,4,6,1,10,0,5,14,9,1,3,2,13425,13458,11
Task 13425,Job 1,9,9,1,11,0,10,20,10,1,4,0,13425,13458,9
Task 13426,Job 0,2,9,3,6,0,5,8,3,3,1,0,13426,13459,10
Task 13426,Job 1,7,7,1,11,1,8,18,10,1,1,2,13426,13459,4
Task 13427,Job 0,4,8,2,9,0,6,13,7,2,4,2,13427,13460,10
Task 13427,Job 1,9,7,3,9,1,12,18,6,3,3,2,13427,13460,10
Task 13428,Job 0,8,10,3,9,0,11,17,6,3,4,2,13428,13461,9
Task 13428,Job 1,13,5,1,8,0,14,21,7,1,2,2,13428,13461,10
Task 13429,Job 0,4,6,1,8,0,5,12,7,1,2,2,13429,13462,7
Task 13429,Job 1,9,8,1,9,0,10,18,8,1,1,1,13429,13462,9
Task 13430,Job 0,9,6,2,12,0,11,21,10,2,1,1,13430,13463,12
Task 13430,Job 1,14,4,2,12,0,16,26,10,2,3,1,13430,13463,8
Task 13431,Job 0,4,10,3,9,0,7,13,6,3,2,2,13431,13465,6
Task 13431,Job 1,9,6,1,9,0,10,18,8,1,3,0,13431,13465,16
Task 13432,Job 0,5,7,3,9,0,8,14,6,3,2,1,13432,13465,15
Task 13432,Job 1,10,7,1,6,1,11,16,5,1,2,2,13432,13465,12
Task 13433,Job 0,4,6,3,10,1,7,14,7,3,1,1,13433,13467,16
Task 13433,Job 1,9,10,1,6,0,10,15,5,1,3,2,13433,13467,17
Task 13434,Job 0,8,5,2,6,0,10,14,4,2,2,2,13434,13467,10
Task 13434,Job 1,13,6,3,10,1,16,23,7,3,4,1,13434,13467,7
Task 13435,Job 0,10,5,4,6,0,14,16,2,4,2,2,13435,13469,16
Task 13435,Job 1,15,5,3,9,1,18,24,6,3,3,0,13435,13469,14
Task 13436,Job 0,8,5,2,12,0,10,20,10,2,1,2,13436,13470,19
Task 13436,Job 1,13,4,4,10,0,17,23,6,4,3,1,13436,13470,12
Task 13437,Job 0,9,5,1,6,0,10,15,5,1,1,2,13437,13471,20
Task 13437,Job 1,14,4,1,8,1,15,22,7,1,4,0,13437,13471,4
Task 13438,Job 0,9,7,1,12,0,10,21,11,1,4,1,13438,13472,17
Task 13438,Job 1,14,4,1,7,0,15,21,6,1,3,1,13438,13472,6
Task 13439,Job 0,4,10,2,6,0,6,10,4,2,3,0,13439,13473,9
Task 13439,Job 1,9,5,2,6,1,11,15,4,2,4,0,13439,13473,11
Task 13440,Job 0,9,6,1,8,0,10,17,7,1,4,0,13440,13473,4
Task 13440,Job 1,14,6,2,8,1,16,22,6,2,4,2,13440,13473,20
Task 13441,Job 0,8,4,1,7,1,9,15,6,1,3,0,13441,13475,8
Task 13441,Job 1,13,10,3,9,0,16,22,6,3,2,1,13441,13475,20
Task 13442,Job 0,8,8,2,7,0,10,15,5,2,3,2,13442,13476,16
Task 13442,Job 1,13,10,4,9,1,17,22,5,4,4,1,13442,13476,10
Task 13443,Job 0,2,10,4,7,0,6,9,3,4,4,2,13443,13476,4
Task 13443,Job 1,7,5,2,10,0,9,17,8,2,2,1,13443,13476,13
Task 13444,Job 0,4,8,1,6,0,5,10,5,1,2,0,13444,13478,12
Task 13444,Job 1,9,8,1,6,1,10,15,5,1,4,1,13444,13478,12
Task 13445,Job 0,4,10,3,6,1,7,10,3,3,2,2,13445,13478,7
Task 13445,Job 1,9,9,4,8,0,13,17,4,4,1,2,13445,13478,7
Task 13446,Job 0,5,9,2,9,1,7,14,7,2,2,2,13446,13479,8
Task 13446,Job 1,10,8,1,10,0,11,20,9,1,4,0,13446,13479,15
Task 13447,Job 0,8,7,2,12,1,10,20,10,2,3,1,13447,13480,14
Task 13447,Job 1,13,9,1,6,0,14,19,5,1,2,1,13447,13480,18
Task 13448,Job 0,9,10,2,11,1,11,20,9,2,4,2,13448,13482,19
Task 13448,Job 1,14,5,1,11,1,15,25,10,1,4,1,13448,13482,11
Task 13449,Job 0,5,9,3,10,0,8,15,7,3,1,1,13449,13483,11
Task 13449,Job 1,10,5,4,7,0,14,17,3,4,3,1,13449,13483,8
Task 13450,Job 0,10,8,1,12,0,11,22,11,1,4,1,13450,13483,19
Task 13450,Job 1,15,5,1,11,1,16,26,10,1,1,1,13450,13483,12
Task 13451,Job 0,1,6,1,6,1,2,7,5,1,3,1,13451,13484,13
Task 13451,Job 1,6,7,2,12,1,8,18,10,2,1,2,13451,13484,4
Task 13452,Job 0,7,10,2,7,1,9,14,5,2,1,0,13452,13485,4
Task 13452,Job 1,12,6,3,10,1,15,22,7,3,4,2,13452,13485,18
Task 13453,Job 0,6,10,1,11,0,7,17,10,1,1,1,13453,13486,12
Task 13453,Job 1,11,5,4,6,1,15,17,2,4,1,2,13453,13486,19
Task 13454,Job 0,7,7,3,6,0,10,13,3,3,1,2,13454,13488,19
Task 13454,Job 1,12,5,3,12,0,15,24,9,3,4,1,13454,13488,15
Task 13455,Job 0,9,8,2,12,0,11,21,10,2,3,1,13455,13488,14
Task 13455,Job 1,14,9,2,7,0,16,21,5,2,2,2,13455,13488,17
Task 13456,Job 0,5,8,1,11,1,6,16,10,1,2,0,13456,13490,14
Task 13456,Job 1,10,5,4,11,0,14,21,7,4,4,1,13456,13490,15
Task 13457,Job 0,9,5,3,12,0,12,21,9,3,2,0,13457,13491,10
Task 13457,Job 1,14,9,2,9,0,16,23,7,2,3,0,13457,13491,10
Task 13458,Job 0,4,10,4,7,0,8,11,3,4,3,1,13458,13491,19
Task 13458,Job 1,9,7,3,10,0,12,19,7,3,4,2,13458,13491,17
Task 13459,Job 0,2,6,2,10,1,4,12,8,2,1,0,13459,13492,19
Task 13459,Job 1,7,7,1,6,0,8,13,5,1,4,1,13459,13492,18
Task 13460,Job 0,5,6,4,6,0,9,11,2,4,2,0,13460,13493,20
Task 13460,Job 1,10,10,3,9,0,13,19,6,3,1,1,13460,13493,10
Task 13461,Job 0,8,7,2,12,1,10,20,10,2,1,2,13461,13495,16
Task 13461,Job 1,13,4,3,12,1,16,25,9,3,2,2,13461,13495,19
Task 13462,Job 0,1,7,4,12,0,5,13,8,4,3,1,13462,13495,2
Task 13462,Job 1,6,4,1,9,0,7,15,8,1,2,2,13462,13495,16
Task 13463,Job 0,4,9,3,8,0,7,12,5,3,2,1,13463,13496,3
Task 13463,Job 1,9,9,2,11,1,11,20,9,2,4,0,13463,13496,9
Task 13464,Job 0,7,6,2,12,0,9,19,10,2,2,2,13464,13498,6
Task 13464,Job 1,12,10,2,12,0,14,24,10,2,3,2,13464,13498,15
Task 13465,Job 0,2,6,1,6,0,3,8,5,1,1,1,13465,13498,6
Task 13465,Job 1,7,8,2,7,0,9,14,5,2,1,2,13465,13498,16
Task 13466,Job 0,4,10,1,11,0,5,15,10,1,1,0,13466,13500,19
Task 13466,Job 1,9,7,3,10,0,12,19,7,3,3,0,13466,13500,5
Task 13467,Job 0,2,5,3,11,1,5,13,8,3,2,0,13467,13500,4
Task 13467,Job 1,7,7,4,12,0,11,19,8,4,4,1,13467,13500,12
Task 13468,Job 0,5,6,3,6,1,8,11,3,3,4,0,13468,13502,17
Task 13468,Job 1,10,4,2,12,0,12,22,10,2,3,1,13468,13502,17
Task 13469,Job 0,10,9,2,11,0,12,21,9,2,3,2,13469,13503,3
Task 13469,Job 1,15,7,1,9,0,16,24,8,1,3,2,13469,13503,8
Task 13470,Job 0,6,7,2,6,0,8,12,4,2,2,0,13470,13503,7
Task 13470,Job 1,11,7,3,6,1,14,17,3,3,2,2,13470,13503,2
Task 13471,Job 0,4,10,4,7,0,8,11,3,4,4,1,13471,13505,17
Task 13471,Job 1,9,10,2,7,1,11,16,5,2,4,2,13471,13505,2
Task 13472,Job 0,2,8,3,7,0,5,9,4,3,4,2,13472,13505,18
Task 13472,Job 1,7,7,2,11,1,9,18,9,2,2,1,13472,13505,2
Task 13473,Job 0,1,9,1,11,0,2,12,10,1,3,1,13473,13507,15
Task 13473,Job 1,6,5,1,11,0,7,17,10,1,1,0,13473,13507,2
Task 13474,Job 0,5,5,1,10,0,6,15,9,1,2,1,13474,13507,11
Task 13474,Job 1,10,4,2,12,0,12,22,10,2,3,2,13474,13507,16
Task 13475,Job 0,7,9,1,8,0,8,15,7,1,3,2,13475,13508,6
Task 13475,Job 1,12,7,1,10,0,13,22,9,1,1,2,13475,13508,10
Task 13476,Job 0,1,5,2,8,1,3,9,6,2,1,0,13476,13510,3
Task 13476,Job 1,6,4,4,10,0,10,16,6,4,4,1,13476,13510,17
Task 13477,Job 0,5,4,2,8,0,7,13,6,2,3,2,13477,13510,4
Task 13477,Job 1,10,4,4,9,0,14,19,5,4,4,1,13477,13510,9
Task 13478,Job 0,10,4,3,6,0,13,16,3,3,1,2,13478,13511,17
Task 13478,Job 1,15,8,2,12,1,17,27,10,2,2,0,13478,13511,6
Task 13479,Job 0,5,5,1,12,0,6,17,11,1,4,2,13479,13512,4
Task 13479,Job 1,10,10,1,8,1,11,18,7,1,3,0,13479,13512,2
Task 13480,Job 0,8,7,4,11,1,12,19,7,4,4,0,13480,13514,9
Task 13480,Job 1,13,10,3,8,0,16,21,5,3,1,2,13480,13514,12
Task 13481,Job 0,9,10,2,11,0,11,20,9,2,2,0,13481,13515,20
Task 13481,Job 1,14,8,2,11,0,16,25,9,2,2,2,13481,13515,3
Task 13482,Job 0,10,9,1,9,1,11,19,8,1,1,2,13482,13515,8
Task 13482,Job 1,15,8,3,9,1,18,24,6,3,4,2,13482,13515,17
Task 13483,Job 0,9,9,1,10,1,10,19,9,1,2,0,13483,13516,20
Task 13483,Job 1,14,7,2,10,1,16,24,8,2,3,0,13483,13516,9
Task 13484,Job 0,7,8,4,11,1,11,18,7,4,1,1,13484,13517,11
Task 13484,Job 1,12,6,4,8,1,16,20,4,4,4,2,13484,13517,5
Task 13485,Job 0,5,7,3,8,1,8,13,5,3,4,2,13485,13519,18
Task 13485,Job 1,10,4,3,11,0,13,21,8,3,3,0,13485,13519,17
Task 13486,Job 0,3,6,2,12,0,5,15,10,2,3,0,13486,13519,3
Task 13486,Job 1,8,4,4,6,0,12,14,2,4,2,2,13486,13519,12
Task 13487,Job 0,10,5,2,9,0,12,19,7,2,4,2,13487,13521,8
Task 13487,Job 1,15,9,1,12,0,16,27,11,1,2,2,13487,13521,20
Task 13488,Job 0,3,10,3,6,0,6,9,3,3,3,2,13488,13522,15
Task 13488,Job 1,8,5,3,8,0,11,16,5,3,3,1,13488,13522,11
Task 13489,Job 0,3,9,3,12,0,6,15,9,3,4,1,13489,13522,20
Task 13489,Job 1,8,8,3,11,1,11,19,8,3,3,1,13489,13522,11
Task 13490,Job 0,2,4,4,10,1,6,12,6,4,2,1,13490,13523,10
Task 13490,Job 1,7,5,4,7,0,11,14,3,4,3,2,13490,13523,14
Task 13491,Job 0,7,6,2,11,0,9,18,9,2,4,0,13491,13525,11
Task 13491,Job 1,12,4,2,11,0,14,23,9,2,3,0,13491,13525,13
Task 13492,Job 0,2,10,4,12,0,6,14,8,4,3,1,13492,13525,8
Task 13492,Job 1,7,6,2,7,0,9,14,5,2,4,2,13492,13525,13
Task 13493,Job 0,8,8,1,8,0,9,16,7,1,4,1,13493,13527,17
Task 13493,Job 1,13,7,1,9,0,14,22,8,1,2,2,13493,13527,11
Task 13494,Job 0,2,8,4,7,0,6,9,3,4,2,2,13494,13528,13
Task 13494,Job 1,7,7,1,10,0,8,17,9,1,3,0,13494,13528,17
Task 13495,Job 0,9,9,4,11,1,13,20,7,4,1,1,13495,13528,9
Task 13495,Job 1,14,9,3,12,0,17,26,9,3,3,1,13495,13528,7
Task 13496,Job 0,4,7,1,8,0,5,12,7,1,1,2,13496,13529,11
Task 13496,Job 1,9,5,4,12,1,13,21,8,4,4,0,13496,13529,11
Task 13497,Job 0,2,9,3,10,0,5,12,7,3,4,2,13497,13530,16
Task 13497,Job 1,7,4,2,12,0,9,19,10,2,1,0,13497,13530,12
Task 13498,Job 0,1,4,4,10,0,5,11,6,4,3,1,13498,13531,9
Task 13498,Job 1,6,5,1,7,0,7,13,6,1,2,1,13498,13531,15
Task 13499,Job 0,2,10,3,8,0,5,10,5,3,3,0,13499,13533,19
Task 13499,Job 1,7,8,3,9,0,10,16,6,3,1,1,13499,13533,10
Task 13500,Job 0,1,10,2,11,0,3,12,9,2,3,0,13500,13534,17
Task 13500,Job 1,6,6,3,9,0,9,15,6,3,4,0,13500,13534,8
Task 13501,Job 0,1,9,2,11,0,3,12,9,2,4,0,13501,13535,19
Task 13501,Job 1,6,9,1,12,1,7,18,11,1,4,2,13501,13535,15
Task 13502,Job 0,6,10,3,10,1,9,16,7,3,3,1,13502,13535,6
Task 13502,Job 1,11,10,3,12,0,14,23,9,3,4,2,13502,13535,20
Task 13503,Job 0,7,6,2,11,0,9,18,9,2,4,2,13503,13537,8
Task 13503,Job 1,12,5,4,12,0,16,24,8,4,1,0,13503,13537,13
Task 13504,Job 0,2,9,1,9,0,3,11,8,1,3,1,13504,13537,14
Task 13504,Job 1,7,8,4,8,0,11,15,4,4,3,1,13504,13537,8
Task 13505,Job 0,8,6,3,7,0,11,15,4,3,3,1,13505,13538,3
Task 13505,Job 1,13,6,3,10,1,16,23,7,3,1,1,13505,13538,8
Task 13506,Job 0,10,10,1,11,0,11,21,10,1,3,0,13506,13539,17
Task 13506,Job 1,15,4,3,9,1,18,24,6,3,2,0,13506,13539,16
Task 13507,Job 0,7,6,2,8,0,9,15,6,2,3,1,13507,13541,6
Task 13507,Job 1,12,7,1,8,0,13,20,7,1,1,2,13507,13541,10
Task 13508,Job 0,1,10,2,11,1,3,12,9,2,3,0,13508,13542,2
Task 13508,Job 1,6,5,1,12,0,7,18,11,1,1,0,13508,13542,15
Task 13509,Job 0,7,4,2,8,0,9,15,6,2,2,0,13509,13542,19
Task 13509,Job 1,12,5,3,8,0,15,20,5,3,3,2,13509,13542,19
Task 13510,Job 0,5,5,3,9,0,8,14,6,3,1,1,13510,13544,9
Task 13510,Job 1,10,8,1,7,0,11,17,6,1,2,0,13510,13544,19
Task 13511,Job 0,5,10,2,6,0,7,11,4,2,4,1,13511,13545,13
Task 13511,Job 1,10,10,4,6,1,14,16,2,4,3,2,13511,13545,20
Task 13512,Job 0,10,9,4,12,0,14,22,8,4,3,2,13512,13546,18
Task 13512,Job 1,15,5,3,8,0,18,23,5,3,4,1,13512,13546,13
Task 13513,Job 0,1,10,2,10,1,3,11,8,2,4,2,13513,13546,18
Task 13513,Job 1,6,6,4,12,0,10,18,8,4,3,2,13513,13546,5
Task 13514,Job 0,1,5,3,12,0,4,13,9,3,2,0,13514,13547,17
Task 13514,Job 1,6,6,4,11,0,10,17,7,4,3,2,13514,13547,13
Task 13515,Job 0,7,4,4,8,0,11,15,4,4,4,2,13515,13548,16
Task 13515,Job 1,12,8,4,6,1,16,18,2,4,4,2,13515,13548,8
Task 13516,Job 0,10,7,3,8,0,13,18,5,3,3,1,13516,13549,11
Task 13516,Job 1,15,6,4,11,0,19,26,7,4,4,1,13516,13549,12
Task 13517,Job 0,2,4,4,8,1,6,10,4,4,4,2,13517,13550,3
Task 13517,Job 1,7,9,4,11,1,11,18,7,4,2,1,13517,13550,17
Task 13518,Job 0,10,6,2,9,1,12,19,7,2,1,0,13518,13551,15
Task 13518,Job 1,15,5,4,8,0,19,23,4,4,1,1,13518,13551,6
Task 13519,Job 0,6,9,1,6,0,7,12,5,1,4,1,13519,13552,11
Task 13519,Job 1,11,8,4,11,0,15,22,7,4,1,1,13519,13552,7
Task 13520,Job 0,6,5,3,10,0,9,16,7,3,4,2,13520,13554,14
Task 13520,Job 1,11,10,2,12,0,13,23,10,2,1,0,13520,13554,18
Task 13521,Job 0,3,6,4,12,0,7,15,8,4,3,0,13521,13555,8
Task 13521,Job 1,8,4,2,11,0,10,19,9,2,2,2,13521,13555,9
Task 13522,Job 0,8,5,3,11,1,11,19,8,3,4,0,13522,13555,6
Task 13522,Job 1,13,4,3,6,1,16,19,3,3,1,2,13522,13555,19
Task 13523,Job 0,9,6,3,11,0,12,20,8,3,2,0,13523,13556,17
Task 13523,Job 1,14,7,4,8,0,18,22,4,4,4,0,13523,13556,15
Task 13524,Job 0,8,8,4,8,0,12,16,4,4,2,1,13524,13557,16
Task 13524,Job 1,13,4,3,12,0,16,25,9,3,3,2,13524,13557,11
Task 13525,Job 0,3,10,3,7,0,6,10,4,3,1,0,13525,13558,6
Task 13525,Job 1,8,7,4,6,0,12,14,2,4,4,2,13525,13558,2
Task 13526,Job 0,1,5,4,11,0,5,12,7,4,3,0,13526,13559,8
Task 13526,Job 1,6,10,4,10,0,10,16,6,4,2,0,13526,13559,9
Task 13527,Job 0,10,9,3,7,0,13,17,4,3,3,0,13527,13561,5
Task 13527,Job 1,15,7,1,10,0,16,25,9,1,2,0,13527,13561,13
Task 13528,Job 0,3,4,2,12,1,5,15,10,2,2,0,13528,13561,13
Task 13528,Job 1,8,6,2,11,0,10,19,9,2,1,2,13528,13561,2
Task 13529,Job 0,2,9,1,12,0,3,14,11,1,1,2,13529,13562,11
Task 13529,Job 1,7,9,4,9,0,11,16,5,4,3,0,13529,13562,13
Task 13530,Job 0,5,6,3,10,0,8,15,7,3,4,0,13530,13563,11
Task 13530,Job 1,10,6,4,6,0,14,16,2,4,1,2,13530,13563,5
Task 13531,Job 0,2,5,1,7,1,3,9,6,1,2,0,13531,13565,5
Task 13531,Job 1,7,6,3,12,0,10,19,9,3,2,2,13531,13565,11
Task 13532,Job 0,8,9,2,12,1,10,20,10,2,4,1,13532,13565,4
Task 13532,Job 1,13,7,2,11,0,15,24,9,2,2,0,13532,13565,17
Task 13533,Job 0,10,6,4,12,0,14,22,8,4,3,2,13533,13566,16
Task 13533,Job 1,15,5,2,7,0,17,22,5,2,2,1,13533,13566,17
Task 13534,Job 0,6,8,4,6,0,10,12,2,4,1,2,13534,13568,15
Task 13534,Job 1,11,8,1,8,0,12,19,7,1,1,1,13534,13568,10
Task 13535,Job 0,8,5,1,12,1,9,20,11,1,3,2,13535,13569,13
Task 13535,Job 1,13,5,1,7,1,14,20,6,1,3,1,13535,13569,6
Task 13536,Job 0,5,9,4,9,0,9,14,5,4,1,0,13536,13570,17
Task 13536,Job 1,10,9,4,6,1,14,16,2,4,2,0,13536,13570,14
Task 13537,Job 0,2,10,2,10,0,4,12,8,2,1,2,13537,13571,13
Task 13537,Job 1,7,4,1,7,0,8,14,6,1,4,2,13537,13571,12
Task 13538,Job 0,5,5,4,9,0,9,14,5,4,3,0,13538,13571,18
Task 13538,Job 1,10,7,1,9,1,11,19,8,1,3,0,13538,13571,19
Task 13539,Job 0,8,4,4,9,1,12,17,5,4,1,1,13539,13572,9
Task 13539,Job 1,13,5,1,8,0,14,21,7,1,3,0,13539,13572,11
Task 13540,Job 0,9,10,4,9,1,13,18,5,4,3,2,13540,13573,19
Task 13540,Job 1,14,5,3,10,0,17,24,7,3,1,2,13540,13573,6
Task 13541,Job 0,6,9,2,6,0,8,12,4,2,4,2,13541,13575,19
Task 13541,Job 1,11,5,3,10,0,14,21,7,3,1,0,13541,13575,6
Task 13542,Job 0,5,10,1,7,0,6,12,6,1,4,2,13542,13575,3
Task 13542,Job 1,10,7,3,9,1,13,19,6,3,4,0,13542,13575,11
Task 13543,Job 0,2,5,3,10,1,5,12,7,3,2,0,13543,13577,6
Task 13543,Job 1,7,9,4,8,1,11,15,4,4,2,0,13543,13577,7
Task 13544,Job 0,6,7,3,8,0,9,14,5,3,3,1,13544,13578,4
Task 13544,Job 1,11,8,1,12,1,12,23,11,1,2,1,13544,13578,13
Task 13545,Job 0,1,10,4,11,1,5,12,7,4,2,2,13545,13578,9
Task 13545,Job 1,6,4,1,11,0,7,17,10,1,2,0,13545,13578,19
Task 13546,Job 0,10,5,1,9,0,11,19,8,1,3,2,13546,13580,10
Task 13546,Job 1,15,10,3,10,1,18,25,7,3,3,1,13546,13580,9
Task 13547,Job 0,8,7,4,8,0,12,16,4,4,3,2,13547,13580,9
Task 13547,Job 1,13,4,4,9,0,17,22,5,4,1,1,13547,13580,9
Task 13548,Job 0,1,7,1,12,0,2,13,11,1,2,2,13548,13582,4
Task 13548,Job 1,6,9,1,10,0,7,16,9,1,1,2,13548,13582,6
Task 13549,Job 0,3,5,4,9,0,7,12,5,4,3,0,13549,13582,4
Task 13549,Job 1,8,7,2,8,1,10,16,6,2,4,1,13549,13582,16
Task 13550,Job 0,10,6,2,11,0,12,21,9,2,3,2,13550,13583,13
Task 13550,Job 1,15,8,2,6,0,17,21,4,2,4,1,13550,13583,12
Task 13551,Job 0,6,7,4,12,1,10,18,8,4,1,2,13551,13585,9
Task 13551,Job 1,11,6,2,11,0,13,22,9,2,4,0,13551,13585,9
Task 13552,Job 0,4,7,1,9,0,5,13,8,1,4,1,13552,13586,15
Task 13552,Job 1,9,8,1,12,0,10,21,11,1,4,0,13552,13586,16
Task 13553,Job 0,2,8,3,6,1,5,8,3,3,1,1,13553,13587,2
Task 13553,Job 1,7,10,2,9,0,9,16,7,2,1,2,13553,13587,7
Task 13554,Job 0,1,4,1,8,1,2,9,7,1,1,0,13554,13588,16
Task 13554,Job 1,6,10,2,9,1,8,15,7,2,4,2,13554,13588,14
Task 13555,Job 0,9,6,3,6,1,12,15,3,3,3,1,13555,13588,18
Task 13555,Job 1,14,9,4,12,0,18,26,8,4,4,0,13555,13588,4
Task 13556,Job 0,2,10,2,12,0,4,14,10,2,1,2,13556,13589,6
Task 13556,Job 1,7,10,4,6,0,11,13,2,4,1,1,13556,13589,6
Task 13557,Job 0,8,7,2,9,0,10,17,7,2,1,1,13557,13591,11
Task 13557,Job 1,13,8,1,12,0,14,25,11,1,4,1,13557,13591,12
Task 13558,Job 0,5,4,2,11,0,7,16,9,2,4,0,13558,13591,7
Task 13558,Job 1,10,6,2,9,0,12,19,7,2,1,2,13558,13591,8
Task 13559,Job 0,7,4,4,11,0,11,18,7,4,2,0,13559,13592,16
Task 13559,Job 1,12,7,4,11,1,16,23,7,4,2,0,13559,13592,8
Task 13560,Job 0,10,4,1,8,0,11,18,7,1,1,1,13560,13593,8
Task 13560,Job 1,15,7,1,12,0,16,27,11,1,1,0,13560,13593,16
Task 13561,Job 0,5,10,4,11,0,9,16,7,4,2,1,13561,13594,5
Task 13561,Job 1,10,5,1,8,1,11,18,7,1,2,0,13561,13594,15
Task 13562,Job 0,8,5,3,7,0,11,15,4,3,2,0,13562,13595,13
Task 13562,Job 1,13,6,2,7,0,15,20,5,2,2,2,13562,13595,16
Task 13563,Job 0,5,7,4,7,0,9,12,3,4,1,2,13563,13597,6
Task 13563,Job 1,10,5,4,11,0,14,21,7,4,4,1,13563,13597,7
Task 13564,Job 0,9,6,4,7,0,13,16,3,4,4,0,13564,13597,17
Task 13564,Job 1,14,4,1,8,0,15,22,7,1,2,1,13564,13597,10
Task 13565,Job 0,1,7,1,12,0,2,13,11,1,2,2,13565,13598,4
Task 13565,Job 1,6,10,4,9,0,10,15,5,4,2,2,13565,13598,19
Task 13566,Job 0,2,8,1,11,0,3,13,10,1,2,2,13566,13599,12
Task 13566,Job 1,7,7,2,8,0,9,15,6,2,4,1,13566,13599,15
Task 13567,Job 0,2,6,3,7,1,5,9,4,3,3,1,13567,13601,14
Task 13567,Job 1,7,4,2,12,1,9,19,10,2,2,1,13567,13601,19
Task 13568,Job 0,9,6,3,6,1,12,15,3,3,3,2,13568,13602,9
Task 13568,Job 1,14,8,1,6,0,15,20,5,1,3,2,13568,13602,3
Task 13569,Job 0,2,9,2,12,0,4,14,10,2,2,1,13569,13603,18
Task 13569,Job 1,7,4,1,11,0,8,18,10,1,1,1,13569,13603,6
Task 13570,Job 0,4,8,2,9,0,6,13,7,2,3,2,13570,13604,10
Task 13570,Job 1,9,6,3,10,1,12,19,7,3,2,0,13570,13604,8
Task 13571,Job 0,3,9,4,8,0,7,11,4,4,2,0,13571,13605,5
Task 13571,Job 1,8,9,3,12,0,11,20,9,3,1,1,13571,13605,3
Task 13572,Job 0,9,9,3,8,0,12,17,5,3,2,2,13572,13605,10
Task 13572,Job 1,14,8,2,12,0,16,26,10,2,4,1,13572,13605,4
Task 13573,Job 0,7,9,3,10,1,10,17,7,3,4,2,13573,13606,19
Task 13573,Job 1,12,9,1,10,0,13,22,9,1,3,2,13573,13606,8
Task 13574,Job 0,9,10,3,8,1,12,17,5,3,3,0,13574,13608,10
Task 13574,Job 1,14,6,3,8,0,17,22,5,3,3,2,13574,13608,14
Task 13575,Job 0,2,5,2,12,0,4,14,10,2,3,0,13575,13609,19
Task 13575,Job 1,7,8,2,9,0,9,16,7,2,3,2,13575,13609,16
Task 13576,Job 0,5,7,4,11,0,9,16,7,4,4,0,13576,13610,20
Task 13576,Job 1,10,9,1,9,0,11,19,8,1,3,1,13576,13610,16
Task 13577,Job 0,9,6,2,11,0,11,20,9,2,2,0,13577,13610,16
Task 13577,Job 1,14,10,2,6,1,16,20,4,2,2,2,13577,13610,15
Task 13578,Job 0,5,9,2,8,0,7,13,6,2,4,2,13578,13611,2
Task 13578,Job 1,10,8,2,6,0,12,16,4,2,2,1,13578,13611,6
Task 13579,Job 0,5,9,1,7,1,6,12,6,1,4,1,13579,13613,17
Task 13579,Job 1,10,4,2,8,0,12,18,6,2,2,0,13579,13613,5
Task 13580,Job 0,8,4,2,11,0,10,19,9,2,3,0,13580,13614,2
Task 13580,Job 1,13,7,1,11,0,14,24,10,1,2,2,13580,13614,14
Task 13581,Job 0,5,10,4,12,0,9,17,8,4,3,0,13581,13615,6
Task 13581,Job 1,10,5,2,7,1,12,17,5,2,1,0,13581,13615,3
Task 13582,Job 0,9,8,1,9,0,10,18,8,1,4,1,13582,13616,15
Task 13582,Job 1,14,9,1,8,1,15,22,7,1,2,2,13582,13616,20
Task 13583,Job 0,4,8,4,10,0,8,14,6,4,4,0,13583,13616,20
Task 13583,Job 1,9,9,2,11,1,11,20,9,2,1,1,13583,13616,19
Task 13584,Job 0,2,9,3,10,0,5,12,7,3,1,0,13584,13618,3
Task 13584,Job 1,7,4,4,6,0,11,13,2,4,4,1,13584,13618,15
Task 13585,Job 0,10,7,3,12,0,13,22,9,3,1,0,13585,13618,10
Task 13585,Job 1,15,6,1,7,0,16,22,6,1,3,2,13585,13618,13
Task 13586,Job 0,5,7,4,11,0,9,16,7,4,3,1,13586,13620,5
Task 13586,Job 1,10,8,3,7,0,13,17,4,3,3,2,13586,13620,19
Task 13587,Job 0,7,10,2,9,1,9,16,7,2,3,2,13587,13620,12
Task 13587,Job 1,12,7,1,7,0,13,19,6,1,2,2,13587,13620,17
Task 13588,Job 0,4,4,3,6,0,7,10,3,3,1,0,13588,13621,18
Task 13588,Job 1,9,5,3,6,0,12,15,3,3,1,1,13588,13621,20
Task 13589,Job 0,10,7,2,12,0,12,22,10,2,4,1,13589,13623,7
Task 13589,Job 1,15,4,4,6,1,19,21,2,4,4,1,13589,13623,9
Task 13590,Job 0,3,7,1,7,0,4,10,6,1,1,1,13590,13623,17
Task 13590,Job 1,8,8,4,11,0,12,19,7,4,2,0,13590,13623,13
Task 13591,Job 0,8,8,1,6,0,9,14,5,1,4,1,13591,13624,8
Task 13591,Job 1,13,4,2,11,0,15,24,9,2,4,2,13591,13624,5
Task 13592,Job 0,10,6,3,9,0,13,19,6,3,1,2,13592,13625,6
Task 13592,Job 1,15,8,3,11,0,18,26,8,3,2,1,13592,13625,5
Task 13593,Job 0,6,8,2,8,0,8,14,6,2,4,2,13593,13627,15
Task 13593,Job 1,11,8,2,8,0,13,19,6,2,3,1,13593,13627,13
Task 13594,Job 0,4,9,1,9,0,5,13,8,1,4,0,13594,13627,14
Task 13594,Job 1,9,10,1,9,1,10,18,8,1,1,2,13594,13627,4
Task 13595,Job 0,9,6,2,9,0,11,18,7,2,1,1,13595,13629,5
Task 13595,Job 1,14,4,3,10,1,17,24,7,3,4,2,13595,13629,16
Task 13596,Job 0,10,7,3,10,1,13,20,7,3,2,1,13596,13629,2
Task 13596,Job 1,15,7,2,11,0,17,26,9,2,1,0,13596,13629,17
Task 13597,Job 0,8,6,3,11,0,11,19,8,3,3,2,13597,13631,4
Task 13597,Job 1,13,8,3,11,1,16,24,8,3,4,1,13597,13631,18
Task 13598,Job 0,7,4,2,11,1,9,18,9,2,4,2,13598,13631,16
Task 13598,Job 1,12,9,1,6,1,13,18,5,1,4,1,13598,13631,12
Task 13599,Job 0,2,5,1,9,0,3,11,8,1,3,0,13599,13633,3
Task 13599,Job 1,7,7,3,8,0,10,15,5,3,1,2,13599,13633,16
Task 13600,Job 0,8,4,3,12,0,11,20,9,3,3,1,13600,13634,5
Task 13600,Job 1,13,5,1,12,0,14,25,11,1,2,2,13600,13634,7
Task 13601,Job 0,5,8,2,9,0,7,14,7,2,4,2,13601,13634,7
Task 13601,Job 1,10,10,4,9,0,14,19,5,4,4,2,13601,13634,17
Task 13602,Job 0,10,7,3,12,0,13,22,9,3,2,0,13602,13636,8
Task 13602,Job 1,15,7,4,12,0,19,27,8,4,2,0,13602,13636,6
Task 13603,Job 0,5,5,3,12,1,8,17,9,3,2,0,13603,13636,7
Task 13603,Job 1,10,9,2,9,1,12,19,7,2,1,0,13603,13636,12
Task 13604,Job 0,6,7,2,10,0,8,16,8,2,4,2,13604,13637,15
Task 13604,Job 1,11,8,1,7,0,12,18,6,1,4,1,13604,13637,7
Task 13605,Job 0,10,4,2,6,0,12,16,4,2,4,1,13605,13638,20
Task 13605,Job 1,15,8,3,9,0,18,24,6,3,2,2,13605,13638,6
Task 13606,Job 0,9,8,4,11,1,13,20,7,4,1,1,13606,13639,2
Task 13606,Job 1,14,4,1,6,0,15,20,5,1,3,0,13606,13639,12
Task 13607,Job 0,10,5,1,10,0,11,20,9,1,2,2,13607,13641,10
Task 13607,Job 1,15,8,1,9,0,16,24,8,1,1,0,13607,13641,9
Task 13608,Job 0,3,4,3,7,0,6,10,4,3,3,0,13608,13642,2
Task 13608,Job 1,8,10,3,11,0,11,19,8,3,1,0,13608,13642,20
Task 13609,Job 0,4,9,2,7,0,6,11,5,2,3,0,13609,13642,6
Task 13609,Job 1,9,9,2,12,0,11,21,10,2,1,2,13609,13642,9
Task 13610,Job 0,5,10,1,6,0,6,11,5,1,4,1,13610,13644,8
Task 13610,Job 1,10,5,4,6,0,14,16,2,4,1,2,13610,13644,10
Task 13611,Job 0,1,5,1,10,0,2,11,9,1,4,2,13611,13644,6
Task 13611,Job 1,6,9,1,12,0,7,18,11,1,2,1,13611,13644,12
Task 13612,Job 0,4,10,1,9,0,5,13,8,1,4,2,13612,13645,11
Task 13612,Job 1,9,6,1,11,1,10,20,10,1,1,1,13612,13645,11
Task 13613,Job 0,3,6,4,10,0,7,13,6,4,1,2,13613,13646,18
Task 13613,Job 1,8,10,2,11,0,10,19,9,2,4,2,13613,13646,3
Task 13614,Job 0,1,6,3,6,0,4,7,3,3,2,0,13614,13648,7
Task 13614,Job 1,6,5,3,10,0,9,16,7,3,3,2,13614,13648,13
Task 13615,Job 0,8,7,1,7,0,9,15,6,1,1,0,13615,13648,5
Task 13615,Job 1,13,6,1,7,1,14,20,6,1,1,1,13615,13648,4
Task 13616,Job 0,4,10,4,11,0,8,15,7,4,2,0,13616,13650,10
Task 13616,Job 1,9,4,3,8,1,12,17,5,3,4,2,13616,13650,16
Task 13617,Job 0,7,6,3,6,0,10,13,3,3,1,0,13617,13651,19
Task 13617,Job 1,12,5,2,11,0,14,23,9,2,1,1,13617,13651,10
Task 13618,Job 0,6,6,2,7,0,8,13,5,2,1,2,13618,13651,13
Task 13618,Job 1,11,6,4,10,0,15,21,6,4,3,0,13618,13651,12
Task 13619,Job 0,5,9,2,12,1,7,17,10,2,2,0,13619,13652,19
Task 13619,Job 1,10,10,4,6,0,14,16,2,4,3,2,13619,13652,15
Task 13620,Job 0,8,10,4,11,0,12,19,7,4,4,2,13620,13654,7
Task 13620,Job 1,13,9,1,12,0,14,25,11,1,1,2,13620,13654,2
Task 13621,Job 0,3,7,3,10,0,6,13,7,3,2,1,13621,13654,16
Task 13621,Job 1,8,7,4,6,0,12,14,2,4,4,2,13621,13654,6
Task 13622,Job 0,3,4,3,11,0,6,14,8,3,2,2,13622,13655,3
Task 13622,Job 1,8,5,3,10,0,11,18,7,3,2,1,13622,13655,6
Task 13623,Job 0,10,8,4,7,0,14,17,3,4,2,0,13623,13656,11
Task 13623,Job 1,15,8,1,11,0,16,26,10,1,3,1,13623,13656,7
Task 13624,Job 0,1,9,2,6,0,3,7,4,2,4,0,13624,13657,2
Task 13624,Job 1,6,10,2,10,0,8,16,8,2,3,1,13624,13657,4
Task 13625,Job 0,8,10,2,7,0,10,15,5,2,3,0,13625,13659,6
Task 13625,Job 1,13,8,2,6,0,15,19,4,2,4,2,13625,13659,7
Task 13626,Job 0,1,7,3,7,0,4,8,4,3,1,0,13626,13660,18
Task 13626,Job 1,6,9,3,7,1,9,13,4,3,4,2,13626,13660,11
Task 13627,Job 0,8,10,4,9,0,12,17,5,4,4,2,13627,13661,13
Task 13627,Job 1,13,10,4,9,1,17,22,5,4,4,2,13627,13661,14
Task 13628,Job 0,9,9,3,12,0,12,21,9,3,3,1,13628,13661,12
Task 13628,Job 1,14,6,4,8,0,18,22,4,4,3,0,13628,13661,19
Task 13629,Job 0,10,7,4,6,1,14,16,2,4,3,0,13629,13663,19
Task 13629,Job 1,15,6,3,7,0,18,22,4,3,4,0,13629,13663,10
Task 13630,Job 0,7,7,3,6,1,10,13,3,3,3,0,13630,13663,10
Task 13630,Job 1,12,9,4,12,0,16,24,8,4,4,0,13630,13663,14
Task 13631,Job 0,5,4,1,7,0,6,12,6,1,1,1,13631,13664,6
Task 13631,Job 1,10,7,2,9,0,12,19,7,2,2,1,13631,13664,6
Task 13632,Job 0,4,6,1,10,0,5,14,9,1,4,0,13632,13665,4
Task 13632,Job 1,9,8,1,6,0,10,15,5,1,3,2,13632,13665,7
Task 13633,Job 0,1,7,1,9,1,2,10,8,1,3,2,13633,13667,12
Task 13633,Job 1,6,6,1,10,0,7,16,9,1,1,2,13633,13667,15
Task 13634,Job 0,4,7,1,6,0,5,10,5,1,2,2,13634,13667,19
Task 13634,Job 1,9,4,1,6,1,10,15,5,1,1,1,13634,13667,9
Task 13635,Job 0,10,10,4,12,0,14,22,8,4,3,1,13635,13668,6
Task 13635,Job 1,15,8,3,9,0,18,24,6,3,2,2,13635,13668,13
Task 13636,Job 0,4,7,4,11,0,8,15,7,4,2,2,13636,13670,10
Task 13636,Job 1,9,8,1,11,0,10,20,10,1,4,0,13636,13670,10
Task 13637,Job 0,2,7,4,7,0,6,9,3,4,1,2,13637,13671,12
Task 13637,Job 1,7,8,3,8,0,10,15,5,3,3,0,13637,13671,2
Task 13638,Job 0,3,10,2,8,0,5,11,6,2,1,0,13638,13671,6
Task 13638,Job 1,8,4,4,10,0,12,18,6,4,3,1,13638,13671,17
Task 13639,Job 0,7,7,2,7,0,9,14,5,2,3,1,13639,13672,11
Task 13639,Job 1,12,10,1,12,0,13,24,11,1,4,0,13639,13672,15
Task 13640,Job 0,8,4,3,9,1,11,17,6,3,2,0,13640,13674,2
Task 13640,Job 1,13,9,3,8,0,16,21,5,3,2,2,13640,13674,20
Task 13641,Job 0,9,8,4,10,1,13,19,6,4,2,2,13641,13675,14
Task 13641,Job 1,14,8,4,9,0,18,23,5,4,3,0,13641,13675,19
Task 13642,Job 0,6,8,3,10,0,9,16,7,3,4,1,13642,13676,12
Task 13642,Job 1,11,4,3,7,0,14,18,4,3,4,0,13642,13676,7
Task 13643,Job 0,6,5,3,12,0,9,18,9,3,2,1,13643,13676,6
Task 13643,Job 1,11,6,3,8,1,14,19,5,3,2,2,13643,13676,5
Task 13644,Job 0,6,8,2,9,1,8,15,7,2,1,1,13644,13677,17
Task 13644,Job 1,11,6,1,10,0,12,21,9,1,3,2,13644,13677,8
Task 13645,Job 0,4,6,1,8,0,5,12,7,1,1,1,13645,13678,7
Task 13645,Job 1,9,8,1,8,0,10,17,7,1,1,2,13645,13678,17
Task 13646,Job 0,4,5,2,12,0,6,16,10,2,1,1,13646,13680,15
Task 13646,Job 1,9,8,1,9,0,10,18,8,1,3,1,13646,13680,18
Task 13647,Job 0,3,7,2,11,0,5,14,9,2,2,0,13647,13681,2
Task 13647,Job 1,8,5,4,8,0,12,16,4,4,4,2,13647,13681,3
Task 13648,Job 0,5,8,2,6,0,7,11,4,2,2,2,13648,13682,18
Task 13648,Job 1,10,9,4,11,0,14,21,7,4,3,2,13648,13682,4
Task 13649,Job 0,8,8,2,12,1,10,20,10,2,4,1,13649,13682,4
Task 13649,Job 1,13,6,1,7,0,14,20,6,1,3,2,13649,13682,19
Task 13650,Job 0,7,10,1,9,0,8,16,8,1,2,0,13650,13683,11
Task 13650,Job 1,12,8,4,10,0,16,22,6,4,4,2,13650,13683,14
Task 13651,Job 0,2,10,3,9,1,5,11,6,3,4,1,13651,13684,8
Task 13651,Job 1,7,10,1,8,0,8,15,7,1,3,0,13651,13684,14
Task 13652,Job 0,7,7,3,6,0,10,13,3,3,3,0,13652,13685,9
Task 13652,Job 1,12,5,3,9,0,15,21,6,3,3,1,13652,13685,19
Task 13653,Job 0,1,6,4,7,0,5,8,3,4,3,2,13653,13686,7
Task 13653,Job 1,6,10,2,8,0,8,14,6,2,3,2,13653,13686,15
Task 13654,Job 0,3,9,4,12,1,7,15,8,4,4,2,13654,13688,11
Task 13654,Job 1,8,9,2,10,0,10,18,8,2,2,2,13654,13688,6
Task 13655,Job 0,5,4,3,7,0,8,12,4,3,4,1,13655,13689,11
Task 13655,Job 1,10,5,2,10,0,12,20,8,2,4,1,13655,13689,11
Task 13656,Job 0,1,6,1,8,0,2,9,7,1,1,1,13656,13690,20
Task 13656,Job 1,6,5,1,10,0,7,16,9,1,3,1,13656,13690,11
Task 13657,Job 0,6,7,2,12,0,8,18,10,2,4,1,13657,13691,2
Task 13657,Job 1,11,10,4,12,1,15,23,8,4,1,0,13657,13691,11
Task 13658,Job 0,6,7,1,9,0,7,15,8,1,2,1,13658,13691,6
Task 13658,Job 1,11,9,3,10,0,14,21,7,3,1,2,13658,13691,8
Task 13659,Job 0,6,4,4,7,0,10,13,3,4,2,2,13659,13692,20
Task 13659,Job 1,11,4,4,10,0,15,21,6,4,4,2,13659,13692,20
Task 13660,Job 0,9,6,2,6,0,11,15,4,2,4,1,13660,13693,18
Task 13660,Job 1,14,9,2,8,0,16,22,6,2,3,1,13660,13693,14
Task 13661,Job 0,3,5,1,6,0,4,9,5,1,2,0,13661,13694,6
Task 13661,Job 1,8,9,3,8,0,11,16,5,3,4,0,13661,13694,17
Task 13662,Job 0,9,10,3,8,0,12,17,5,3,3,1,13662,13696,12
Task 13662,Job 1,14,10,3,10,1,17,24,7,3,1,0,13662,13696,18
Task 13663,Job 0,4,9,2,6,0,6,10,4,2,4,2,13663,13696,4
Task 13663,Job 1,9,6,1,12,0,10,21,11,1,1,1,13663,13696,18
Task 13664,Job 0,5,10,3,12,1,8,17,9,3,3,0,13664,13698,10
Task 13664,Job 1,10,8,3,6,1,13,16,3,3,4,1,13664,13698,10
Task 13665,Job 0,8,10,1,7,0,9,15,6,1,3,0,13665,13699,15
Task 13665,Job 1,13,7,4,9,1,17,22,5,4,1,0,13665,13699,20
Task 13666,Job 0,10,7,1,10,0,11,20,9,1,4,2,13666,13700,10
Task 13666,Job 1,15,6,3,11,0,18,26,8,3,1,0,13666,13700,7
Task 13667,Job 0,8,7,1,8,1,9,16,7,1,1,2,13667,13701,18
Task 13667,Job 1,13,8,4,9,0,17,22,5,4,1,2,13667,13701,15
Task 13668,Job 0,5,10,1,7,0,6,12,6,1,2,0,13668,13701,11
Task 13668,Job 1,10,5,2,9,0,12,19,7,2,4,1,13668,13701,20
Task 13669,Job 0,1,9,3,11,1,4,12,8,3,2,2,13669,13703,5
Task 13669,Job 1,6,4,4,10,0,10,16,6,4,3,2,13669,13703,9
Task 13670,Job 0,2,5,2,6,0,4,8,4,2,2,1,13670,13703,5
Task 13670,Job 1,7,9,3,12,0,10,19,9,3,3,2,13670,13703,17
Task 13671,Job 0,1,9,2,10,0,3,11,8,2,3,0,13671,13704,9
Task 13671,Job 1,6,10,2,6,1,8,12,4,2,1,2,13671,13704,12
Task 13672,Job 0,7,10,2,6,0,9,13,4,2,2,1,13672,13705,13
Task 13672,Job 1,12,6,2,11,0,14,23,9,2,4,1,13672,13705,5
Task 13673,Job 0,1,5,4,10,0,5,11,6,4,1,0,13673,13707,9
Task 13673,Job 1,6,10,2,12,1,8,18,10,2,4,2,13673,13707,9
Task 13674,Job 0,2,10,4,7,0,6,9,3,4,1,1,13674,13708,10
Task 13674,Job 1,7,6,4,8,1,11,15,4,4,2,1,13674,13708,4
Task 13675,Job 0,1,8,1,7,1,2,8,6,1,3,1,13675,13709,12
Task 13675,Job 1,6,4,1,6,1,7,12,5,1,3,2,13675,13709,18
Task 13676,Job 0,7,8,4,10,0,11,17,6,4,2,1,13676,13709,4
Task 13676,Job 1,12,9,2,8,0,14,20,6,2,1,0,13676,13709,19
Task 13677,Job 0,4,8,1,12,1,5,16,11,1,4,0,13677,13711,16
Task 13677,Job 1,9,4,2,9,0,11,18,7,2,3,0,13677,13711,6
Task 13678,Job 0,1,5,3,10,0,4,11,7,3,3,2,13678,13711,19
Task 13678,Job 1,6,8,1,7,0,7,13,6,1,4,1,13678,13711,5
Task 13679,Job 0,4,10,1,8,1,5,12,7,1,4,2,13679,13712,2
Task 13679,Job 1,9,10,3,7,1,12,16,4,3,2,2,13679,13712,3
Task 13680,Job 0,10,8,1,11,0,11,21,10,1,2,2,13680,13714,6
Task 13680,Job 1,15,6,2,7,0,17,22,5,2,4,0,13680,13714,5
Task 13681,Job 0,10,8,3,11,0,13,21,8,3,2,1,13681,13715,11
Task 13681,Job 1,15,10,1,9,0,16,24,8,1,4,1,13681,13715,8
Task 13682,Job 0,4,8,2,6,1,6,10,4,2,3,2,13682,13715,4
Task 13682,Job 1,9,9,3,8,0,12,17,5,3,2,2,13682,13715,5
Task 13683,Job 0,7,10,2,8,1,9,15,6,2,1,2,13683,13716,5
Task 13683,Job 1,12,5,4,8,0,16,20,4,4,3,2,13683,13716,6
Task 13684,Job 0,2,6,1,12,0,3,14,11,1,3,1,13684,13718,4
Task 13684,Job 1,7,4,1,7,1,8,14,6,1,2,2,13684,13718,3
Task 13685,Job 0,1,10,3,6,0,4,7,3,3,2,1,13685,13719,19
Task 13685,Job 1,6,7,1,12,0,7,18,11,1,4,2,13685,13719,9
Task 13686,Job 0,9,9,4,9,0,13,18,5,4,4,2,13686,13720,5
Task 13686,Job 1,14,7,3,9,1,17,23,6,3,2,0,13686,13720,20
Task 13687,Job 0,8,5,2,7,0,10,15,5,2,3,2,13687,13721,5
Task 13687,Job 1,13,8,3,9,0,16,22,6,3,3,2,13687,13721,10
Task 13688,Job 0,8,9,1,12,0,9,20,11,1,1,1,13688,13721,19
Task 13688,Job 1,13,7,2,12,0,15,25,10,2,3,0,13688,13721,14
Task 13689,Job 0,3,7,3,7,0,6,10,4,3,2,1,13689,13722,10
Task 13689,Job 1,8,10,2,8,1,10,16,6,2,3,1,13689,13722,2
Task 13690,Job 0,1,10,4,8,0,5,9,4,4,3,1,13690,13724,16
Task 13690,Job 1,6,8,4,12,0,10,18,8,4,1,1,13690,13724,11
Task 13691,Job 0,5,5,1,12,0,6,17,11,1,3,1,13691,13725,9
Task 13691,Job 1,10,10,2,6,0,12,16,4,2,1,2,13691,13725,11
Task 13692,Job 0,1,5,3,9,0,4,10,6,3,1,2,13692,13726,7
Task 13692,Job 1,6,5,4,6,0,10,12,2,4,1,1,13692,13726,16
Task 13693,Job 0,10,7,1,9,0,11,19,8,1,4,2,13693,13726,6
Task 13693,Job 1,15,4,2,9,0,17,24,7,2,1,1,13693,13726,13
Task 13694,Job 0,2,8,3,7,1,5,9,4,3,2,0,13694,13728,4
Task 13694,Job 1,7,4,1,12,0,8,19,11,1,4,1,13694,13728,20
Task 13695,Job 0,4,9,3,9,0,7,13,6,3,1,2,13695,13729,14
Task 13695,Job 1,9,10,4,6,0,13,15,2,4,3,0,13695,13729,6
Task 13696,Job 0,4,9,2,9,1,6,13,7,2,4,2,13696,13730,3
Task 13696,Job 1,9,6,2,7,0,11,16,5,2,3,0,13696,13730,9
Task 13697,Job 0,1,9,2,10,0,3,11,8,2,2,1,13697,13730,17
Task 13697,Job 1,6,7,4,7,1,10,13,3,4,1,2,13697,13730,18
Task 13698,Job 0,4,5,1,6,0,5,10,5,1,3,2,13698,13731,11
Task 13698,Job 1,9,6,3,12,0,12,21,9,3,1,1,13698,13731,8
Task 13699,Job 0,2,5,4,11,0,6,13,7,4,3,1,13699,13732,17
Task 13699,Job 1,7,4,4,12,1,11,19,8,4,1,1,13699,13732,16
Task 13700,Job 0,6,5,4,12,0,10,18,8,4,4,0,13700,13733,3
Task 13700,Job 1,11,6,1,9,0,12,20,8,1,4,0,13700,13733,15
Task 13701,Job 0,8,10,2,11,0,10,19,9,2,1,1,13701,13735,15
Task 13701,Job 1,13,10,1,8,1,14,21,7,1,2,1,13701,13735,12
Task 13702,Job 0,8,8,2,12,0,10,20,10,2,3,1,13702,13736,9
Task 13702,Job 1,13,8,3,9,1,16,22,6,3,2,1,13702,13736,14
Task 13703,Job 0,8,9,2,11,0,10,19,9,2,4,2,13703,13737,2
Task 13703,Job 1,13,4,3,10,0,16,23,7,3,4,2,13703,13737,16
Task 13704,Job 0,2,4,1,6,0,3,8,5,1,3,2,13704,13737,11
Task 13704,Job 1,7,9,4,12,0,11,19,8,4,2,0,13704,13737,9
Task 13705,Job 0,8,8,4,12,0,12,20,8,4,3,2,13705,13739,5
Task 13705,Job 1,13,8,3,10,1,16,23,7,3,2,2,13705,13739,10
Task 13706,Job 0,3,6,1,7,0,4,10,6,1,1,1,13706,13740,17
Task 13706,Job 1,8,10,1,6,0,9,14,5,1,2,0,13706,13740,2
Task 13707,Job 0,5,4,2,9,0,7,14,7,2,3,1,13707,13740,3
Task 13707,Job 1,10,8,2,10,0,12,20,8,2,3,2,13707,13740,15
Task 13708,Job 0,10,6,3,7,0,13,17,4,3,3,1,13708,13742,7
Task 13708,Job 1,15,10,2,10,0,17,25,8,2,4,0,13708,13742,16
Task 13709,Job 0,10,4,4,8,0,14,18,4,4,1,2,13709,13742,18
Task 13709,Job 1,15,4,3,7,0,18,22,4,3,2,0,13709,13742,3
Task 13710,Job 0,1,7,3,11,0,4,12,8,3,2,2,13710,13744,10
Task 13710,Job 1,6,7,3,8,0,9,14,5,3,3,1,13710,13744,3
Task 13711,Job 0,3,8,4,7,0,7,10,3,4,3,2,13711,13744,3
Task 13711,Job 1,8,9,4,7,0,12,15,3,4,3,0,13711,13744,3
Task 13712,Job 0,3,7,4,7,0,7,10,3,4,4,2,13712,13745,9
Task 13712,Job 1,8,8,2,6,0,10,14,4,2,1,1,13712,13745,3
Task 13713,Job 0,1,10,3,7,0,4,8,4,3,1,0,13713,13746,4
Task 13713,Job 1,6,5,1,10,0,7,16,9,1,4,1,13713,13746,10
Task 13714,Job 0,3,4,1,7,0,4,10,6,1,1,2,13714,13748,6
Task 13714,Job 1,8,9,2,7,0,10,15,5,2,1,1,13714,13748,20
Task 13715,Job 0,6,9,4,7,0,10,13,3,4,4,0,13715,13749,16
Task 13715,Job 1,11,6,1,6,0,12,17,5,1,3,2,13715,13749,11
Task 13716,Job 0,5,5,1,11,0,6,16,10,1,2,2,13716,13749,4
Task 13716,Job 1,10,6,2,9,0,12,19,7,2,1,0,13716,13749,7
Task 13717,Job 0,9,10,4,12,1,13,21,8,4,4,2,13717,13751,18
Task 13717,Job 1,14,7,1,12,0,15,26,11,1,1,0,13717,13751,12
Task 13718,Job 0,10,4,3,12,0,13,22,9,3,3,0,13718,13751,4
Task 13718,Job 1,15,7,1,7,0,16,22,6,1,2,1,13718,13751,10
Task 13719,Job 0,8,6,3,11,0,11,19,8,3,1,2,13719,13752,9
Task 13719,Job 1,13,4,1,10,0,14,23,9,1,2,1,13719,13752,20
Task 13720,Job 0,4,8,3,9,0,7,13,6,3,2,1,13720,13753,9
Task 13720,Job 1,9,4,4,11,0,13,20,7,4,1,0,13720,13753,19
Task 13721,Job 0,1,9,2,10,0,3,11,8,2,3,1,13721,13754,7
Task 13721,Job 1,6,6,3,12,1,9,18,9,3,4,2,13721,13754,4
Task 13722,Job 0,4,5,2,7,0,6,11,5,2,1,2,13722,13755,14
Task 13722,Job 1,9,8,4,11,0,13,20,7,4,3,0,13722,13755,12
Task 13723,Job 0,7,7,1,6,0,8,13,5,1,1,1,13723,13757,7
Task 13723,Job 1,12,7,4,7,0,16,19,3,4,3,0,13723,13757,17
Task 13724,Job 0,3,5,2,10,0,5,13,8,2,2,0,13724,13758,15
Task 13724,Job 1,8,6,4,12,1,12,20,8,4,2,2,13724,13758,12
Task 13725,Job 0,7,8,4,12,0,11,19,8,4,1,0,13725,13759,9
Task 13725,Job 1,12,7,4,7,0,16,19,3,4,1,1,13725,13759,9
Task 13726,Job 0,7,9,3,7,0,10,14,4,3,3,0,13726,13759,7
Task 13726,Job 1,12,8,1,12,1,13,24,11,1,3,1,13726,13759,7
Task 13727,Job 0,6,8,3,10,0,9,16,7,3,1,0,13727,13760,18
Task 13727,Job 1,11,7,3,11,0,14,22,8,3,4,0,13727,13760,3
Task 13728,Job 0,6,5,1,9,1,7,15,8,1,3,2,13728,13761,11
Task 13728,Job 1,11,10,3,12,0,14,23,9,3,2,1,13728,13761,19
Task 13729,Job 0,6,8,4,7,0,10,13,3,4,1,1,13729,13763,19
Task 13729,Job 1,11,6,4,12,0,15,23,8,4,3,1,13729,13763,9
Task 13730,Job 0,4,7,2,12,0,6,16,10,2,2,2,13730,13763,7
Task 13730,Job 1,9,10,2,7,0,11,16,5,2,2,2,13730,13763,7
Task 13731,Job 0,8,6,4,7,0,12,15,3,4,4,0,13731,13765,8
Task 13731,Job 1,13,9,1,10,0,14,23,9,1,4,2,13731,13765,10
Task 13732,Job 0,7,4,2,11,0,9,18,9,2,3,1,13732,13765,9
Task 13732,Job 1,12,8,2,10,0,14,22,8,2,4,2,13732,13765,3
Task 13733,Job 0,6,6,4,10,0,10,16,6,4,1,2,13733,13767,2
Task 13733,Job 1,11,4,2,12,0,13,23,10,2,2,1,13733,13767,13
Task 13734,Job 0,2,5,4,6,1,6,8,2,4,2,1,13734,13768,4
Task 13734,Job 1,7,10,3,12,1,10,19,9,3,4,1,13734,13768,20
Task 13735,Job 0,1,9,2,6,0,3,7,4,2,1,2,13735,13768,17
Task 13735,Job 1,6,9,4,9,0,10,15,5,4,2,1,13735,13768,18
Task 13736,Job 0,7,4,2,12,0,9,19,10,2,1,1,13736,13769,16
Task 13736,Job 1,12,8,2,8,0,14,20,6,2,1,0,13736,13769,20
Task 13737,Job 0,5,6,2,12,0,7,17,10,2,3,0,13737,13770,6
Task 13737,Job 1,10,5,3,9,0,13,19,6,3,1,0,13737,13770,12
Task 13738,Job 0,4,5,4,12,0,8,16,8,4,4,0,13738,13772,5
Task 13738,Job 1,9,10,3,7,0,12,16,4,3,4,2,13738,13772,12
Task 13739,Job 0,1,4,2,6,0,3,7,4,2,3,0,13739,13773,14
Task 13739,Job 1,6,9,2,6,0,8,12,4,2,3,0,13739,13773,10
Task 13740,Job 0,2,5,2,6,0,4,8,4,2,1,0,13740,13774,11
Task 13740,Job 1,7,6,2,9,0,9,16,7,2,4,0,13740,13774,11
Task 13741,Job 0,8,10,3,6,0,11,14,3,3,1,0,13741,13774,10
Task 13741,Job 1,13,9,2,8,0,15,21,6,2,4,1,13741,13774,8
Task 13742,Job 0,3,7,3,8,1,6,11,5,3,4,1,13742,13776,2
Task 13742,Job 1,8,8,3,7,1,11,15,4,3,4,1,13742,13776,6
Task 13743,Job 0,7,6,3,11,1,10,18,8,3,3,0,13743,13776,19
Task 13743,Job 1,12,5,3,12,1,15,24,9,3,3,0,13743,13776,18
Task 13744,Job 0,1,9,3,9,0,4,10,6,3,4,2,13744,13777,9
Task 13744,Job 1,6,10,1,9,1,7,15,8,1,3,0,13744,13777,8
Task 13745,Job 0,10,5,2,10,0,12,20,8,2,2,1,13745,13779,5
Task 13745,Job 1,15,8,2,12,0,17,27,10,2,4,2,13745,13779,11
Task 13746,Job 0,2,5,4,9,0,6,11,5,4,4,1,13746,13779,9
Task 13746,Job 1,7,8,3,11,0,10,18,8,3,1,2,13746,13779,15
Task 13747,Job 0,4,10,3,8,0,7,12,5,3,3,0,13747,13781,14
Task 13747,Job 1,9,7,3,9,1,12,18,6,3,1,0,13747,13781,19
Task 13748,Job 0,8,6,1,10,0,9,18,9,1,2,2,13748,13782,15
Task 13748,Job 1,13,10,2,7,1,15,20,5,2,1,1,13748,13782,8
Task 13749,Job 0,9,5,3,8,0,12,17,5,3,1,0,13749,13783,10
Task 13749,Job 1,14,5,4,7,1,18,21,3,4,3,0,13749,13783,10
Task 13750,Job 0,8,4,1,9,0,9,17,8,1,1,0,13750,13783,18
Task 13750,Job 1,13,6,2,6,0,15,19,4,2,3,0,13750,13783,4
Task 13751,Job 0,8,8,1,8,0,9,16,7,1,1,1,13751,13785,8
Task 13751,Job 1,13,4,4,11,0,17,24,7,4,1,2,13751,13785,16
Task 13752,Job 0,7,9,2,6,0,9,13,4,2,4,2,13752,13786,18
Task 13752,Job 1,12,9,3,6,1,15,18,3,3,4,2,13752,13786,3
Task 13753,Job 0,5,10,3,6,0,8,11,3,3,1,1,13753,13787,2
Task 13753,Job 1,10,7,3,6,0,13,16,3,3,1,1,13753,13787,2
Task 13754,Job 0,4,7,3,7,0,7,11,4,3,3,2,13754,13788,14
Task 13754,Job 1,9,9,1,9,0,10,18,8,1,4,1,13754,13788,3
Task 13755,Job 0,3,10,1,6,1,4,9,5,1,2,2,13755,13789,4
Task 13755,Job 1,8,10,4,10,1,12,18,6,4,1,0,13755,13789,20
Task 13756,Job 0,4,8,3,9,1,7,13,6,3,1,2,13756,13789,4
Task 13756,Job 1,9,9,3,6,0,12,15,3,3,3,1,13756,13789,18
Task 13757,Job 0,10,8,1,10,1,11,20,9,1,4,2,13757,13790,11
Task 13757,Job 1,15,9,1,8,0,16,23,7,1,2,2,13757,13790,20
Task 13758,Job 0,10,8,4,12,0,14,22,8,4,1,0,13758,13791,10
Task 13758,Job 1,15,6,4,12,0,19,27,8,4,4,1,13758,13791,17
Task 13759,Job 0,8,8,2,7,1,10,15,5,2,3,1,13759,13793,4
Task 13759,Job 1,13,4,4,10,0,17,23,6,4,4,2,13759,13793,16
Task 13760,Job 0,10,4,1,7,0,11,17,6,1,1,0,13760,13793,15
Task 13760,Job 1,15,8,4,9,1,19,24,5,4,3,1,13760,13793,12
Task 13761,Job 0,4,7,1,8,0,5,12,7,1,2,2,13761,13794,11
Task 13761,Job 1,9,10,2,10,0,11,19,8,2,3,0,13761,13794,2
Task 13762,Job 0,9,7,3,10,0,12,19,7,3,2,2,13762,13796,3
Task 13762,Job 1,14,5,3,6,0,17,20,3,3,1,1,13762,13796,12
Task 13763,Job 0,5,8,2,12,0,7,17,10,2,3,2,13763,13797,17
Task 13763,Job 1,10,9,3,10,0,13,20,7,3,1,2,13763,13797,17
Task 13764,Job 0,7,4,2,9,0,9,16,7,2,3,2,13764,13798,9
Task 13764,Job 1,12,9,3,7,0,15,19,4,3,3,1,13764,13798,15
Task 13765,Job 0,5,9,3,6,0,8,11,3,3,2,0,13765,13798,7
Task 13765,Job 1,10,9,1,6,0,11,16,5,1,4,1,13765,13798,13
Task 13766,Job 0,7,5,4,10,1,11,17,6,4,2,2,13766,13800,11
Task 13766,Job 1,12,9,3,7,0,15,19,4,3,3,1,13766,13800,4
Task 13767,Job 0,10,4,4,8,1,14,18,4,4,2,2,13767,13800,15
Task 13767,Job 1,15,6,4,9,0,19,24,5,4,4,2,13767,13800,8
Task 13768,Job 0,3,9,2,9,0,5,12,7,2,2,2,13768,13802,11
Task 13768,Job 1,8,7,3,10,0,11,18,7,3,2,2,13768,13802,7
Task 13769,Job 0,9,6,4,7,0,13,16,3,4,4,1,13769,13803,13
Task 13769,Job 1,14,4,2,7,1,16,21,5,2,2,0,13769,13803,9
Task 13770,Job 0,2,9,2,7,0,4,9,5,2,3,0,13770,13803,9
Task 13770,Job 1,7,5,3,8,0,10,15,5,3,2,2,13770,13803,5
Task 13771,Job 0,2,10,4,7,0,6,9,3,4,1,1,13771,13805,19
Task 13771,Job 1,7,4,1,12,1,8,19,11,1,3,2,13771,13805,3
Task 13772,Job 0,7,4,4,10,0,11,17,6,4,3,0,13772,13806,9
Task 13772,Job 1,12,6,2,10,1,14,22,8,2,2,1,13772,13806,3
Task 13773,Job 0,1,9,1,6,1,2,7,5,1,2,2,13773,13806,6
Task 13773,Job 1,6,10,4,12,0,10,18,8,4,2,1,13773,13806,15
Task 13774,Job 0,8,7,1,8,0,9,16,7,1,2,1,13774,13808,3
Task 13774,Job 1,13,8,3,6,0,16,19,3,3,4,2,13774,13808,4
Task 13775,Job 0,9,7,2,6,1,11,15,4,2,4,2,13775,13809,8
Task 13775,Job 1,14,6,1,12,1,15,26,11,1,1,2,13775,13809,18
Task 13776,Job 0,5,8,3,11,0,8,16,8,3,4,0,13776,13810,16
Task 13776,Job 1,10,8,3,7,0,13,17,4,3,2,0,13776,13810,16
Task 13777,Job 0,1,4,1,11,0,2,12,10,1,1,2,13777,13810,6
Task 13777,Job 1,6,9,1,9,1,7,15,8,1,3,0,13777,13810,17
Task 13778,Job 0,8,6,2,8,1,10,16,6,2,3,0,13778,13811,3
Task 13778,Job 1,13,5,1,7,1,14,20,6,1,3,2,13778,13811,13
Task 13779,Job 0,5,10,1,10,0,6,15,9,1,4,0,13779,13813,9
Task 13779,Job 1,10,4,2,12,0,12,22,10,2,2,0,13779,13813,10
Task 13780,Job 0,1,8,3,8,0,4,9,5,3,4,0,13780,13814,18
Task 13780,Job 1,6,8,2,12,0,8,18,10,2,4,1,13780,13814,12
Task 13781,Job 0,5,5,1,11,0,6,16,10,1,1,0,13781,13814,20
Task 13781,Job 1,10,8,2,10,0,12,20,8,2,4,0,13781,13814,19
Task 13782,Job 0,8,4,4,6,0,12,14,2,4,4,2,13782,13815,15
Task 13782,Job 1,13,7,1,11,1,14,24,10,1,2,2,13782,13815,19
Task 13783,Job 0,3,7,3,10,0,6,13,7,3,4,2,13783,13816,18
Task 13783,Job 1,8,4,1,6,0,9,14,5,1,3,2,13783,13816,2
Task 13784,Job 0,3,10,2,11,1,5,14,9,2,3,2,13784,13817,13
Task 13784,Job 1,8,8,3,6,0,11,14,3,3,4,1,13784,13817,7
Task 13785,Job 0,2,8,1,10,0,3,12,9,1,2,1,13785,13818,11
Task 13785,Job 1,7,9,3,11,0,10,18,8,3,2,0,13785,13818,15
Task 13786,Job 0,2,9,4,9,0,6,11,5,4,4,2,13786,13820,2
Task 13786,Job 1,7,5,1,12,0,8,19,11,1,4,1,13786,13820,6
Task 13787,Job 0,2,9,1,10,0,3,12,9,1,4,0,13787,13820,11
Task 13787,Job 1,7,7,3,10,0,10,17,7,3,1,2,13787,13820,16
Task 13788,Job 0,10,4,4,10,0,14,20,6,4,1,1,13788,13822,15
Task 13788,Job 1,15,4,3,9,0,18,24,6,3,3,2,13788,13822,6
Task 13789,Job 0,6,10,2,10,0,8,16,8,2,4,2,13789,13823,19
Task 13789,Job 1,11,10,3,12,0,14,23,9,3,2,1,13789,13823,18
Task 13790,Job 0,5,10,4,9,0,9,14,5,4,1,2,13790,13823,15
Task 13790,Job 1,10,7,4,7,0,14,17,3,4,1,1,13790,13823,17
Task 13791,Job 0,1,4,4,12,0,5,13,8,4,3,1,13791,13824,11
Task 13791,Job 1,6,6,2,7,0,8,13,5,2,4,2,13791,13824,19
Task 13792,Job 0,6,4,1,7,0,7,13,6,1,1,1,13792,13825,9
Task 13792,Job 1,11,7,1,7,1,12,18,6,1,1,0,13792,13825,10
Task 13793,Job 0,7,5,4,7,0,11,14,3,4,4,1,13793,13827,17
Task 13793,Job 1,12,4,1,11,0,13,23,10,1,1,1,13793,13827,5
Task 13794,Job 0,4,4,2,12,0,6,16,10,2,2,0,13794,13828,6
Task 13794,Job 1,9,7,3,7,0,12,16,4,3,1,1,13794,13828,15
Task 13795,Job 0,10,6,2,7,0,12,17,5,2,4,2,13795,13829,4
Task 13795,Job 1,15,4,2,7,0,17,22,5,2,2,0,13795,13829,13
Task 13796,Job 0,4,8,2,12,0,6,16,10,2,1,0,13796,13830,10
Task 13796,Job 1,9,10,1,7,1,10,16,6,1,1,2,13796,13830,9
Task 13797,Job 0,10,4,2,9,0,12,19,7,2,1,2,13797,13831,6
Task 13797,Job 1,15,5,4,11,0,19,26,7,4,1,2,13797,13831,6
Task 13798,Job 0,1,8,4,11,0,5,12,7,4,1,0,13798,13832,13
Task 13798,Job 1,6,7,4,11,0,10,17,7,4,1,2,13798,13832,3
Task 13799,Job 0,7,9,1,12,0,8,19,11,1,4,0,13799,13832,12
Task 13799,Job 1,12,10,3,12,1,15,24,9,3,2,1,13799,13832,19
Task 13800,Job 0,5,5,1,6,1,6,11,5,1,4,1,13800,13833,8
Task 13800,Job 1,10,5,3,11,0,13,21,8,3,1,0,13800,13833,10
Task 13801,Job 0,7,8,2,10,0,9,17,8,2,1,2,13801,13834,8
Task 13801,Job 1,12,7,2,9,0,14,21,7,2,3,0,13801,13834,13
Task 13802,Job 0,10,8,4,6,0,14,16,2,4,4,2,13802,13835,3
Task 13802,Job 1,15,4,3,10,0,18,25,7,3,4,1,13802,13835,3
Task 13803,Job 0,9,8,4,12,1,13,21,8,4,1,1,13803,13837,3
Task 13803,Job 1,14,4,4,6,0,18,20,2,4,3,0,13803,13837,12
Task 13804,Job 0,4,4,2,6,0,6,10,4,2,4,2,13804,13837,11
Task 13804,Job 1,9,4,2,6,0,11,15,4,2,3,2,13804,13837,10
Task 13805,Job 0,4,4,2,7,1,6,11,5,2,1,2,13805,13838,16
Task 13805,Job 1,9,4,4,9,0,13,18,5,4,1,1,13805,13838,9
Task 13806,Job 0,1,7,4,9,0,5,10,5,4,3,0,13806,13840,4
Task 13806,Job 1,6,9,1,9,0,7,15,8,1,3,0,13806,13840,18
Task 13807,Job 0,2,5,1,8,0,3,10,7,1,1,1,13807,13841,17
Task 13807,Job 1,7,6,3,11,0,10,18,8,3,2,2,13807,13841,19
Task 13808,Job 0,7,8,1,9,0,8,16,8,1,2,1,13808,13841,2
Task 13808,Job 1,12,9,1,9,0,13,21,8,1,4,1,13808,13841,20
Task 13809,Job 0,1,9,4,10,0,5,11,6,4,2,2,13809,13843,20
Task 13809,Job 1,6,6,2,6,0,8,12,4,2,3,1,13809,13843,4
Task 13810,Job 0,10,4,4,9,0,14,19,5,4,3,2,13810,13843,10
Task 13810,Job 1,15,10,2,8,1,17,23,6,2,4,0,13810,13843,18
Task 13811,Job 0,5,8,1,12,0,6,17,11,1,4,2,13811,13845,20
Task 13811,Job 1,10,5,1,7,1,11,17,6,1,1,1,13811,13845,16
Task 13812,Job 0,5,5,3,7,0,8,12,4,3,3,1,13812,13846,11
Task 13812,Job 1,10,8,2,11,0,12,21,9,2,3,0,13812,13846,9
Task 13813,Job 0,6,8,4,10,0,10,16,6,4,3,2,13813,13846,9
Task 13813,Job 1,11,6,3,10,0,14,21,7,3,2,0,13813,13846,15
Task 13814,Job 0,1,8,3,10,1,4,11,7,3,1,0,13814,13847,9
Task 13814,Job 1,6,6,3,10,1,9,16,7,3,2,0,13814,13847,3
Task 13815,Job 0,5,5,1,6,0,6,11,5,1,1,0,13815,13848,4
Task 13815,Job 1,10,7,1,12,0,11,22,11,1,1,2,13815,13848,3
Task 13816,Job 0,6,6,3,7,0,9,13,4,3,3,0,13816,13850,12
Task 13816,Job 1,11,6,4,12,0,15,23,8,4,1,1,13816,13850,19
Task 13817,Job 0,9,7,2,6,0,11,15,4,2,4,2,13817,13851,15
Task 13817,Job 1,14,10,2,7,1,16,21,5,2,1,0,13817,13851,18
Task 13818,Job 0,10,4,4,9,0,14,19,5,4,4,0,13818,13852,10
Task 13818,Job 1,15,6,3,12,0,18,27,9,3,3,1,13818,13852,20
Task 13819,Job 0,10,4,1,6,0,11,16,5,1,1,2,13819,13853,7
Task 13819,Job 1,15,5,1,7,0,16,22,6,1,4,0,13819,13853,20
Task 13820,Job 0,4,8,4,6,0,8,10,2,4,2,1,13820,13854,11
Task 13820,Job 1,9,7,4,11,0,13,20,7,4,4,1,13820,13854,16
Task 13821,Job 0,6,10,1,7,0,7,13,6,1,1,0,13821,13855,3
Task 13821,Job 1,11,9,3,10,1,14,21,7,3,2,2,13821,13855,13
Task 13822,Job 0,3,8,4,11,0,7,14,7,4,4,0,13822,13855,20
Task 13822,Job 1,8,5,1,8,1,9,16,7,1,2,1,13822,13855,10
Task 13823,Job 0,2,9,2,7,0,4,9,5,2,1,2,13823,13857,9
Task 13823,Job 1,7,10,1,10,0,8,17,9,1,3,1,13823,13857,20
Task 13824,Job 0,8,6,4,7,0,12,15,3,4,4,0,13824,13858,4
Task 13824,Job 1,13,8,2,10,0,15,23,8,2,3,0,13824,13858,8
Task 13825,Job 0,4,7,3,11,0,7,15,8,3,4,2,13825,13858,2
Task 13825,Job 1,9,10,4,10,0,13,19,6,4,4,2,13825,13858,3
Task 13826,Job 0,2,8,4,8,0,6,10,4,4,4,0,13826,13860,13
Task 13826,Job 1,7,9,4,10,0,11,17,6,4,4,1,13826,13860,12
Task 13827,Job 0,3,6,1,8,0,4,11,7,1,3,0,13827,13861,14
Task 13827,Job 1,8,7,1,12,0,9,20,11,1,4,1,13827,13861,9
Task 13828,Job 0,10,8,2,9,0,12,19,7,2,1,1,13828,13862,13
Task 13828,Job 1,15,10,2,9,0,17,24,7,2,2,2,13828,13862,18
Task 13829,Job 0,2,7,3,12,0,5,14,9,3,1,1,13829,13862,19
Task 13829,Job 1,7,8,4,9,0,11,16,5,4,1,2,13829,13862,15
Task 13830,Job 0,2,9,1,6,0,3,8,5,1,4,1,13830,13863,16
Task 13830,Job 1,7,8,2,10,0,9,17,8,2,3,1,13830,13863,6
Task 13831,Job 0,7,4,3,8,1,10,15,5,3,2,0,13831,13865,12
Task 13831,Job 1,12,7,4,8,0,16,20,4,4,1,2,13831,13865,12
Task 13832,Job 0,8,5,2,8,0,10,16,6,2,3,0,13832,13865,8
Task 13832,Job 1,13,8,1,12,0,14,25,11,1,4,1,13832,13865,4
Task 13833,Job 0,9,8,1,10,0,10,19,9,1,2,0,13833,13866,14
Task 13833,Job 1,14,9,3,6,1,17,20,3,3,4,0,13833,13866,16
Task 13834,Job 0,10,10,1,6,0,11,16,5,1,3,2,13834,13868,8
Task 13834,Job 1,15,9,2,10,0,17,25,8,2,2,1,13834,13868,8
Task 13835,Job 0,2,4,2,11,0,4,13,9,2,1,1,13835,13869,7
Task 13835,Job 1,7,9,1,12,0,8,19,11,1,4,2,13835,13869,5
Task 13836,Job 0,10,10,1,8,0,11,18,7,1,2,0,13836,13869,12
Task 13836,Job 1,15,6,3,10,1,18,25,7,3,2,2,13836,13869,18
Task 13837,Job 0,2,9,2,12,0,4,14,10,2,1,0,13837,13870,2
Task 13837,Job 1,7,9,2,8,0,9,15,6,2,3,2,13837,13870,18
Task 13838,Job 0,2,8,3,12,0,5,14,9,3,2,1,13838,13872,9
Task 13838,Job 1,7,8,1,7,1,8,14,6,1,4,2,13838,13872,19
Task 13839,Job 0,8,8,3,8,0,11,16,5,3,2,2,13839,13873,12
Task 13839,Job 1,13,6,1,11,0,14,24,10,1,3,2,13839,13873,17
Task 13840,Job 0,7,4,4,6,1,11,13,2,4,3,2,13840,13874,13
Task 13840,Job 1,12,6,2,12,1,14,24,10,2,3,0,13840,13874,14
Task 13841,Job 0,9,4,1,10,0,10,19,9,1,2,0,13841,13875,18
Task 13841,Job 1,14,7,3,10,0,17,24,7,3,3,1,13841,13875,18
Task 13842,Job 0,8,6,2,10,0,10,18,8,2,4,1,13842,13876,10
Task 13842,Job 1,13,8,4,12,0,17,25,8,4,3,0,13842,13876,8
Task 13843,Job 0,8,8,1,6,0,9,14,5,1,2,0,13843,13877,12
Task 13843,Job 1,13,7,3,8,0,16,21,5,3,2,1,13843,13877,18
Task 13844,Job 0,10,10,2,9,0,12,19,7,2,4,1,13844,13877,19
Task 13844,Job 1,15,6,1,11,1,16,26,10,1,4,0,13844,13877,2
Task 13845,Job 0,9,9,3,9,0,12,18,6,3,3,1,13845,13878,4
Task 13845,Job 1,14,7,4,8,0,18,22,4,4,4,0,13845,13878,7
Task 13846,Job 0,10,5,2,12,0,12,22,10,2,3,1,13846,13879,4
Task 13846,Job 1,15,5,2,10,1,17,25,8,2,1,2,13846,13879,11
Task 13847,Job 0,7,10,1,10,0,8,17,9,1,1,2,13847,13881,16
Task 13847,Job 1,12,8,3,6,0,15,18,3,3,1,0,13847,13881,4
Task 13848,Job 0,7,4,3,10,1,10,17,7,3,4,2,13848,13882,19
Task 13848,Job 1,12,5,4,11,0,16,23,7,4,3,1,13848,13882,11
Task 13849,Job 0,9,6,1,10,0,10,19,9,1,4,1,13849,13883,14
Task 13849,Job 1,14,6,3,11,1,17,25,8,3,1,2,13849,13883,13
Task 13850,Job 0,10,10,3,11,1,13,21,8,3,1,2,13850,13883,2
Task 13850,Job 1,15,4,1,9,0,16,24,8,1,2,2,13850,13883,16
Task 13851,Job 0,2,10,3,10,1,5,12,7,3,2,1,13851,13884,20
Task 13851,Job 1,7,5,1,10,1,8,17,9,1,1,2,13851,13884,5
Task 13852,Job 0,7,9,1,10,0,8,17,9,1,1,0,13852,13885,8
Task 13852,Job 1,12,7,1,8,1,13,20,7,1,4,1,13852,13885,9
Task 13853,Job 0,10,6,2,10,0,12,20,8,2,2,1,13853,13886,18
Task 13853,Job 1,15,4,3,9,1,18,24,6,3,3,0,13853,13886,14
Task 13854,Job 0,8,4,1,12,0,9,20,11,1,1,1,13854,13887,12
Task 13854,Job 1,13,5,4,10,0,17,23,6,4,2,2,13854,13887,9
Task 13855,Job 0,7,9,2,6,0,9,13,4,2,2,0,13855,13889,15
Task 13855,Job 1,12,5,2,11,0,14,23,9,2,4,2,13855,13889,3
Task 13856,Job 0,10,9,3,6,0,13,16,3,3,1,0,13856,13889,5
Task 13856,Job 1,15,7,2,12,0,17,27,10,2,3,2,13856,13889,3
Task 13857,Job 0,2,8,4,12,0,6,14,8,4,4,0,13857,13890,7
Task 13857,Job 1,7,10,3,12,0,10,19,9,3,4,0,13857,13890,19
Task 13858,Job 0,6,10,4,12,0,10,18,8,4,4,2,13858,13891,9
Task 13858,Job 1,11,8,2,6,0,13,17,4,2,1,2,13858,13891,19
Task 13859,Job 0,7,7,2,8,1,9,15,6,2,2,0,13859,13892,4
Task 13859,Job 1,12,4,2,12,0,14,24,10,2,3,1,13859,13892,20
Task 13860,Job 0,9,5,1,8,1,10,17,7,1,1,2,13860,13893,4
Task 13860,Job 1,14,7,1,9,0,15,23,8,1,2,0,13860,13893,6
Task 13861,Job 0,1,7,4,11,0,5,12,7,4,2,2,13861,13894,4
Task 13861,Job 1,6,9,2,11,0,8,17,9,2,2,1,13861,13894,4
Task 13862,Job 0,9,4,3,6,0,12,15,3,3,2,2,13862,13896,5
Task 13862,Job 1,14,10,2,11,0,16,25,9,2,2,2,13862,13896,20
Task 13863,Job 0,9,4,3,8,0,12,17,5,3,2,2,13863,13897,2
Task 13863,Job 1,14,8,4,8,0,18,22,4,4,4,1,13863,13897,7
Task 13864,Job 0,6,4,2,6,1,8,12,4,2,4,0,13864,13897,13
Task 13864,Job 1,11,8,2,9,0,13,20,7,2,2,1,13864,13897,4
Task 13865,Job 0,2,6,1,10,1,3,12,9,1,1,1,13865,13899,3
Task 13865,Job 1,7,8,4,7,1,11,14,3,4,1,0,13865,13899,18
Task 13866,Job 0,1,10,3,6,0,4,7,3,3,3,0,13866,13900,2
Task 13866,Job 1,6,5,4,6,0,10,12,2,4,1,0,13866,13900,15
Task 13867,Job 0,4,6,2,6,0,6,10,4,2,4,0,13867,13900,14
Task 13867,Job 1,9,5,1,11,1,10,20,10,1,4,0,13867,13900,10
Task 13868,Job 0,4,9,1,6,0,5,10,5,1,1,2,13868,13901,20
Task 13868,Job 1,9,8,1,6,0,10,15,5,1,2,0,13868,13901,17
Task 13869,Job 0,10,9,2,8,0,12,18,6,2,1,2,13869,13903,2
Task 13869,Job 1,15,8,2,8,0,17,23,6,2,2,1,13869,13903,5
Task 13870,Job 0,4,4,3,11,0,7,15,8,3,3,0,13870,13903,19
Task 13870,Job 1,9,6,3,12,0,12,21,9,3,3,0,13870,13903,8
Task 13871,Job 0,6,6,2,7,0,8,13,5,2,4,1,13871,13904,17
Task 13871,Job 1,11,8,3,9,0,14,20,6,3,2,2,13871,13904,11
Task 13872,Job 0,4,4,1,10,0,5,14,9,1,1,2,13872,13905,19
Task 13872,Job 1,9,7,3,7,0,12,16,4,3,3,2,13872,13905,5
Task 13873,Job 0,10,6,1,10,0,11,20,9,1,3,0,13873,13907,7
Task 13873,Job 1,15,7,4,9,1,19,24,5,4,4,1,13873,13907,13
Task 13874,Job 0,10,10,2,7,0,12,17,5,2,1,2,13874,13908,3
Task 13874,Job 1,15,7,4,11,0,19,26,7,4,3,1,13874,13908,14
Task 13875,Job 0,7,4,3,10,1,10,17,7,3,2,0,13875,13908,20
Task 13875,Job 1,12,7,2,12,1,14,24,10,2,1,2,13875,13908,4
Task 13876,Job 0,2,8,3,11,0,5,13,8,3,1,2,13876,13909,15
Task 13876,Job 1,7,9,2,10,0,9,17,8,2,3,0,13876,13909,13
Task 13877,Job 0,2,8,2,8,1,4,10,6,2,4,0,13877,13911,2
Task 13877,Job 1,7,10,2,12,0,9,19,10,2,3,2,13877,13911,19
Task 13878,Job 0,1,10,4,8,0,5,9,4,4,2,2,13878,13911,2
Task 13878,Job 1,6,4,4,12,0,10,18,8,4,1,0,13878,13911,9
Task 13879,Job 0,7,7,3,11,0,10,18,8,3,1,0,13879,13912,5
Task 13879,Job 1,12,10,1,7,0,13,19,6,1,3,1,13879,13912,7
Task 13880,Job 0,9,10,1,8,0,10,17,7,1,4,2,13880,13914,13
Task 13880,Job 1,14,5,1,8,0,15,22,7,1,4,0,13880,13914,20
Task 13881,Job 0,3,5,3,7,0,6,10,4,3,4,0,13881,13914,9
Task 13881,Job 1,8,10,2,9,0,10,17,7,2,3,0,13881,13914,13
Task 13882,Job 0,8,8,3,12,1,11,20,9,3,2,0,13882,13916,11
Task 13882,Job 1,13,7,1,11,0,14,24,10,1,1,0,13882,13916,14
Task 13883,Job 0,10,8,1,11,0,11,21,10,1,2,1,13883,13917,12
Task 13883,Job 1,15,9,4,6,1,19,21,2,4,2,1,13883,13917,20
Task 13884,Job 0,6,5,3,9,0,9,15,6,3,2,0,13884,13917,9
Task 13884,Job 1,11,5,4,12,0,15,23,8,4,1,0,13884,13917,18
Task 13885,Job 0,10,6,1,10,1,11,20,9,1,3,1,13885,13918,5
Task 13885,Job 1,15,6,4,6,0,19,21,2,4,1,1,13885,13918,3
Task 13886,Job 0,9,8,4,6,0,13,15,2,4,2,0,13886,13919,17
Task 13886,Job 1,14,9,4,11,0,18,25,7,4,1,2,13886,13919,20
Task 13887,Job 0,6,5,3,12,1,9,18,9,3,4,2,13887,13921,2
Task 13887,Job 1,11,9,3,9,0,14,20,6,3,4,2,13887,13921,16
Task 13888,Job 0,4,10,2,8,0,6,12,6,2,3,0,13888,13921,15
Task 13888,Job 1,9,10,4,8,0,13,17,4,4,3,0,13888,13921,14
Task 13889,Job 0,2,7,1,9,0,3,11,8,1,4,0,13889,13922,7
Task 13889,Job 1,7,6,4,9,0,11,16,5,4,3,2,13889,13922,4
Task 13890,Job 0,7,6,3,10,0,10,17,7,3,4,2,13890,13923,9
Task 13890,Job 1,12,6,3,9,1,15,21,6,3,4,0,13890,13923,13
Task 13891,Job 0,6,5,4,12,0,10,18,8,4,3,1,13891,13924,6
Task 13891,Job 1,11,5,3,10,0,14,21,7,3,4,2,13891,13924,10
Task 13892,Job 0,9,6,4,11,0,13,20,7,4,3,0,13892,13926,14
Task 13892,Job 1,14,7,4,8,1,18,22,4,4,2,1,13892,13926,18
Task 13893,Job 0,10,6,4,9,0,14,19,5,4,4,1,13893,13926,3
Task 13893,Job 1,15,5,4,9,0,19,24,5,4,1,0,13893,13926,5
Task 13894,Job 0,4,8,4,6,1,8,10,2,4,3,1,13894,13928,6
Task 13894,Job 1,9,7,2,8,0,11,17,6,2,1,1,13894,13928,5
Task 13895,Job 0,9,4,4,7,0,13,16,3,4,3,1,13895,13929,8
Task 13895,Job 1,14,5,1,10,0,15,24,9,1,4,0,13895,13929,15
Task 13896,Job 0,8,6,1,6,1,9,14,5,1,4,2,13896,13930,17
Task 13896,Job 1,13,9,3,12,1,16,25,9,3,4,1,13896,13930,19
Task 13897,Job 0,6,8,2,8,0,8,14,6,2,1,1,13897,13931,14
Task 13897,Job 1,11,6,3,6,0,14,17,3,3,3,0,13897,13931,13
Task 13898,Job 0,6,7,3,9,0,9,15,6,3,1,2,13898,13932,9
Task 13898,Job 1,11,8,2,6,1,13,17,4,2,3,2,13898,13932,7
Task 13899,Job 0,3,9,1,12,0,4,15,11,1,1,0,13899,13933,17
Task 13899,Job 1,8,5,2,12,0,10,20,10,2,2,2,13899,13933,11
Task 13900,Job 0,1,7,4,9,0,5,10,5,4,1,0,13900,13934,9
Task 13900,Job 1,6,8,1,6,0,7,12,5,1,1,1,13900,13934,15
Task 13901,Job 0,8,4,4,8,0,12,16,4,4,1,0,13901,13934,3
Task 13901,Job 1,13,9,2,8,0,15,21,6,2,3,1,13901,13934,18
Task 13902,Job 0,10,5,3,6,0,13,16,3,3,1,2,13902,13936,7
Task 13902,Job 1,15,9,2,9,1,17,24,7,2,2,1,13902,13936,16
Task 13903,Job 0,1,9,2,10,0,3,11,8,2,2,1,13903,13937,3
Task 13903,Job 1,6,9,3,9,0,9,15,6,3,1,0,13903,13937,11
Task 13904,Job 0,1,8,1,12,0,2,13,11,1,2,2,13904,13937,6
Task 13904,Job 1,6,10,2,12,1,8,18,10,2,4,2,13904,13937,4
Task 13905,Job 0,7,8,1,8,0,8,15,7,1,1,0,13905,13939,6
Task 13905,Job 1,12,9,1,6,0,13,18,5,1,3,1,13905,13939,13
Task 13906,Job 0,6,4,3,12,0,9,18,9,3,3,1,13906,13940,5
Task 13906,Job 1,11,8,1,6,0,12,17,5,1,3,2,13906,13940,6
Task 13907,Job 0,2,7,4,7,1,6,9,3,4,1,1,13907,13940,8
Task 13907,Job 1,7,9,2,9,0,9,16,7,2,3,2,13907,13940,16
Task 13908,Job 0,5,6,4,10,0,9,15,6,4,4,1,13908,13942,10
Task 13908,Job 1,10,5,2,7,0,12,17,5,2,1,2,13908,13942,17
Task 13909,Job 0,2,5,4,10,1,6,12,6,4,2,0,13909,13942,16
Task 13909,Job 1,7,5,2,6,0,9,13,4,2,2,2,13909,13942,10
Task 13910,Job 0,3,6,2,7,1,5,10,5,2,1,1,13910,13943,17
Task 13910,Job 1,8,10,1,9,0,9,17,8,1,2,0,13910,13943,17
Task 13911,Job 0,1,4,4,9,1,5,10,5,4,2,0,13911,13944,17
Task 13911,Job 1,6,7,1,8,0,7,14,7,1,3,1,13911,13944,12
Task 13912,Job 0,1,6,4,12,0,5,13,8,4,1,0,13912,13945,19
Task 13912,Job 1,6,7,3,12,1,9,18,9,3,1,0,13912,13945,8
Task 13913,Job 0,4,4,4,6,0,8,10,2,4,4,0,13913,13947,4
Task 13913,Job 1,9,5,4,9,0,13,18,5,4,4,2,13913,13947,9
Task 13914,Job 0,1,9,4,6,0,5,7,2,4,1,1,13914,13947,20
Task 13914,Job 1,6,7,2,10,0,8,16,8,2,3,2,13914,13947,11
Task 13915,Job 0,1,4,2,6,0,3,7,4,2,3,2,13915,13948,7
Task 13915,Job 1,6,9,1,10,0,7,16,9,1,3,2,13915,13948,7
Task 13916,Job 0,9,8,1,12,0,10,21,11,1,1,1,13916,13950,12
Task 13916,Job 1,14,5,1,9,1,15,23,8,1,3,0,13916,13950,8
Task 13917,Job 0,2,7,2,9,0,4,11,7,2,3,1,13917,13951,12
Task 13917,Job 1,7,6,4,6,0,11,13,2,4,3,2,13917,13951,2
Task 13918,Job 0,1,4,2,12,0,3,13,10,2,2,1,13918,13952,2
Task 13918,Job 1,6,9,1,9,0,7,15,8,1,1,0,13918,13952,7
Task 13919,Job 0,7,4,3,9,0,10,16,6,3,3,0,13919,13953,18
Task 13919,Job 1,12,6,4,8,0,16,20,4,4,4,2,13919,13953,4
Task 13920,Job 0,5,10,2,12,0,7,17,10,2,2,2,13920,13953,15
Task 13920,Job 1,10,8,3,7,0,13,17,4,3,4,2,13920,13953,9
Task 13921,Job 0,2,7,4,11,1,6,13,7,4,1,0,13921,13955,13
Task 13921,Job 1,7,9,3,8,0,10,15,5,3,4,2,13921,13955,13
Task 13922,Job 0,7,9,2,7,0,9,14,5,2,4,0,13922,13955,19
Task 13922,Job 1,12,7,4,10,0,16,22,6,4,3,2,13922,13955,13
Task 13923,Job 0,4,5,2,9,0,6,13,7,2,3,1,13923,13957,8
Task 13923,Job 1,9,4,4,7,0,13,16,3,4,3,1,13923,13957,10
Task 13924,Job 0,4,7,1,12,0,5,16,11,1,1,1,13924,13958,5
Task 13924,Job 1,9,7,1,12,0,10,21,11,1,1,1,13924,13958,14
Task 13925,Job 0,8,6,4,11,1,12,19,7,4,3,1,13925,13959,6
Task 13925,Job 1,13,9,4,9,0,17,22,5,4,3,1,13925,13959,19
Task 13926,Job 0,5,10,4,6,1,9,11,2,4,1,1,13926,13959,18
Task 13926,Job 1,10,7,1,12,0,11,22,11,1,4,0,13926,13959,18
Task 13927,Job 0,3,4,2,8,0,5,11,6,2,1,0,13927,13961,7
Task 13927,Job 1,8,7,3,12,0,11,20,9,3,4,2,13927,13961,18
Task 13928,Job 0,6,6,4,8,0,10,14,4,4,3,1,13928,13962,12
Task 13928,Job 1,11,6,2,7,0,13,18,5,2,3,2,13928,13962,20
Task 13929,Job 0,8,6,2,12,0,10,20,10,2,3,0,13929,13962,7
Task 13929,Job 1,13,7,1,12,1,14,25,11,1,2,2,13929,13962,16
Task 13930,Job 0,10,4,4,7,0,14,17,3,4,2,1,13930,13963,17
Task 13930,Job 1,15,4,4,6,0,19,21,2,4,3,1,13930,13963,11
Task 13931,Job 0,6,7,1,12,0,7,18,11,1,1,2,13931,13965,20
Task 13931,Job 1,11,9,1,7,1,12,18,6,1,4,2,13931,13965,15
Task 13932,Job 0,5,8,3,10,0,8,15,7,3,3,1,13932,13965,17
Task 13932,Job 1,10,9,2,11,0,12,21,9,2,3,2,13932,13965,8
Task 13933,Job 0,7,8,2,12,0,9,19,10,2,1,2,13933,13966,11
Task 13933,Job 1,12,5,4,8,0,16,20,4,4,1,2,13933,13966,9
Task 13934,Job 0,5,10,2,10,0,7,15,8,2,2,0,13934,13968,3
Task 13934,Job 1,10,9,1,11,1,11,21,10,1,2,2,13934,13968,20
Task 13935,Job 0,3,7,2,7,0,5,10,5,2,3,1,13935,13968,17
Task 13935,Job 1,8,9,4,6,0,12,14,2,4,3,2,13935,13968,17
Task 13936,Job 0,8,7,2,9,1,10,17,7,2,4,0,13936,13970,19
Task 13936,Job 1,13,7,1,7,0,14,20,6,1,2,1,13936,13970,12
Task 13937,Job 0,6,7,4,8,0,10,14,4,4,3,2,13937,13971,15
Task 13937,Job 1,11,5,4,10,0,15,21,6,4,1,1,13937,13971,14
Task 13938,Job 0,1,4,1,10,0,2,11,9,1,1,0,13938,13971,14
Task 13938,Job 1,6,5,4,8,0,10,14,4,4,4,1,13938,13971,7
Task 13939,Job 0,1,5,3,6,0,4,7,3,3,1,2,13939,13972,12
Task 13939,Job 1,6,10,3,6,0,9,12,3,3,3,0,13939,13972,14
Task 13940,Job 0,2,5,2,12,0,4,14,10,2,1,2,13940,13974,7
Task 13940,Job 1,7,7,3,8,0,10,15,5,3,3,1,13940,13974,7
Task 13941,Job 0,4,4,2,11,0,6,15,9,2,1,2,13941,13974,8
Task 13941,Job 1,9,5,4,11,0,13,20,7,4,2,0,13941,13974,15
Task 13942,Job 0,6,5,4,11,0,10,17,7,4,4,1,13942,13975,10
Task 13942,Job 1,11,10,2,11,0,13,22,9,2,2,1,13942,13975,7
Task 13943,Job 0,1,4,3,9,1,4,10,6,3,2,0,13943,13976,17
Task 13943,Job 1,6,8,3,10,0,9,16,7,3,1,0,13943,13976,17
Task 13944,Job 0,5,4,4,7,0,9,12,3,4,1,2,13944,13978,5
Task 13944,Job 1,10,6,3,8,0,13,18,5,3,4,1,13944,13978,19
Task 13945,Job 0,6,6,1,6,0,7,12,5,1,1,2,13945,13978,12
Task 13945,Job 1,11,10,3,8,1,14,19,5,3,1,1,13945,13978,15
Task 13946,Job 0,4,4,4,7,0,8,11,3,4,1,0,13946,13979,10
Task 13946,Job 1,9,9,1,8,0,10,17,7,1,4,1,13946,13979,13
Task 13947,Job 0,4,9,1,11,0,5,15,10,1,2,0,13947,13981,18
Task 13947,Job 1,9,9,4,8,0,13,17,4,4,4,2,13947,13981,20
Task 13948,Job 0,3,9,2,9,0,5,12,7,2,4,0,13948,13981,17
Task 13948,Job 1,8,10,3,10,0,11,18,7,3,4,1,13948,13981,12
Task 13949,Job 0,7,5,2,12,0,9,19,10,2,2,1,13949,13983,2
Task 13949,Job 1,12,7,1,8,0,13,20,7,1,1,0,13949,13983,10
Task 13950,Job 0,5,10,4,6,1,9,11,2,4,4,1,13950,13984,20
Task 13950,Job 1,10,7,4,9,0,14,19,5,4,1,1,13950,13984,11
Task 13951,Job 0,9,7,4,11,0,13,20,7,4,1,2,13951,13985,20
Task 13951,Job 1,14,5,1,10,1,15,24,9,1,1,2,13951,13985,3
Task 13952,Job 0,3,8,3,9,0,6,12,6,3,2,2,13952,13986,16
Task 13952,Job 1,8,5,2,12,0,10,20,10,2,4,1,13952,13986,9
Task 13953,Job 0,7,7,2,12,1,9,19,10,2,1,1,13953,13987,15
Task 13953,Job 1,12,4,4,10,0,16,22,6,4,4,1,13953,13987,3
Task 13954,Job 0,4,9,3,8,0,7,12,5,3,4,1,13954,13987,19
Task 13954,Job 1,9,6,3,10,1,12,19,7,3,3,0,13954,13987,15
Task 13955,Job 0,10,5,1,11,0,11,21,10,1,3,2,13955,13988,18
Task 13955,Job 1,15,10,3,6,0,18,21,3,3,2,0,13955,13988,18
Task 13956,Job 0,6,9,1,9,0,7,15,8,1,1,1,13956,13989,2
Task 13956,Job 1,11,8,3,12,0,14,23,9,3,2,1,13956,13989,19
Task 13957,Job 0,6,5,4,9,1,10,15,5,4,3,0,13957,13991,19
Task 13957,Job 1,11,5,4,8,0,15,19,4,4,4,1,13957,13991,3
Task 13958,Job 0,7,5,4,12,0,11,19,8,4,4,0,13958,13992,12
Task 13958,Job 1,12,4,1,9,0,13,21,8,1,4,2,13958,13992,14
Task 13959,Job 0,3,7,2,9,1,5,12,7,2,3,1,13959,13992,13
Task 13959,Job 1,8,5,3,6,0,11,14,3,3,1,1,13959,13992,7
Task 13960,Job 0,10,8,1,7,0,11,17,6,1,3,0,13960,13993,11
Task 13960,Job 1,15,8,3,9,0,18,24,6,3,2,2,13960,13993,7
Task 13961,Job 0,4,6,3,6,1,7,10,3,3,4,0,13961,13994,14
Task 13961,Job 1,9,10,4,10,0,13,19,6,4,1,0,13961,13994,9
Task 13962,Job 0,7,4,2,12,0,9,19,10,2,2,1,13962,13996,20
Task 13962,Job 1,12,9,2,12,0,14,24,10,2,1,0,13962,13996,7
Task 13963,Job 0,6,4,2,11,0,8,17,9,2,2,1,13963,13996,9
Task 13963,Job 1,11,4,2,8,0,13,19,6,2,1,1,13963,13996,12
Task 13964,Job 0,7,4,2,6,1,9,13,4,2,4,2,13964,13997,19
Task 13964,Job 1,12,7,3,7,0,15,19,4,3,4,1,13964,13997,6
Task 13965,Job 0,10,4,2,11,0,12,21,9,2,2,1,13965,13999,17
Task 13965,Job 1,15,4,3,10,1,18,25,7,3,1,0,13965,13999,17
Task 13966,Job 0,5,4,2,11,1,7,16,9,2,4,0,13966,14000,8
Task 13966,Job 1,10,10,3,9,0,13,19,6,3,1,0,13966,14000,4
Task 13967,Job 0,1,4,1,11,0,2,12,10,1,4,1,13967,14000,20
Task 13967,Job 1,6,6,2,11,1,8,17,9,2,1,0,13967,14000,17
Task 13968,Job 0,7,8,2,11,0,9,18,9,2,2,0,13968,14002,15
Task 13968,Job 1,12,7,3,9,0,15,21,6,3,1,2,13968,14002,7
Task 13969,Job 0,4,9,1,9,0,5,13,8,1,1,1,13969,14002,17
Task 13969,Job 1,9,7,4,12,0,13,21,8,4,2,2,13969,14002,11
Task 13970,Job 0,2,7,1,7,0,3,9,6,1,4,0,13970,14003,6
Task 13970,Job 1,7,9,4,10,0,11,17,6,4,3,2,13970,14003,6
Task 13971,Job 0,7,8,1,8,0,8,15,7,1,2,1,13971,14005,14
Task 13971,Job 1,12,7,2,7,0,14,19,5,2,3,0,13971,14005,18
Task 13972,Job 0,4,5,1,6,0,5,10,5,1,4,0,13972,14006,9
Task 13972,Job 1,9,8,3,10,1,12,19,7,3,4,1,13972,14006,5
Task 13973,Job 0,2,9,2,6,0,4,8,4,2,4,1,13973,14007,2
Task 13973,Job 1,7,9,3,10,1,10,17,7,3,1,2,13973,14007,14
Task 13974,Job 0,5,8,3,10,1,8,15,7,3,2,0,13974,14008,19
Task 13974,Job 1,10,6,4,9,0,14,19,5,4,1,1,13974,14008,15
Task 13975,Job 0,7,10,3,9,0,10,16,6,3,3,1,13975,14009,7
Task 13975,Job 1,12,4,2,10,0,14,22,8,2,1,1,13975,14009,2
Task 13976,Job 0,4,5,3,12,0,7,16,9,3,2,0,13976,14010,9
Task 13976,Job 1,9,4,4,9,0,13,18,5,4,4,1,13976,14010,7
Task 13977,Job 0,4,7,1,11,0,5,15,10,1,1,2,13977,14011,20
Task 13977,Job 1,9,10,4,10,0,13,19,6,4,4,1,13977,14011,16
Task 13978,Job 0,9,9,4,12,1,13,21,8,4,2,2,13978,14012,2
Task 13978,Job 1,14,7,3,6,0,17,20,3,3,1,0,13978,14012,3
Task 13979,Job 0,2,10,4,9,0,6,11,5,4,2,0,13979,14013,6
Task 13979,Job 1,7,10,3,6,0,10,13,3,3,2,0,13979,14013,15
Task 13980,Job 0,1,5,1,11,0,2,12,10,1,3,2,13980,14014,7
Task 13980,Job 1,6,10,2,6,0,8,12,4,2,4,2,13980,14014,12
Task 13981,Job 0,6,9,2,8,0,8,14,6,2,1,0,13981,14014,13
Task 13981,Job 1,11,7,4,8,0,15,19,4,4,1,1,13981,14014,14
Task 13982,Job 0,8,8,4,9,1,12,17,5,4,3,1,13982,14016,13
Task 13982,Job 1,13,6,4,6,0,17,19,2,4,4,0,13982,14016,11
Task 13983,Job 0,10,5,4,6,1,14,16,2,4,1,0,13983,14016,18
Task 13983,Job 1,15,9,4,10,1,19,25,6,4,1,2,13983,14016,3
Task 13984,Job 0,4,9,3,10,0,7,14,7,3,1,2,13984,14017,6
Task 13984,Job 1,9,8,4,10,0,13,19,6,4,4,2,13984,14017,20
Task 13985,Job 0,2,5,2,8,0,4,10,6,2,3,2,13985,14019,18
Task 13985,Job 1,7,7,4,9,0,11,16,5,4,1,1,13985,14019,6
Task 13986,Job 0,2,9,1,8,1,3,10,7,1,3,2,13986,14019,15
Task 13986,Job 1,7,6,4,7,0,11,14,3,4,3,0,13986,14019,6
Task 13987,Job 0,2,10,4,10,1,6,12,6,4,1,2,13987,14020,9
Task 13987,Job 1,7,7,3,12,0,10,19,9,3,4,2,13987,14020,13
Task 13988,Job 0,4,8,3,6,0,7,10,3,3,4,2,13988,14022,7
Task 13988,Job 1,9,5,4,10,0,13,19,6,4,3,0,13988,14022,7
Task 13989,Job 0,10,5,2,11,0,12,21,9,2,4,2,13989,14022,15
Task 13989,Job 1,15,7,4,6,1,19,21,2,4,4,1,13989,14022,19
Task 13990,Job 0,9,7,3,6,0,12,15,3,3,1,2,13990,14024,16
Task 13990,Job 1,14,6,3,11,0,17,25,8,3,1,2,13990,14024,14
Task 13991,Job 0,3,8,1,10,0,4,13,9,1,3,0,13991,14025,20
Task 13991,Job 1,8,10,4,11,0,12,19,7,4,2,1,13991,14025,20
Task 13992,Job 0,4,10,3,10,0,7,14,7,3,2,0,13992,14025,6
Task 13992,Job 1,9,10,3,7,0,12,16,4,3,3,1,13992,14025,16
Task 13993,Job 0,6,8,4,12,0,10,18,8,4,1,1,13993,14027,11
Task 13993,Job 1,11,6,4,12,1,15,23,8,4,3,1,13993,14027,12
Task 13994,Job 0,6,5,4,6,0,10,12,2,4,2,0,13994,14028,6
Task 13994,Job 1,11,9,4,7,0,15,18,3,4,1,0,13994,14028,8
Task 13995,Job 0,9,9,3,10,0,12,19,7,3,2,1,13995,14029,11
Task 13995,Job 1,14,5,3,8,1,17,22,5,3,1,2,13995,14029,5
Task 13996,Job 0,4,5,4,10,0,8,14,6,4,4,0,13996,14030,3
Task 13996,Job 1,9,9,1,8,0,10,17,7,1,2,1,13996,14030,20
Task 13997,Job 0,9,9,2,11,0,11,20,9,2,1,1,13997,14030,17
Task 13997,Job 1,14,6,2,11,0,16,25,9,2,1,1,13997,14030,10
Task 13998,Job 0,6,4,2,12,1,8,18,10,2,2,1,13998,14032,13
Task 13998,Job 1,11,9,1,7,0,12,18,6,1,3,0,13998,14032,9
Task 13999,Job 0,9,10,1,11,0,10,20,10,1,3,0,13999,14033,4
Task 13999,Job 1,14,5,4,6,1,18,20,2,4,1,0,13999,14033,10
Task 14000,Job 0,4,5,1,10,1,5,14,9,1,4,2,14000,14033,20
Task 14000,Job 1,9,6,4,12,0,13,21,8,4,1,1,14000,14033,13
Task 14001,Job 0,2,6,4,10,0,6,12,6,4,1,2,14001,14034,16
Task 14001,Job 1,7,6,4,6,1,11,13,2,4,4,2,14001,14034,15
Task 14002,Job 0,1,9,1,6,0,2,7,5,1,2,2,14002,14036,16
Task 14002,Job 1,6,9,4,8,0,10,14,4,4,2,0,14002,14036,10
Task 14003,Job 0,8,6,3,10,0,11,18,7,3,3,0,14003,14037,17
Task 14003,Job 1,13,6,4,7,0,17,20,3,4,2,1,14003,14037,11
Task 14004,Job 0,9,6,4,9,0,13,18,5,4,4,2,14004,14037,6
Task 14004,Job 1,14,8,1,10,0,15,24,9,1,4,2,14004,14037,17
Task 14005,Job 0,2,10,1,6,0,3,8,5,1,3,2,14005,14039,13
Task 14005,Job 1,7,7,3,9,0,10,16,6,3,4,1,14005,14039,4
Task 14006,Job 0,10,7,1,9,1,11,19,8,1,2,0,14006,14040,19
Task 14006,Job 1,15,7,3,8,0,18,23,5,3,2,1,14006,14040,14
Task 14007,Job 0,2,10,1,10,0,3,12,9,1,1,1,14007,14041,18
Task 14007,Job 1,7,7,2,10,1,9,17,8,2,1,1,14007,14041,11
Task 14008,Job 0,1,6,4,12,0,5,13,8,4,3,2,14008,14042,7
Task 14008,Job 1,6,7,3,6,0,9,12,3,3,4,1,14008,14042,13
Task 14009,Job 0,4,6,1,6,1,5,10,5,1,3,0,14009,14043,18
Task 14009,Job 1,9,7,4,6,0,13,15,2,4,4,1,14009,14043,18
Task 14010,Job 0,6,5,2,7,0,8,13,5,2,3,1,14010,14043,3
Task 14010,Job 1,11,9,3,6,1,14,17,3,3,1,2,14010,14043,11
Task 14011,Job 0,8,7,3,12,0,11,20,9,3,2,2,14011,14045,8
Task 14011,Job 1,13,5,3,6,0,16,19,3,3,1,2,14011,14045,6
Task 14012,Job 0,3,8,2,9,0,5,12,7,2,4,1,14012,14045,3
Task 14012,Job 1,8,5,4,8,0,12,16,4,4,3,0,14012,14045,16
Task 14013,Job 0,1,6,2,10,0,3,11,8,2,2,1,14013,14047,8
Task 14013,Job 1,6,8,3,7,0,9,13,4,3,4,1,14013,14047,2
Task 14014,Job 0,1,8,1,11,1,2,12,10,1,3,1,14014,14048,18
Task 14014,Job 1,6,6,4,8,0,10,14,4,4,2,2,14014,14048,15
Task 14015,Job 0,8,9,3,12,1,11,20,9,3,3,2,14015,14049,18
Task 14015,Job 1,13,7,2,9,1,15,22,7,2,4,1,14015,14049,14
Task 14016,Job 0,5,5,4,11,0,9,16,7,4,1,0,14016,14050,5
Task 14016,Job 1,10,8,2,7,1,12,17,5,2,1,0,14016,14050,11
Task 14017,Job 0,2,5,2,8,0,4,10,6,2,4,0,14017,14050,9
Task 14017,Job 1,7,9,4,10,0,11,17,6,4,4,1,14017,14050,13
Task 14018,Job 0,10,5,2,11,0,12,21,9,2,2,1,14018,14052,14
Task 14018,Job 1,15,10,2,6,0,17,21,4,2,2,0,14018,14052,7
Task 14019,Job 0,7,4,1,10,0,8,17,9,1,2,0,14019,14053,19
Task 14019,Job 1,12,7,1,6,1,13,18,5,1,2,2,14019,14053,6
Task 14020,Job 0,10,5,4,9,1,14,19,5,4,1,1,14020,14054,6
Task 14020,Job 1,15,9,4,11,0,19,26,7,4,1,0,14020,14054,9
Task 14021,Job 0,8,8,4,6,0,12,14,2,4,2,2,14021,14054,13
Task 14021,Job 1,13,9,2,9,0,15,22,7,2,4,0,14021,14054,20
Task 14022,Job 0,10,4,2,10,0,12,20,8,2,1,1,14022,14056,13
Task 14022,Job 1,15,4,1,7,1,16,22,6,1,3,2,14022,14056,20
Task 14023,Job 0,7,10,3,11,0,10,18,8,3,3,2,14023,14057,17
Task 14023,Job 1,12,9,4,12,0,16,24,8,4,4,0,14023,14057,20
Task 14024,Job 0,10,6,3,12,0,13,22,9,3,1,0,14024,14058,14
Task 14024,Job 1,15,9,1,10,0,16,25,9,1,1,2,14024,14058,17
Task 14025,Job 0,3,10,4,12,1,7,15,8,4,2,1,14025,14058,5
Task 14025,Job 1,8,10,2,6,0,10,14,4,2,3,2,14025,14058,19
Task 14026,Job 0,2,10,1,7,0,3,9,6,1,4,1,14026,14059,5
Task 14026,Job 1,7,9,2,9,0,9,16,7,2,3,2,14026,14059,18
Task 14027,Job 0,7,5,2,10,1,9,17,8,2,2,1,14027,14060,3
Task 14027,Job 1,12,7,2,6,1,14,18,4,2,1,0,14027,14060,3
Task 14028,Job 0,7,5,2,8,0,9,15,6,2,3,1,14028,14061,13
Task 14028,Job 1,12,4,4,12,1,16,24,8,4,4,0,14028,14061,13
Task 14029,Job 0,5,8,3,7,0,8,12,4,3,2,1,14029,14062,18
Task 14029,Job 1,10,10,3,8,0,13,18,5,3,2,1,14029,14062,19
Task 14030,Job 0,2,8,1,12,1,3,14,11,1,1,1,14030,14063,20
Task 14030,Job 1,7,9,2,9,1,9,16,7,2,1,2,14030,14063,18
Task 14031,Job 0,10,4,1,12,0,11,22,11,1,3,2,14031,14065,18
Task 14031,Job 1,15,9,2,9,0,17,24,7,2,4,2,14031,14065,19
Task 14032,Job 0,8,9,2,7,0,10,15,5,2,1,1,14032,14066,12
Task 14032,Job 1,13,6,2,10,1,15,23,8,2,4,0,14032,14066,3
Task 14033,Job 0,9,5,4,12,0,13,21,8,4,4,0,14033,14067,9
Task 14033,Job 1,14,4,1,9,0,15,23,8,1,4,2,14033,14067,10
Task 14034,Job 0,3,4,3,6,0,6,9,3,3,2,1,14034,14068,18
Task 14034,Job 1,8,6,1,9,0,9,17,8,1,3,0,14034,14068,17
Task 14035,Job 0,9,5,3,12,1,12,21,9,3,3,2,14035,14069,5
Task 14035,Job 1,14,10,2,12,1,16,26,10,2,1,0,14035,14069,19
Task 14036,Job 0,8,9,4,9,0,12,17,5,4,3,0,14036,14069,12
Task 14036,Job 1,13,10,4,11,0,17,24,7,4,3,0,14036,14069,5
Task 14037,Job 0,4,8,3,12,0,7,16,9,3,4,1,14037,14071,7
Task 14037,Job 1,9,5,4,8,0,13,17,4,4,2,1,14037,14071,4
Task 14038,Job 0,4,6,2,6,0,6,10,4,2,1,1,14038,14071,11
Task 14038,Job 1,9,8,1,9,0,10,18,8,1,2,0,14038,14071,17
Task 14039,Job 0,2,8,4,10,0,6,12,6,4,4,0,14039,14072,3
Task 14039,Job 1,7,10,1,9,0,8,16,8,1,4,1,14039,14072,12
Task 14040,Job 0,2,9,4,11,0,6,13,7,4,2,0,14040,14074,8
Task 14040,Job 1,7,6,2,11,1,9,18,9,2,4,0,14040,14074,18
Task 14041,Job 0,9,8,3,7,0,12,16,4,3,4,0,14041,14074,18
Task 14041,Job 1,14,4,4,12,0,18,26,8,4,4,1,14041,14074,20
Task 14042,Job 0,4,4,2,12,0,6,16,10,2,4,0,14042,14076,15
Task 14042,Job 1,9,6,1,12,0,10,21,11,1,3,2,14042,14076,20
Task 14043,Job 0,9,9,4,8,0,13,17,4,4,4,1,14043,14076,20
Task 14043,Job 1,14,4,4,10,0,18,24,6,4,4,0,14043,14076,4
Task 14044,Job 0,7,7,4,6,0,11,13,2,4,1,2,14044,14078,10
Task 14044,Job 1,12,6,4,11,0,16,23,7,4,3,0,14044,14078,11
Task 14045,Job 0,5,4,2,10,0,7,15,8,2,2,2,14045,14079,3
Task 14045,Job 1,10,8,2,9,1,12,19,7,2,1,0,14045,14079,13
Task 14046,Job 0,6,7,2,7,0,8,13,5,2,4,1,14046,14079,6
Task 14046,Job 1,11,9,3,10,0,14,21,7,3,4,0,14046,14079,15
Task 14047,Job 0,10,9,3,12,0,13,22,9,3,4,0,14047,14081,12
Task 14047,Job 1,15,4,3,10,0,18,25,7,3,4,2,14047,14081,10
Task 14048,Job 0,2,10,1,10,1,3,12,9,1,4,1,14048,14081,14
Task 14048,Job 1,7,8,2,10,0,9,17,8,2,1,1,14048,14081,4
Task 14049,Job 0,9,9,2,12,0,11,21,10,2,3,1,14049,14083,2
Task 14049,Job 1,14,8,2,6,0,16,20,4,2,1,0,14049,14083,19
Task 14050,Job 0,2,8,2,7,0,4,9,5,2,2,2,14050,14083,7
Task 14050,Job 1,7,10,1,10,0,8,17,9,1,3,2,14050,14083,20
Task 14051,Job 0,9,9,3,6,1,12,15,3,3,3,2,14051,14085,7
Task 14051,Job 1,14,9,2,12,0,16,26,10,2,4,1,14051,14085,20
Task 14052,Job 0,2,6,4,8,1,6,10,4,4,2,0,14052,14085,7
Task 14052,Job 1,7,5,1,8,0,8,15,7,1,1,2,14052,14085,5
Task 14053,Job 0,1,9,4,7,1,5,8,3,4,1,0,14053,14086,15
Task 14053,Job 1,6,8,1,9,0,7,15,8,1,3,2,14053,14086,20
Task 14054,Job 0,2,9,2,9,1,4,11,7,2,1,1,14054,14088,7
Task 14054,Job 1,7,8,3,11,0,10,18,8,3,2,1,14054,14088,8
Task 14055,Job 0,4,6,1,6,0,5,10,5,1,1,2,14055,14088,9
Task 14055,Job 1,9,9,4,7,0,13,16,3,4,3,0,14055,14088,19
Task 14056,Job 0,1,4,3,7,1,4,8,4,3,2,0,14056,14089,4
Task 14056,Job 1,6,4,4,10,1,10,16,6,4,4,2,14056,14089,12
Task 14057,Job 0,3,6,4,9,1,7,12,5,4,3,1,14057,14090,6
Task 14057,Job 1,8,6,1,7,1,9,15,6,1,2,2,14057,14090,3
Task 14058,Job 0,5,7,1,11,0,6,16,10,1,3,2,14058,14091,20
Task 14058,Job 1,10,7,2,9,0,12,19,7,2,2,1,14058,14091,7
Task 14059,Job 0,9,8,3,11,0,12,20,8,3,3,2,14059,14093,14
Task 14059,Job 1,14,7,4,8,0,18,22,4,4,1,2,14059,14093,7
Task 14060,Job 0,10,10,2,6,0,12,16,4,2,2,2,14060,14093,17
Task 14060,Job 1,15,7,4,10,1,19,25,6,4,1,1,14060,14093,9
Task 14061,Job 0,9,5,2,11,0,11,20,9,2,4,2,14061,14094,14
Task 14061,Job 1,14,5,4,10,0,18,24,6,4,2,1,14061,14094,11
Task 14062,Job 0,4,6,2,7,0,6,11,5,2,2,0,14062,14095,9
Task 14062,Job 1,9,8,2,7,0,11,16,5,2,2,1,14062,14095,3
Task 14063,Job 0,6,10,2,11,0,8,17,9,2,1,0,14063,14097,20
Task 14063,Job 1,11,4,1,11,0,12,22,10,1,4,2,14063,14097,5
Task 14064,Job 0,10,10,2,10,0,12,20,8,2,4,1,14064,14097,14
Task 14064,Job 1,15,7,4,10,0,19,25,6,4,3,1,14064,14097,16
Task 14065,Job 0,5,10,4,11,1,9,16,7,4,3,2,14065,14099,12
Task 14065,Job 1,10,5,3,6,0,13,16,3,3,2,2,14065,14099,4
Task 14066,Job 0,1,9,2,12,0,3,13,10,2,4,2,14066,14099,14
Task 14066,Job 1,6,10,4,10,0,10,16,6,4,2,2,14066,14099,14
Task 14067,Job 0,7,7,3,9,0,10,16,6,3,2,1,14067,14100,8
Task 14067,Job 1,12,7,2,6,0,14,18,4,2,3,2,14067,14100,18
Task 14068,Job 0,4,4,2,9,0,6,13,7,2,1,1,14068,14101,17
Task 14068,Job 1,9,9,4,12,0,13,21,8,4,3,0,14068,14101,8
Task 14069,Job 0,8,10,3,10,1,11,18,7,3,4,1,14069,14102,6
Task 14069,Job 1,13,9,2,11,0,15,24,9,2,1,2,14069,14102,14
Task 14070,Job 0,10,4,1,11,0,11,21,10,1,3,1,14070,14103,17
Task 14070,Job 1,15,5,4,10,0,19,25,6,4,2,0,14070,14103,10
Task 14071,Job 0,4,9,4,11,0,8,15,7,4,2,0,14071,14104,6
Task 14071,Job 1,9,7,3,11,0,12,20,8,3,3,1,14071,14104,3
Task 14072,Job 0,8,7,3,11,0,11,19,8,3,4,1,14072,14106,18
Task 14072,Job 1,13,10,3,12,0,16,25,9,3,1,1,14072,14106,18
Task 14073,Job 0,3,9,3,11,1,6,14,8,3,2,0,14073,14106,5
Task 14073,Job 1,8,5,4,8,0,12,16,4,4,2,0,14073,14106,16
Task 14074,Job 0,9,8,2,9,0,11,18,7,2,3,0,14074,14107,2
Task 14074,Job 1,14,5,2,11,0,16,25,9,2,4,1,14074,14107,7
Task 14075,Job 0,1,4,4,10,1,5,11,6,4,3,1,14075,14108,4
Task 14075,Job 1,6,6,4,11,0,10,17,7,4,3,0,14075,14108,6
Task 14076,Job 0,3,4,3,12,0,6,15,9,3,2,2,14076,14109,15
Task 14076,Job 1,8,5,2,6,0,10,14,4,2,2,0,14076,14109,14
Task 14077,Job 0,8,10,2,12,0,10,20,10,2,1,2,14077,14110,9
Task 14077,Job 1,13,10,1,11,0,14,24,10,1,2,0,14077,14110,19
Task 14078,Job 0,7,8,1,10,1,8,17,9,1,3,0,14078,14111,10
Task 14078,Job 1,12,9,1,12,1,13,24,11,1,1,1,14078,14111,5
Task 14079,Job 0,9,7,1,11,0,10,20,10,1,4,2,14079,14113,13
Task 14079,Job 1,14,6,1,12,0,15,26,11,1,4,1,14079,14113,8
Task 14080,Job 0,10,4,2,11,1,12,21,9,2,2,1,14080,14114,17
Task 14080,Job 1,15,5,3,7,0,18,22,4,3,3,1,14080,14114,9
Task 14081,Job 0,8,5,1,12,1,9,20,11,1,4,0,14081,14115,11
Task 14081,Job 1,13,10,3,6,0,16,19,3,3,2,1,14081,14115,17
Task 14082,Job 0,2,7,2,6,1,4,8,4,2,4,2,14082,14116,17
Task 14082,Job 1,7,7,2,8,0,9,15,6,2,4,0,14082,14116,3
Task 14083,Job 0,2,6,1,9,0,3,11,8,1,1,2,14083,14116,16
Task 14083,Job 1,7,10,4,12,1,11,19,8,4,2,1,14083,14116,20
Task 14084,Job 0,10,4,3,11,0,13,21,8,3,4,2,14084,14118,15
Task 14084,Job 1,15,4,1,12,0,16,27,11,1,4,1,14084,14118,19
Task 14085,Job 0,5,4,1,6,0,6,11,5,1,2,0,14085,14118,4
Task 14085,Job 1,10,10,2,11,0,12,21,9,2,3,0,14085,14118,7
Task 14086,Job 0,7,9,4,7,0,11,14,3,4,2,1,14086,14120,20
Task 14086,Job 1,12,4,4,9,0,16,21,5,4,2,0,14086,14120,2
Task 14087,Job 0,2,9,2,10,1,4,12,8,2,3,2,14087,14120,12
Task 14087,Job 1,7,10,3,11,0,10,18,8,3,2,1,14087,14120,17
Task 14088,Job 0,1,4,2,10,1,3,11,8,2,2,2,14088,14121,6
Task 14088,Job 1,6,6,3,12,1,9,18,9,3,4,0,14088,14121,12
Task 14089,Job 0,7,9,3,11,1,10,18,8,3,3,2,14089,14123,14
Task 14089,Job 1,12,10,2,9,0,14,21,7,2,3,2,14089,14123,2
Task 14090,Job 0,10,4,1,7,0,11,17,6,1,3,1,14090,14123,14
Task 14090,Job 1,15,7,4,11,0,19,26,7,4,4,1,14090,14123,18
Task 14091,Job 0,10,4,2,9,1,12,19,7,2,3,2,14091,14124,9
Task 14091,Job 1,15,6,2,10,1,17,25,8,2,4,2,14091,14124,14
Task 14092,Job 0,8,10,4,10,0,12,18,6,4,3,1,14092,14125,16
Task 14092,Job 1,13,6,4,9,0,17,22,5,4,2,1,14092,14125,20
Task 14093,Job 0,3,9,1,10,1,4,13,9,1,2,1,14093,14126,20
Task 14093,Job 1,8,8,1,12,0,9,20,11,1,3,2,14093,14126,17
Task 14094,Job 0,2,5,3,9,0,5,11,6,3,3,0,14094,14128,17
Task 14094,Job 1,7,6,2,12,0,9,19,10,2,2,0,14094,14128,8
Task 14095,Job 0,1,9,1,9,0,2,10,8,1,4,1,14095,14128,13
Task 14095,Job 1,6,6,4,6,0,10,12,2,4,4,1,14095,14128,16
Task 14096,Job 0,6,5,2,7,0,8,13,5,2,1,2,14096,14130,12
Task 14096,Job 1,11,4,1,12,1,12,23,11,1,2,0,14096,14130,18
Task 14097,Job 0,6,4,3,9,0,9,15,6,3,4,1,14097,14130,19
Task 14097,Job 1,11,6,4,10,0,15,21,6,4,3,1,14097,14130,4
Task 14098,Job 0,3,7,2,12,0,5,15,10,2,3,1,14098,14131,20
Task 14098,Job 1,8,5,3,8,1,11,16,5,3,3,2,14098,14131,15
Task 14099,Job 0,3,5,3,6,1,6,9,3,3,4,2,14099,14133,2
Task 14099,Job 1,8,9,4,7,0,12,15,3,4,2,1,14099,14133,5
Task 14100,Job 0,3,4,4,6,0,7,9,2,4,2,1,14100,14134,17
Task 14100,Job 1,8,4,3,6,0,11,14,3,3,3,1,14100,14134,9
Task 14101,Job 0,3,6,2,7,0,5,10,5,2,1,1,14101,14134,12
Task 14101,Job 1,8,6,4,10,1,12,18,6,4,3,2,14101,14134,14
Task 14102,Job 0,2,9,4,8,1,6,10,4,4,4,2,14102,14135,13
Task 14102,Job 1,7,6,1,6,0,8,13,5,1,3,2,14102,14135,13
Task 14103,Job 0,2,9,2,6,0,4,8,4,2,2,2,14103,14136,8
Task 14103,Job 1,7,7,2,8,0,9,15,6,2,4,2,14103,14136,17
Task 14104,Job 0,10,9,3,6,0,13,16,3,3,1,0,14104,14137,10
Task 14104,Job 1,15,5,4,7,0,19,22,3,4,4,0,14104,14137,15
Task 14105,Job 0,8,4,4,8,0,12,16,4,4,3,1,14105,14139,12
Task 14105,Job 1,13,9,4,10,0,17,23,6,4,4,0,14105,14139,15
Task 14106,Job 0,3,7,2,7,0,5,10,5,2,2,1,14106,14139,11
Task 14106,Job 1,8,8,3,6,0,11,14,3,3,3,2,14106,14139,7
Task 14107,Job 0,3,5,3,6,0,6,9,3,3,4,2,14107,14140,13
Task 14107,Job 1,8,4,3,8,1,11,16,5,3,3,0,14107,14140,20
Task 14108,Job 0,1,5,2,7,0,3,8,5,2,1,2,14108,14142,4
Task 14108,Job 1,6,10,4,11,1,10,17,7,4,1,1,14108,14142,5
Task 14109,Job 0,5,10,4,6,0,9,11,2,4,4,0,14109,14143,11
Task 14109,Job 1,10,4,1,12,0,11,22,11,1,3,0,14109,14143,5
Task 14110,Job 0,5,4,3,10,0,8,15,7,3,2,1,14110,14144,17
Task 14110,Job 1,10,4,3,7,1,13,17,4,3,4,2,14110,14144,20
Task 14111,Job 0,6,8,3,9,1,9,15,6,3,2,1,14111,14145,15
Task 14111,Job 1,11,9,2,6,0,13,17,4,2,3,1,14111,14145,3
Task 14112,Job 0,2,9,3,6,0,5,8,3,3,3,1,14112,14145,19
Task 14112,Job 1,7,7,3,12,0,10,19,9,3,1,1,14112,14145,2
Task 14113,Job 0,10,9,3,11,0,13,21,8,3,2,1,14113,14146,5
Task 14113,Job 1,15,5,1,12,0,16,27,11,1,3,0,14113,14146,3
Task 14114,Job 0,2,6,4,10,0,6,12,6,4,3,1,14114,14147,4
Task 14114,Job 1,7,9,2,8,0,9,15,6,2,2,1,14114,14147,11
Task 14115,Job 0,1,10,1,9,1,2,10,8,1,4,1,14115,14148,5
Task 14115,Job 1,6,8,2,6,1,8,12,4,2,1,0,14115,14148,7
Task 14116,Job 0,5,8,1,9,0,6,14,8,1,1,2,14116,14149,2
Task 14116,Job 1,10,6,1,9,1,11,19,8,1,3,2,14116,14149,19
Task 14117,Job 0,8,5,4,10,0,12,18,6,4,4,0,14117,14150,18
Task 14117,Job 1,13,9,4,11,1,17,24,7,4,2,1,14117,14150,13
Task 14118,Job 0,9,8,3,10,1,12,19,7,3,1,2,14118,14151,4
Task 14118,Job 1,14,4,2,12,0,16,26,10,2,1,1,14118,14151,14
Task 14119,Job 0,5,10,1,7,0,6,12,6,1,1,2,14119,14153,9
Task 14119,Job 1,10,4,3,8,0,13,18,5,3,3,2,14119,14153,6
Task 14120,Job 0,10,8,3,9,0,13,19,6,3,2,2,14120,14154,4
Task 14120,Job 1,15,10,2,7,0,17,22,5,2,4,0,14120,14154,19
Task 14121,Job 0,5,6,2,10,0,7,15,8,2,3,2,14121,14155,13
Task 14121,Job 1,10,4,1,9,0,11,19,8,1,1,0,14121,14155,17
Task 14122,Job 0,8,6,1,12,0,9,20,11,1,2,2,14122,14155,17
Task 14122,Job 1,13,6,4,8,1,17,21,4,4,2,2,14122,14155,15
Task 14123,Job 0,10,7,4,8,0,14,18,4,4,2,1,14123,14156,11
Task 14123,Job 1,15,5,2,8,0,17,23,6,2,3,2,14123,14156,19
Task 14124,Job 0,6,10,1,11,0,7,17,10,1,3,2,14124,14158,13
Task 14124,Job 1,11,4,4,8,0,15,19,4,4,3,0,14124,14158,4
Task 14125,Job 0,8,8,3,9,0,11,17,6,3,3,1,14125,14159,15
Task 14125,Job 1,13,10,2,8,1,15,21,6,2,3,1,14125,14159,12
Task 14126,Job 0,9,9,4,8,0,13,17,4,4,3,2,14126,14159,5
Task 14126,Job 1,14,6,1,7,0,15,21,6,1,2,1,14126,14159,15
Task 14127,Job 0,9,7,4,8,0,13,17,4,4,1,1,14127,14161,3
Task 14127,Job 1,14,9,3,7,0,17,21,4,3,1,0,14127,14161,10
Task 14128,Job 0,2,9,1,9,0,3,11,8,1,4,2,14128,14161,11
Task 14128,Job 1,7,5,1,12,0,8,19,11,1,3,2,14128,14161,6
Task 14129,Job 0,10,4,2,8,0,12,18,6,2,4,1,14129,14162,15
Task 14129,Job 1,15,9,4,12,0,19,27,8,4,3,2,14129,14162,3
Task 14130,Job 0,3,7,1,11,0,4,14,10,1,1,2,14130,14164,4
Task 14130,Job 1,8,10,2,6,0,10,14,4,2,3,1,14130,14164,20
Task 14131,Job 0,3,8,1,6,0,4,9,5,1,4,0,14131,14165,5
Task 14131,Job 1,8,10,2,10,0,10,18,8,2,3,0,14131,14165,4
Task 14132,Job 0,7,7,1,12,0,8,19,11,1,1,0,14132,14166,13
Task 14132,Job 1,12,7,2,10,0,14,22,8,2,2,2,14132,14166,6
Task 14133,Job 0,6,9,3,10,0,9,16,7,3,2,1,14133,14167,4
Task 14133,Job 1,11,4,1,12,0,12,23,11,1,3,1,14133,14167,2
Task 14134,Job 0,1,7,4,7,0,5,8,3,4,1,1,14134,14167,6
Task 14134,Job 1,6,4,1,6,0,7,12,5,1,3,0,14134,14167,16
Task 14135,Job 0,1,5,2,12,0,3,13,10,2,1,2,14135,14168,4
Task 14135,Job 1,6,5,1,8,0,7,14,7,1,4,0,14135,14168,13
Task 14136,Job 0,6,4,3,12,0,9,18,9,3,4,2,14136,14169,10
Task 14136,Job 1,11,10,3,6,1,14,17,3,3,2,2,14136,14169,17
Task 14137,Job 0,1,7,3,6,0,4,7,3,3,1,0,14137,14170,10
Task 14137,Job 1,6,9,3,10,1,9,16,7,3,2,0,14137,14170,5
Task 14138,Job 0,5,4,2,10,1,7,15,8,2,4,2,14138,14172,2
Task 14138,Job 1,10,9,2,12,0,12,22,10,2,2,0,14138,14172,7
Task 14139,Job 0,3,4,2,8,0,5,11,6,2,2,0,14139,14173,9
Task 14139,Job 1,8,5,2,12,0,10,20,10,2,4,0,14139,14173,11
Task 14140,Job 0,10,4,2,8,1,12,18,6,2,4,2,14140,14174,11
Task 14140,Job 1,15,7,1,9,0,16,24,8,1,4,2,14140,14174,4
Task 14141,Job 0,5,8,2,7,0,7,12,5,2,3,2,14141,14174,3
Task 14141,Job 1,10,6,2,11,1,12,21,9,2,3,2,14141,14174,6
Task 14142,Job 0,2,4,4,12,0,6,14,8,4,1,0,14142,14175,20
Task 14142,Job 1,7,9,2,11,1,9,18,9,2,1,0,14142,14175,16
Task 14143,Job 0,2,10,1,8,1,3,10,7,1,4,0,14143,14176,4
Task 14143,Job 1,7,5,2,12,0,9,19,10,2,1,1,14143,14176,5
Task 14144,Job 0,1,4,4,9,0,5,10,5,4,1,1,14144,14177,2
Task 14144,Job 1,6,8,1,11,0,7,17,10,1,1,2,14144,14177,5
Task 14145,Job 0,4,9,2,9,0,6,13,7,2,2,2,14145,14179,6
Task 14145,Job 1,9,4,2,10,0,11,19,8,2,3,2,14145,14179,11
Task 14146,Job 0,5,5,1,10,0,6,15,9,1,4,0,14146,14180,6
Task 14146,Job 1,10,6,3,12,1,13,22,9,3,1,0,14146,14180,9
Task 14147,Job 0,1,8,2,12,0,3,13,10,2,1,2,14147,14181,14
Task 14147,Job 1,6,9,4,7,1,10,13,3,4,2,0,14147,14181,10
Task 14148,Job 0,3,9,3,12,0,6,15,9,3,1,0,14148,14182,19
Task 14148,Job 1,8,4,3,12,1,11,20,9,3,1,2,14148,14182,12
Task 14149,Job 0,1,6,3,8,0,4,9,5,3,4,1,14149,14182,9
Task 14149,Job 1,6,5,4,9,0,10,15,5,4,3,1,14149,14182,5
Task 14150,Job 0,9,4,3,8,0,12,17,5,3,2,0,14150,14183,15
Task 14150,Job 1,14,7,3,8,0,17,22,5,3,2,2,14150,14183,9
Task 14151,Job 0,2,7,1,10,0,3,12,9,1,3,2,14151,14185,9
Task 14151,Job 1,7,6,1,8,0,8,15,7,1,1,2,14151,14185,17
Task 14152,Job 0,1,4,3,6,0,4,7,3,3,4,1,14152,14185,20
Task 14152,Job 1,6,10,1,6,0,7,12,5,1,1,1,14152,14185,6
Task 14153,Job 0,1,6,4,9,0,5,10,5,4,4,1,14153,14186,15
Task 14153,Job 1,6,10,4,8,0,10,14,4,4,4,2,14153,14186,20
Task 14154,Job 0,6,5,4,8,0,10,14,4,4,1,2,14154,14188,2
Task 14154,Job 1,11,5,3,7,0,14,18,4,3,2,0,14154,14188,3
Task 14155,Job 0,9,8,2,11,0,11,20,9,2,4,1,14155,14189,13
Task 14155,Job 1,14,10,1,8,0,15,22,7,1,1,1,14155,14189,3
Task 14156,Job 0,5,6,3,10,0,8,15,7,3,3,2,14156,14190,4
Task 14156,Job 1,10,9,3,8,0,13,18,5,3,1,1,14156,14190,10
Task 14157,Job 0,1,10,1,8,0,2,9,7,1,2,1,14157,14190,6
Task 14157,Job 1,6,5,3,7,0,9,13,4,3,3,1,14157,14190,20
Task 14158,Job 0,5,6,2,10,0,7,15,8,2,3,0,14158,14191,8
Task 14158,Job 1,10,8,1,8,0,11,18,7,1,2,0,14158,14191,16
Task 14159,Job 0,2,8,2,8,0,4,10,6,2,3,1,14159,14192,15
Task 14159,Job 1,7,5,4,10,0,11,17,6,4,2,2,14159,14192,4
Task 14160,Job 0,3,10,1,9,0,4,12,8,1,1,0,14160,14193,12
Task 14160,Job 1,8,8,3,12,0,11,20,9,3,3,1,14160,14193,10
Task 14161,Job 0,9,5,4,12,0,13,21,8,4,1,0,14161,14194,12
Task 14161,Job 1,14,4,4,8,0,18,22,4,4,3,0,14161,14194,2
Task 14162,Job 0,8,10,1,9,0,9,17,8,1,2,1,14162,14196,6
Task 14162,Job 1,13,6,4,12,0,17,25,8,4,3,1,14162,14196,14
Task 14163,Job 0,8,4,1,10,0,9,18,9,1,1,2,14163,14196,2
Task 14163,Job 1,13,5,2,12,0,15,25,10,2,1,2,14163,14196,13
Task 14164,Job 0,3,7,4,9,1,7,12,5,4,4,2,14164,14197,11
Task 14164,Job 1,8,6,2,10,0,10,18,8,2,1,1,14164,14197,4
Task 14165,Job 0,5,4,1,7,1,6,12,6,1,3,1,14165,14198,7
Task 14165,Job 1,10,7,1,9,1,11,19,8,1,1,0,14165,14198,11
Task 14166,Job 0,1,10,1,8,0,2,9,7,1,2,2,14166,14199,7
Task 14166,Job 1,6,9,1,12,0,7,18,11,1,3,1,14166,14199,16
Task 14167,Job 0,7,10,1,8,0,8,15,7,1,1,1,14167,14201,8
Task 14167,Job 1,12,7,1,12,0,13,24,11,1,2,1,14167,14201,6
Task 14168,Job 0,7,4,2,7,0,9,14,5,2,3,1,14168,14201,12
Task 14168,Job 1,12,4,1,11,1,13,23,10,1,3,2,14168,14201,7
Task 14169,Job 0,6,4,2,10,1,8,16,8,2,4,1,14169,14203,12
Task 14169,Job 1,11,9,2,6,0,13,17,4,2,4,1,14169,14203,6
Task 14170,Job 0,5,6,1,12,0,6,17,11,1,1,1,14170,14204,6
Task 14170,Job 1,10,10,3,11,0,13,21,8,3,4,2,14170,14204,19
Task 14171,Job 0,6,9,1,7,0,7,13,6,1,3,1,14171,14204,13
Task 14171,Job 1,11,4,4,12,0,15,23,8,4,1,2,14171,14204,13
Task 14172,Job 0,3,6,3,6,1,6,9,3,3,3,2,14172,14206,10
Task 14172,Job 1,8,6,2,11,1,10,19,9,2,2,0,14172,14206,19
Task 14173,Job 0,2,8,4,10,0,6,12,6,4,1,2,14173,14207,17
Task 14173,Job 1,7,4,2,12,0,9,19,10,2,3,2,14173,14207,18
Task 14174,Job 0,2,6,3,11,0,5,13,8,3,2,1,14174,14208,14
Task 14174,Job 1,7,9,4,7,0,11,14,3,4,3,2,14174,14208,6
Task 14175,Job 0,9,5,3,10,1,12,19,7,3,1,2,14175,14209,15
Task 14175,Job 1,14,9,1,6,1,15,20,5,1,1,0,14175,14209,19
Task 14176,Job 0,4,10,1,8,1,5,12,7,1,2,2,14176,14209,16
Task 14176,Job 1,9,7,3,10,0,12,19,7,3,4,0,14176,14209,13
Task 14177,Job 0,5,5,2,12,1,7,17,10,2,3,2,14177,14211,2
Task 14177,Job 1,10,7,3,10,0,13,20,7,3,4,1,14177,14211,7
Task 14178,Job 0,10,7,4,10,0,14,20,6,4,2,2,14178,14211,4
Task 14178,Job 1,15,6,3,12,0,18,27,9,3,3,0,14178,14211,8
Task 14179,Job 0,8,7,2,6,0,10,14,4,2,3,1,14179,14212,18
Task 14179,Job 1,13,6,4,11,0,17,24,7,4,1,0,14179,14212,2
Task 14180,Job 0,10,7,1,9,0,11,19,8,1,1,0,14180,14213,15
Task 14180,Job 1,15,6,3,9,1,18,24,6,3,4,1,14180,14213,6
Task 14181,Job 0,8,8,3,8,0,11,16,5,3,2,2,14181,14215,12
Task 14181,Job 1,13,10,3,12,0,16,25,9,3,3,1,14181,14215,6
Task 14182,Job 0,6,5,4,12,0,10,18,8,4,4,1,14182,14216,7
Task 14182,Job 1,11,9,1,9,1,12,20,8,1,3,0,14182,14216,6
Task 14183,Job 0,3,6,3,9,1,6,12,6,3,3,0,14183,14216,19
Task 14183,Job 1,8,5,1,7,0,9,15,6,1,4,0,14183,14216,5
Task 14184,Job 0,3,4,1,6,0,4,9,5,1,4,2,14184,14218,10
Task 14184,Job 1,8,8,4,11,0,12,19,7,4,3,2,14184,14218,18
Task 14185,Job 0,4,8,3,6,0,7,10,3,3,1,1,14185,14219,7
Task 14185,Job 1,9,7,3,12,0,12,21,9,3,4,2,14185,14219,13
Task 14186,Job 0,1,6,3,12,1,4,13,9,3,2,0,14186,14219,3
Task 14186,Job 1,6,4,3,6,0,9,12,3,3,2,0,14186,14219,13
Task 14187,Job 0,4,7,3,11,0,7,15,8,3,1,0,14187,14221,12
Task 14187,Job 1,9,10,2,11,1,11,20,9,2,2,1,14187,14221,6
Task 14188,Job 0,9,9,3,9,0,12,18,6,3,4,2,14188,14221,20
Task 14188,Job 1,14,8,2,7,0,16,21,5,2,4,2,14188,14221,11
Task 14189,Job 0,2,8,1,6,1,3,8,5,1,3,2,14189,14222,14
Task 14189,Job 1,7,10,3,11,1,10,18,8,3,4,0,14189,14222,4
Task 14190,Job 0,9,4,3,7,0,12,16,4,3,3,0,14190,14224,13
Task 14190,Job 1,14,10,1,10,1,15,24,9,1,2,1,14190,14224,16
Task 14191,Job 0,9,10,1,10,0,10,19,9,1,2,0,14191,14225,5
Task 14191,Job 1,14,8,3,10,0,17,24,7,3,4,2,14191,14225,3
Task 14192,Job 0,9,10,3,11,0,12,20,8,3,1,0,14192,14225,2
Task 14192,Job 1,14,9,1,7,0,15,21,6,1,1,2,14192,14225,7
Task 14193,Job 0,10,7,4,11,0,14,21,7,4,4,2,14193,14226,15
Task 14193,Job 1,15,8,1,9,1,16,24,8,1,2,0,14193,14226,12
Task 14194,Job 0,3,7,3,6,0,6,9,3,3,1,0,14194,14228,9
Task 14194,Job 1,8,5,2,10,0,10,18,8,2,2,0,14194,14228,11
Task 14195,Job 0,8,8,3,9,1,11,17,6,3,1,1,14195,14229,15
Task 14195,Job 1,13,6,4,6,1,17,19,2,4,1,2,14195,14229,17
Task 14196,Job 0,3,5,2,11,0,5,14,9,2,4,0,14196,14230,5
Task 14196,Job 1,8,9,4,10,1,12,18,6,4,3,0,14196,14230,8
Task 14197,Job 0,10,6,4,7,0,14,17,3,4,4,2,14197,14231,14
Task 14197,Job 1,15,6,4,9,0,19,24,5,4,2,0,14197,14231,10
Task 14198,Job 0,5,9,2,6,0,7,11,4,2,1,1,14198,14231,4
Task 14198,Job 1,10,7,1,12,0,11,22,11,1,4,1,14198,14231,2
Task 14199,Job 0,10,5,3,12,1,13,22,9,3,1,0,14199,14232,20
Task 14199,Job 1,15,4,1,6,0,16,21,5,1,3,0,14199,14232,11
Task 14200,Job 0,8,4,3,10,0,11,18,7,3,3,1,14200,14234,16
Task 14200,Job 1,13,10,3,11,1,16,24,8,3,1,0,14200,14234,11
Task 14201,Job 0,6,7,3,10,0,9,16,7,3,3,2,14201,14234,8
Task 14201,Job 1,11,5,1,11,0,12,22,10,1,1,0,14201,14234,16
Task 14202,Job 0,10,7,4,12,1,14,22,8,4,1,2,14202,14236,17
Task 14202,Job 1,15,5,4,9,0,19,24,5,4,3,0,14202,14236,9
Task 14203,Job 0,10,6,4,9,1,14,19,5,4,2,0,14203,14237,18
Task 14203,Job 1,15,9,1,12,0,16,27,11,1,1,0,14203,14237,10
Task 14204,Job 0,4,10,3,7,1,7,11,4,3,1,2,14204,14238,5
Task 14204,Job 1,9,5,3,7,0,12,16,4,3,1,1,14204,14238,10
Task 14205,Job 0,1,5,2,11,0,3,12,9,2,1,2,14205,14239,14
Task 14205,Job 1,6,4,3,11,0,9,17,8,3,1,2,14205,14239,15
Task 14206,Job 0,9,5,2,10,0,11,19,8,2,1,1,14206,14239,11
Task 14206,Job 1,14,7,4,11,1,18,25,7,4,4,0,14206,14239,14
Task 14207,Job 0,7,4,3,6,0,10,13,3,3,3,1,14207,14241,14
Task 14207,Job 1,12,10,4,12,1,16,24,8,4,2,1,14207,14241,15
Task 14208,Job 0,3,5,2,9,0,5,12,7,2,1,0,14208,14242,8
Task 14208,Job 1,8,6,2,12,1,10,20,10,2,3,2,14208,14242,20
Task 14209,Job 0,3,6,2,10,1,5,13,8,2,3,0,14209,14243,13
Task 14209,Job 1,8,4,3,6,1,11,14,3,3,1,0,14209,14243,20
Task 14210,Job 0,8,9,4,9,0,12,17,5,4,1,2,14210,14244,4
Task 14210,Job 1,13,7,1,6,0,14,19,5,1,1,0,14210,14244,14
Task 14211,Job 0,3,5,2,12,0,5,15,10,2,4,2,14211,14245,16
Task 14211,Job 1,8,9,1,11,0,9,19,10,1,4,0,14211,14245,19
Task 14212,Job 0,1,9,3,10,0,4,11,7,3,2,2,14212,14245,7
Task 14212,Job 1,6,8,1,7,0,7,13,6,1,1,0,14212,14245,12
Task 14213,Job 0,8,9,4,6,0,12,14,2,4,2,2,14213,14247,6
Task 14213,Job 1,13,7,4,9,1,17,22,5,4,3,1,14213,14247,9
Task 14214,Job 0,5,5,3,11,0,8,16,8,3,4,2,14214,14248,8
Task 14214,Job 1,10,8,2,12,0,12,22,10,2,4,0,14214,14248,19
Task 14215,Job 0,2,6,4,8,0,6,10,4,4,1,1,14215,14249,10
Task 14215,Job 1,7,7,1,11,0,8,18,10,1,4,1,14215,14249,20
Task 14216,Job 0,6,10,2,6,0,8,12,4,2,2,0,14216,14249,11
Task 14216,Job 1,11,10,3,12,0,14,23,9,3,4,1,14216,14249,12
Task 14217,Job 0,4,8,2,10,0,6,14,8,2,4,1,14217,14251,19
Task 14217,Job 1,9,5,2,8,0,11,17,6,2,2,0,14217,14251,10
Task 14218,Job 0,4,4,3,9,0,7,13,6,3,4,2,14218,14252,8
Task 14218,Job 1,9,6,4,11,0,13,20,7,4,4,2,14218,14252,3
Task 14219,Job 0,7,5,1,6,1,8,13,5,1,2,1,14219,14252,8
Task 14219,Job 1,12,9,3,8,0,15,20,5,3,4,2,14219,14252,6
Task 14220,Job 0,2,6,1,10,1,3,12,9,1,3,0,14220,14254,11
Task 14220,Job 1,7,6,2,6,1,9,13,4,2,1,2,14220,14254,8
Task 14221,Job 0,10,5,1,6,0,11,16,5,1,2,2,14221,14254,5
Task 14221,Job 1,15,5,4,12,0,19,27,8,4,4,0,14221,14254,11
Task 14222,Job 0,9,6,1,7,0,10,16,6,1,2,2,14222,14256,6
Task 14222,Job 1,14,8,2,12,0,16,26,10,2,1,0,14222,14256,10
Task 14223,Job 0,6,8,2,7,0,8,13,5,2,1,0,14223,14256,17
Task 14223,Job 1,11,9,1,9,1,12,20,8,1,2,1,14223,14256,10
Task 14224,Job 0,5,9,1,6,0,6,11,5,1,1,2,14224,14257,14
Task 14224,Job 1,10,8,3,12,0,13,22,9,3,2,0,14224,14257,13
Task 14225,Job 0,3,10,4,12,0,7,15,8,4,1,1,14225,14258,4
Task 14225,Job 1,8,8,4,8,0,12,16,4,4,4,2,14225,14258,3
Task 14226,Job 0,7,8,1,12,0,8,19,11,1,4,2,14226,14259,19
Task 14226,Job 1,12,4,4,8,0,16,20,4,4,4,1,14226,14259,11
Task 14227,Job 0,6,6,1,6,0,7,12,5,1,1,1,14227,14260,19
Task 14227,Job 1,11,7,3,11,0,14,22,8,3,3,2,14227,14260,4
Task 14228,Job 0,8,5,2,10,0,10,18,8,2,2,0,14228,14262,5
Task 14228,Job 1,13,9,4,10,0,17,23,6,4,3,1,14228,14262,4
Task 14229,Job 0,10,4,2,7,0,12,17,5,2,4,1,14229,14262,7
Task 14229,Job 1,15,6,2,9,1,17,24,7,2,3,0,14229,14262,2
Task 14230,Job 0,5,5,2,12,0,7,17,10,2,4,0,14230,14263,16
Task 14230,Job 1,10,8,1,12,0,11,22,11,1,4,1,14230,14263,16
Task 14231,Job 0,8,7,3,6,0,11,14,3,3,3,2,14231,14264,12
Task 14231,Job 1,13,5,3,12,0,16,25,9,3,1,2,14231,14264,5
Task 14232,Job 0,4,6,4,10,1,8,14,6,4,2,1,14232,14266,10
Task 14232,Job 1,9,9,4,7,0,13,16,3,4,4,2,14232,14266,11
Task 14233,Job 0,1,4,3,9,0,4,10,6,3,2,0,14233,14266,15
Task 14233,Job 1,6,5,1,8,0,7,14,7,1,1,1,14233,14266,16
Task 14234,Job 0,7,10,4,7,0,11,14,3,4,2,1,14234,14267,14
Task 14234,Job 1,12,4,2,8,1,14,20,6,2,4,0,14234,14267,15
Task 14235,Job 0,8,7,3,10,0,11,18,7,3,4,1,14235,14269,16
Task 14235,Job 1,13,9,4,11,1,17,24,7,4,4,1,14235,14269,5
Task 14236,Job 0,7,4,3,11,0,10,18,8,3,2,1,14236,14270,11
Task 14236,Job 1,12,4,3,11,1,15,23,8,3,4,0,14236,14270,18
Task 14237,Job 0,2,6,2,11,1,4,13,9,2,2,0,14237,14270,14
Task 14237,Job 1,7,4,3,9,0,10,16,6,3,3,0,14237,14270,2
Task 14238,Job 0,5,8,2,10,0,7,15,8,2,3,2,14238,14272,18
Task 14238,Job 1,10,5,2,9,0,12,19,7,2,2,1,14238,14272,15
Task 14239,Job 0,1,10,2,6,0,3,7,4,2,4,0,14239,14272,7
Task 14239,Job 1,6,4,4,12,0,10,18,8,4,4,1,14239,14272,2
Task 14240,Job 0,1,8,4,8,1,5,9,4,4,3,1,14240,14273,7
Task 14240,Job 1,6,4,3,8,0,9,14,5,3,4,0,14240,14273,15
Task 14241,Job 0,3,7,4,6,0,7,9,2,4,2,2,14241,14274,15
Task 14241,Job 1,8,4,2,8,0,10,16,6,2,2,0,14241,14274,17
Task 14242,Job 0,10,10,1,7,1,11,17,6,1,4,1,14242,14275,12
Task 14242,Job 1,15,8,3,12,0,18,27,9,3,2,1,14242,14275,14
Task 14243,Job 0,1,9,3,12,0,4,13,9,3,3,0,14243,14277,13
Task 14243,Job 1,6,8,1,9,1,7,15,8,1,2,1,14243,14277,20
Task 14244,Job 0,6,7,1,8,0,7,14,7,1,1,1,14244,14277,16
Task 14244,Job 1,11,9,4,9,0,15,20,5,4,1,0,14244,14277,20
Task 14245,Job 0,2,6,4,6,0,6,8,2,4,2,0,14245,14279,2
Task 14245,Job 1,7,8,1,10,1,8,17,9,1,2,1,14245,14279,16
Task 14246,Job 0,8,4,4,12,0,12,20,8,4,3,2,14246,14280,13
Task 14246,Job 1,13,8,4,10,0,17,23,6,4,4,1,14246,14280,7
Task 14247,Job 0,5,5,3,7,0,8,12,4,3,2,0,14247,14281,5
Task 14247,Job 1,10,10,1,9,1,11,19,8,1,3,2,14247,14281,10
Task 14248,Job 0,4,9,2,8,0,6,12,6,2,3,2,14248,14281,6
Task 14248,Job 1,9,9,1,11,0,10,20,10,1,4,0,14248,14281,10
Task 14249,Job 0,1,9,4,9,0,5,10,5,4,1,0,14249,14283,20
Task 14249,Job 1,6,6,2,7,0,8,13,5,2,1,2,14249,14283,5
Task 14250,Job 0,1,6,1,10,0,2,11,9,1,2,0,14250,14283,10
Task 14250,Job 1,6,10,2,12,0,8,18,10,2,4,1,14250,14283,7
Task 14251,Job 0,6,8,2,10,0,8,16,8,2,4,1,14251,14285,3
Task 14251,Job 1,11,7,3,11,0,14,22,8,3,1,1,14251,14285,4
Task 14252,Job 0,9,6,1,12,0,10,21,11,1,1,1,14252,14285,11
Task 14252,Job 1,14,9,3,10,0,17,24,7,3,1,2,14252,14285,20
Task 14253,Job 0,6,8,1,9,1,7,15,8,1,1,1,14253,14286,10
Task 14253,Job 1,11,10,4,6,0,15,17,2,4,4,2,14253,14286,9
Task 14254,Job 0,6,7,1,7,0,7,13,6,1,4,0,14254,14288,17
Task 14254,Job 1,11,5,4,9,0,15,20,5,4,2,1,14254,14288,7
Task 14255,Job 0,10,7,2,12,1,12,22,10,2,2,0,14255,14289,4
Task 14255,Job 1,15,4,3,11,0,18,26,8,3,2,0,14255,14289,9
Task 14256,Job 0,2,5,4,9,0,6,11,5,4,2,0,14256,14290,5
Task 14256,Job 1,7,5,4,11,1,11,18,7,4,3,2,14256,14290,12
Task 14257,Job 0,9,5,2,8,0,11,17,6,2,4,2,14257,14290,16
Task 14257,Job 1,14,9,4,7,0,18,21,3,4,3,2,14257,14290,13
Task 14258,Job 0,8,10,4,8,0,12,16,4,4,4,2,14258,14292,6
Task 14258,Job 1,13,5,2,11,0,15,24,9,2,3,0,14258,14292,18
Task 14259,Job 0,2,8,4,12,0,6,14,8,4,1,2,14259,14293,20
Task 14259,Job 1,7,5,3,9,0,10,16,6,3,2,0,14259,14293,11
Task 14260,Job 0,2,4,1,6,1,3,8,5,1,4,2,14260,14293,12
Task 14260,Job 1,7,4,1,8,0,8,15,7,1,2,1,14260,14293,2
Task 14261,Job 0,3,4,3,7,1,6,10,4,3,3,2,14261,14294,15
Task 14261,Job 1,8,10,2,11,1,10,19,9,2,4,0,14261,14294,2
Task 14262,Job 0,10,4,4,7,0,14,17,3,4,2,0,14262,14295,7
Task 14262,Job 1,15,10,2,9,0,17,24,7,2,2,2,14262,14295,16
Task 14263,Job 0,5,6,2,7,0,7,12,5,2,4,2,14263,14297,11
Task 14263,Job 1,10,8,2,11,1,12,21,9,2,2,0,14263,14297,9
Task 14264,Job 0,1,6,1,11,0,2,12,10,1,2,1,14264,14298,13
Task 14264,Job 1,6,4,1,11,1,7,17,10,1,1,0,14264,14298,11
Task 14265,Job 0,6,5,3,9,0,9,15,6,3,2,1,14265,14298,6
Task 14265,Job 1,11,10,4,8,0,15,19,4,4,4,2,14265,14298,20
Task 14266,Job 0,7,7,4,10,1,11,17,6,4,2,0,14266,14299,12
Task 14266,Job 1,12,4,4,7,0,16,19,3,4,3,0,14266,14299,3
Task 14267,Job 0,3,8,4,6,0,7,9,2,4,1,2,14267,14301,4
Task 14267,Job 1,8,10,1,8,0,9,16,7,1,1,2,14267,14301,10
Task 14268,Job 0,4,6,3,12,1,7,16,9,3,1,0,14268,14302,4
Task 14268,Job 1,9,7,2,6,0,11,15,4,2,3,2,14268,14302,6
Task 14269,Job 0,1,9,3,6,0,4,7,3,3,1,1,14269,14302,17
Task 14269,Job 1,6,9,1,6,1,7,12,5,1,1,2,14269,14302,4
Task 14270,Job 0,3,8,3,11,0,6,14,8,3,1,1,14270,14304,20
Task 14270,Job 1,8,6,1,10,0,9,18,9,1,4,1,14270,14304,20
Task 14271,Job 0,5,4,4,6,0,9,11,2,4,1,2,14271,14305,3
Task 14271,Job 1,10,10,4,6,0,14,16,2,4,2,1,14271,14305,14
Task 14272,Job 0,7,10,4,7,0,11,14,3,4,4,0,14272,14306,10
Task 14272,Job 1,12,4,4,6,0,16,18,2,4,2,0,14272,14306,7
Task 14273,Job 0,1,4,3,9,0,4,10,6,3,4,0,14273,14307,4
Task 14273,Job 1,6,4,2,6,0,8,12,4,2,2,0,14273,14307,5
Task 14274,Job 0,9,4,3,10,0,12,19,7,3,4,2,14274,14308,19
Task 14274,Job 1,14,6,3,6,0,17,20,3,3,3,0,14274,14308,18
Task 14275,Job 0,6,9,1,10,0,7,16,9,1,3,2,14275,14308,4
Task 14275,Job 1,11,8,2,7,0,13,18,5,2,1,2,14275,14308,10
Task 14276,Job 0,4,9,2,11,0,6,15,9,2,3,2,14276,14310,15
Task 14276,Job 1,9,9,2,12,0,11,21,10,2,1,1,14276,14310,17
Task 14277,Job 0,10,10,2,7,0,12,17,5,2,4,1,14277,14310,13
Task 14277,Job 1,15,4,1,9,0,16,24,8,1,4,2,14277,14310,12
Task 14278,Job 0,3,9,3,9,0,6,12,6,3,1,2,14278,14311,20
Task 14278,Job 1,8,8,1,7,0,9,15,6,1,2,0,14278,14311,20
Task 14279,Job 0,5,8,4,12,0,9,17,8,4,3,2,14279,14313,8
Task 14279,Job 1,10,8,4,9,0,14,19,5,4,2,2,14279,14313,2
Task 14280,Job 0,7,8,4,10,0,11,17,6,4,1,1,14280,14314,15
Task 14280,Job 1,12,8,3,9,1,15,21,6,3,1,2,14280,14314,6
Task 14281,Job 0,3,6,4,6,1,7,9,2,4,1,0,14281,14315,2
Task 14281,Job 1,8,6,2,11,0,10,19,9,2,3,1,14281,14315,15
Task 14282,Job 0,2,7,1,12,0,3,14,11,1,2,0,14282,14315,17
Task 14282,Job 1,7,10,1,10,0,8,17,9,1,3,1,14282,14315,14
Task 14283,Job 0,10,5,1,9,1,11,19,8,1,1,2,14283,14317,4
Task 14283,Job 1,15,9,3,7,1,18,22,4,3,2,2,14283,14317,17
Task 14284,Job 0,8,6,4,6,1,12,14,2,4,4,0,14284,14317,18
Task 14284,Job 1,13,5,1,6,0,14,19,5,1,4,0,14284,14317,8
Task 14285,Job 0,1,6,1,6,0,2,7,5,1,4,0,14285,14319,20
Task 14285,Job 1,6,4,3,6,0,9,12,3,3,4,2,14285,14319,18
Task 14286,Job 0,10,4,2,7,0,12,17,5,2,4,0,14286,14319,9
Task 14286,Job 1,15,8,3,8,1,18,23,5,3,2,2,14286,14319,16
Task 14287,Job 0,6,9,4,11,0,10,17,7,4,4,0,14287,14321,11
Task 14287,Job 1,11,5,4,11,0,15,22,7,4,4,1,14287,14321,18
Task 14288,Job 0,2,5,3,8,0,5,10,5,3,2,0,14288,14321,20
Task 14288,Job 1,7,10,2,7,0,9,14,5,2,1,0,14288,14321,6
Task 14289,Job 0,8,6,1,11,0,9,19,10,1,4,1,14289,14323,20
Task 14289,Job 1,13,10,3,7,0,16,20,4,3,3,0,14289,14323,19
Task 14290,Job 0,7,6,2,9,0,9,16,7,2,1,2,14290,14324,16
Task 14290,Job 1,12,10,1,9,0,13,21,8,1,4,2,14290,14324,14
Task 14291,Job 0,7,9,2,6,0,9,13,4,2,2,2,14291,14325,4
Task 14291,Job 1,12,7,2,9,0,14,21,7,2,4,0,14291,14325,15
Task 14292,Job 0,1,6,3,8,0,4,9,5,3,2,0,14292,14326,15
Task 14292,Job 1,6,9,3,10,0,9,16,7,3,1,0,14292,14326,5
Task 14293,Job 0,2,8,2,12,0,4,14,10,2,2,1,14293,14326,17
Task 14293,Job 1,7,8,2,9,1,9,16,7,2,4,0,14293,14326,13
Task 14294,Job 0,9,8,2,10,0,11,19,8,2,1,1,14294,14327,2
Task 14294,Job 1,14,6,2,11,1,16,25,9,2,3,0,14294,14327,12
Task 14295,Job 0,4,10,4,7,0,8,11,3,4,2,2,14295,14329,3
Task 14295,Job 1,9,7,1,6,0,10,15,5,1,2,0,14295,14329,7
Task 14296,Job 0,9,9,1,10,1,10,19,9,1,4,1,14296,14330,6
Task 14296,Job 1,14,4,4,10,1,18,24,6,4,2,0,14296,14330,11
Task 14297,Job 0,9,6,3,9,0,12,18,6,3,2,1,14297,14331,6
Task 14297,Job 1,14,7,4,12,1,18,26,8,4,2,1,14297,14331,7
Task 14298,Job 0,1,6,4,10,0,5,11,6,4,2,2,14298,14331,15
Task 14298,Job 1,6,6,2,7,0,8,13,5,2,1,0,14298,14331,15
Task 14299,Job 0,6,9,1,10,0,7,16,9,1,2,2,14299,14333,16
Task 14299,Job 1,11,6,2,8,0,13,19,6,2,2,0,14299,14333,8
Task 14300,Job 0,1,4,3,12,0,4,13,9,3,4,1,14300,14333,7
Task 14300,Job 1,6,5,1,8,0,7,14,7,1,4,2,14300,14333,7
Task 14301,Job 0,1,9,3,8,0,4,9,5,3,2,1,14301,14334,9
Task 14301,Job 1,6,8,4,6,1,10,12,2,4,1,2,14301,14334,18
Task 14302,Job 0,7,4,4,6,1,11,13,2,4,4,0,14302,14335,4
Task 14302,Job 1,12,7,3,6,0,15,18,3,3,2,0,14302,14335,8
Task 14303,Job 0,9,10,3,8,0,12,17,5,3,1,1,14303,14337,13
Task 14303,Job 1,14,10,2,11,0,16,25,9,2,3,1,14303,14337,4
Task 14304,Job 0,10,7,4,10,0,14,20,6,4,3,2,14304,14338,17
Task 14304,Job 1,15,10,2,7,1,17,22,5,2,3,2,14304,14338,17
Task 14305,Job 0,3,4,1,9,0,4,12,8,1,1,2,14305,14338,7
Task 14305,Job 1,8,9,4,9,1,12,17,5,4,4,1,14305,14338,13
Task 14306,Job 0,9,5,1,6,0,10,15,5,1,4,1,14306,14340,3
Task 14306,Job 1,14,5,3,10,1,17,24,7,3,2,1,14306,14340,9
Task 14307,Job 0,4,4,4,9,0,8,13,5,4,3,1,14307,14341,13
Task 14307,Job 1,9,10,3,10,0,12,19,7,3,4,2,14307,14341,9
Task 14308,Job 0,7,7,4,8,0,11,15,4,4,2,0,14308,14341,3
Task 14308,Job 1,12,6,3,10,0,15,22,7,3,2,0,14308,14341,16
Task 14309,Job 0,9,10,3,8,1,12,17,5,3,2,1,14309,14343,5
Task 14309,Job 1,14,5,2,8,0,16,22,6,2,4,0,14309,14343,12
Task 14310,Job 0,8,4,4,8,1,12,16,4,4,3,2,14310,14343,9
Task 14310,Job 1,13,10,2,11,0,15,24,9,2,1,1,14310,14343,14
Task 14311,Job 0,5,9,3,11,0,8,16,8,3,2,0,14311,14344,14
Task 14311,Job 1,10,8,3,7,0,13,17,4,3,1,1,14311,14344,19
Task 14312,Job 0,8,5,4,11,1,12,19,7,4,4,1,14312,14346,3
Task 14312,Job 1,13,6,2,11,0,15,24,9,2,3,1,14312,14346,10
Task 14313,Job 0,1,5,1,9,0,2,10,8,1,3,2,14313,14347,6
Task 14313,Job 1,6,8,1,10,0,7,16,9,1,2,1,14313,14347,3
Task 14314,Job 0,8,5,1,6,1,9,14,5,1,1,2,14314,14348,5
Task 14314,Job 1,13,10,3,11,0,16,24,8,3,4,0,14314,14348,5
Task 14315,Job 0,2,4,3,12,0,5,14,9,3,2,2,14315,14349,6
Task 14315,Job 1,7,7,4,12,0,11,19,8,4,4,2,14315,14349,17
Task 14316,Job 0,10,10,3,6,0,13,16,3,3,1,0,14316,14350,4
Task 14316,Job 1,15,7,1,11,0,16,26,10,1,2,1,14316,14350,10
Task 14317,Job 0,3,7,1,8,0,4,11,7,1,1,0,14317,14350,11
Task 14317,Job 1,8,5,3,11,1,11,19,8,3,4,1,14317,14350,12
Task 14318,Job 0,2,4,1,11,0,3,13,10,1,2,2,14318,14351,17
Task 14318,Job 1,7,4,2,11,0,9,18,9,2,4,2,14318,14351,3
Task 14319,Job 0,5,8,2,6,0,7,11,4,2,3,1,14319,14352,13
Task 14319,Job 1,10,7,3,10,0,13,20,7,3,4,1,14319,14352,7
Task 14320,Job 0,6,7,4,12,1,10,18,8,4,3,2,14320,14353,7
Task 14320,Job 1,11,6,1,12,0,12,23,11,1,4,0,14320,14353,6
Task 14321,Job 0,10,8,3,11,0,13,21,8,3,4,1,14321,14355,11
Task 14321,Job 1,15,9,3,8,1,18,23,5,3,1,1,14321,14355,14
Task 14322,Job 0,7,7,4,10,0,11,17,6,4,2,1,14322,14356,16
Task 14322,Job 1,12,7,4,11,0,16,23,7,4,1,0,14322,14356,11
Task 14323,Job 0,6,4,1,9,0,7,15,8,1,3,1,14323,14356,8
Task 14323,Job 1,11,6,1,10,0,12,21,9,1,4,1,14323,14356,19
Task 14324,Job 0,1,4,4,10,0,5,11,6,4,4,1,14324,14358,12
Task 14324,Job 1,6,5,3,12,0,9,18,9,3,3,1,14324,14358,10
Task 14325,Job 0,3,4,4,9,0,7,12,5,4,4,1,14325,14359,13
Task 14325,Job 1,8,6,4,6,0,12,14,2,4,1,1,14325,14359,4
Task 14326,Job 0,5,6,1,9,1,6,14,8,1,3,0,14326,14360,11
Task 14326,Job 1,10,8,2,11,1,12,21,9,2,3,0,14326,14360,14
Task 14327,Job 0,6,9,3,12,0,9,18,9,3,4,1,14327,14361,17
Task 14327,Job 1,11,4,4,11,0,15,22,7,4,3,1,14327,14361,13
Task 14328,Job 0,2,10,3,7,0,5,9,4,3,1,1,14328,14361,19
Task 14328,Job 1,7,10,1,10,0,8,17,9,1,2,1,14328,14361,11
Task 14329,Job 0,2,6,3,7,0,5,9,4,3,4,2,14329,14362,6
Task 14329,Job 1,7,5,4,11,1,11,18,7,4,1,2,14329,14362,20
Task 14330,Job 0,1,8,3,7,1,4,8,4,3,1,0,14330,14363,14
Task 14330,Job 1,6,4,2,10,0,8,16,8,2,1,1,14330,14363,14
Task 14331,Job 0,7,5,4,10,0,11,17,6,4,2,2,14331,14365,20
Task 14331,Job 1,12,10,2,7,0,14,19,5,2,1,2,14331,14365,14
Task 14332,Job 0,5,8,4,6,1,9,11,2,4,1,1,14332,14365,6
Task 14332,Job 1,10,4,3,8,0,13,18,5,3,2,1,14332,14365,19
Task 14333,Job 0,10,7,1,8,0,11,18,7,1,3,2,14333,14367,7
Task 14333,Job 1,15,10,4,6,0,19,21,2,4,1,0,14333,14367,11
Task 14334,Job 0,3,7,2,10,1,5,13,8,2,3,2,14334,14367,3
Task 14334,Job 1,8,6,2,6,0,10,14,4,2,1,1,14334,14367,15
Task 14335,Job 0,5,5,3,7,0,8,12,4,3,4,1,14335,14369,17
Task 14335,Job 1,10,8,4,9,0,14,19,5,4,1,1,14335,14369,7
Task 14336,Job 0,3,7,4,11,0,7,14,7,4,3,1,14336,14369,6
Task 14336,Job 1,8,10,1,8,0,9,16,7,1,2,1,14336,14369,15
Task 14337,Job 0,6,5,3,7,0,9,13,4,3,2,2,14337,14370,18
Task 14337,Job 1,11,5,4,8,0,15,19,4,4,3,1,14337,14370,19
Task 14338,Job 0,4,9,2,9,0,6,13,7,2,4,0,14338,14372,19
Task 14338,Job 1,9,5,1,11,0,10,20,10,1,1,1,14338,14372,2
Task 14339,Job 0,2,7,4,11,0,6,13,7,4,1,0,14339,14373,9
Task 14339,Job 1,7,6,2,9,0,9,16,7,2,1,1,14339,14373,13
Task 14340,Job 0,3,6,4,8,0,7,11,4,4,4,0,14340,14374,20
Task 14340,Job 1,8,5,1,7,0,9,15,6,1,4,0,14340,14374,9
Task 14341,Job 0,6,10,4,10,0,10,16,6,4,2,2,14341,14375,18
Task 14341,Job 1,11,7,3,8,0,14,19,5,3,2,0,14341,14375,14
Task 14342,Job 0,7,9,3,7,0,10,14,4,3,4,2,14342,14376,2
Task 14342,Job 1,12,10,1,7,0,13,19,6,1,2,0,14342,14376,16
Task 14343,Job 0,6,6,3,7,0,9,13,4,3,3,2,14343,14377,5
Task 14343,Job 1,11,7,1,12,0,12,23,11,1,4,1,14343,14377,20
Task 14344,Job 0,8,5,1,7,0,9,15,6,1,4,1,14344,14378,7
Task 14344,Job 1,13,9,1,8,0,14,21,7,1,4,0,14344,14378,14
Task 14345,Job 0,10,4,4,8,0,14,18,4,4,2,1,14345,14379,7
Task 14345,Job 1,15,7,1,11,0,16,26,10,1,3,2,14345,14379,15
Task 14346,Job 0,10,4,3,10,0,13,20,7,3,4,0,14346,14380,5
Task 14346,Job 1,15,6,3,8,1,18,23,5,3,2,0,14346,14380,12
Task 14347,Job 0,10,6,2,12,0,12,22,10,2,3,0,14347,14380,13
Task 14347,Job 1,15,7,1,6,1,16,21,5,1,4,1,14347,14380,4
Task 14348,Job 0,2,8,4,12,0,6,14,8,4,2,0,14348,14381,9
Task 14348,Job 1,7,5,3,7,0,10,14,4,3,3,1,14348,14381,20
Task 14349,Job 0,10,7,4,10,0,14,20,6,4,4,0,14349,14382,3
Task 14349,Job 1,15,5,4,9,0,19,24,5,4,1,0,14349,14382,9
Task 14350,Job 0,5,4,1,7,0,6,12,6,1,1,0,14350,14384,11
Task 14350,Job 1,10,5,3,12,0,13,22,9,3,3,0,14350,14384,17
Task 14351,Job 0,4,10,4,12,0,8,16,8,4,3,1,14351,14384,10
Task 14351,Job 1,9,6,2,9,0,11,18,7,2,3,2,14351,14384,6
Task 14352,Job 0,1,10,4,8,0,5,9,4,4,4,1,14352,14385,15
Task 14352,Job 1,6,10,1,10,0,7,16,9,1,2,1,14352,14385,2
Task 14353,Job 0,8,5,1,7,0,9,15,6,1,3,1,14353,14386,14
Task 14353,Job 1,13,4,1,10,0,14,23,9,1,1,0,14353,14386,17
Task 14354,Job 0,9,8,1,11,1,10,20,10,1,1,2,14354,14388,3
Task 14354,Job 1,14,4,1,7,0,15,21,6,1,4,0,14354,14388,8
Task 14355,Job 0,1,4,2,8,0,3,9,6,2,2,0,14355,14389,13
Task 14355,Job 1,6,9,1,11,0,7,17,10,1,1,1,14355,14389,18
Task 14356,Job 0,8,8,2,7,1,10,15,5,2,1,2,14356,14389,13
Task 14356,Job 1,13,5,2,6,0,15,19,4,2,2,1,14356,14389,17
Task 14357,Job 0,2,7,3,11,0,5,13,8,3,3,1,14357,14390,7
Task 14357,Job 1,7,5,2,11,0,9,18,9,2,3,1,14357,14390,18
Task 14358,Job 0,1,8,1,6,0,2,7,5,1,2,0,14358,14391,8
Task 14358,Job 1,6,4,3,10,0,9,16,7,3,4,2,14358,14391,12
Task 14359,Job 0,2,6,1,11,1,3,13,10,1,1,0,14359,14393,19
Task 14359,Job 1,7,8,4,7,0,11,14,3,4,3,0,14359,14393,6
Task 14360,Job 0,4,9,3,9,0,7,13,6,3,4,1,14360,14394,7
Task 14360,Job 1,9,4,3,12,1,12,21,9,3,3,1,14360,14394,3
Task 14361,Job 0,2,7,4,6,0,6,8,2,4,2,2,14361,14394,17
Task 14361,Job 1,7,7,2,11,1,9,18,9,2,1,0,14361,14394,10
Task 14362,Job 0,4,10,3,10,1,7,14,7,3,1,0,14362,14395,3
Task 14362,Job 1,9,5,4,11,1,13,20,7,4,4,1,14362,14395,2
Task 14363,Job 0,4,8,3,8,0,7,12,5,3,3,2,14363,14396,10
Task 14363,Job 1,9,10,2,8,0,11,17,6,2,2,1,14363,14396,17
Task 14364,Job 0,4,5,4,6,0,8,10,2,4,4,0,14364,14398,9
Task 14364,Job 1,9,5,1,9,0,10,18,8,1,1,1,14364,14398,12
Task 14365,Job 0,3,9,2,7,0,5,10,5,2,3,2,14365,14398,7
Task 14365,Job 1,8,8,3,8,0,11,16,5,3,2,2,14365,14398,19
Task 14366,Job 0,2,10,2,7,0,4,9,5,2,1,1,14366,14400,11
Task 14366,Job 1,7,8,3,7,0,10,14,4,3,1,1,14366,14400,9
Task 14367,Job 0,4,8,3,9,0,7,13,6,3,3,0,14367,14401,4
Task 14367,Job 1,9,6,1,10,0,10,19,9,1,4,0,14367,14401,9
Task 14368,Job 0,10,6,3,12,0,13,22,9,3,4,1,14368,14401,11
Task 14368,Job 1,15,10,4,9,0,19,24,5,4,1,1,14368,14401,8
Task 14369,Job 0,1,7,1,9,0,2,10,8,1,3,1,14369,14403,10
Task 14369,Job 1,6,6,3,10,0,9,16,7,3,1,1,14369,14403,3
Task 14370,Job 0,1,4,2,11,0,3,12,9,2,2,0,14370,14404,2
Task 14370,Job 1,6,4,3,7,0,9,13,4,3,3,2,14370,14404,12
Task 14371,Job 0,5,9,3,10,0,8,15,7,3,1,2,14371,14405,19
Task 14371,Job 1,10,4,2,12,0,12,22,10,2,3,1,14371,14405,10
Task 14372,Job 0,3,6,1,11,0,4,14,10,1,3,1,14372,14406,12
Task 14372,Job 1,8,10,4,6,0,12,14,2,4,1,0,14372,14406,13
Task 14373,Job 0,1,9,2,12,0,3,13,10,2,1,2,14373,14406,20
Task 14373,Job 1,6,6,4,10,0,10,16,6,4,3,1,14373,14406,10
Task 14374,Job 0,9,9,2,7,0,11,16,5,2,4,0,14374,14408,5
Task 14374,Job 1,14,9,4,10,0,18,24,6,4,4,2,14374,14408,14
Task 14375,Job 0,3,5,2,11,0,5,14,9,2,3,2,14375,14408,3
Task 14375,Job 1,8,9,3,11,0,11,19,8,3,2,1,14375,14408,7
Task 14376,Job 0,2,10,4,6,1,6,8,2,4,2,1,14376,14410,13
Task 14376,Job 1,7,7,1,8,0,8,15,7,1,4,2,14376,14410,6
Task 14377,Job 0,9,10,4,6,0,13,15,2,4,4,2,14377,14410,8
Task 14377,Job 1,14,8,2,11,0,16,25,9,2,1,0,14377,14410,6
Task 14378,Job 0,7,4,3,6,1,10,13,3,3,2,1,14378,14412,3
Task 14378,Job 1,12,9,2,10,0,14,22,8,2,1,2,14378,14412,19
Task 14379,Job 0,2,7,2,10,0,4,12,8,2,2,2,14379,14412,20
Task 14379,Job 1,7,4,3,8,1,10,15,5,3,3,2,14379,14412,2
Task 14380,Job 0,2,10,3,10,0,5,12,7,3,4,2,14380,14413,17
Task 14380,Job 1,7,6,4,9,0,11,16,5,4,1,0,14380,14413,12
Task 14381,Job 0,2,9,4,7,0,6,9,3,4,1,0,14381,14415,6
Task 14381,Job 1,7,10,4,11,0,11,18,7,4,4,1,14381,14415,6
Task 14382,Job 0,5,4,1,11,0,6,16,10,1,3,1,14382,14416,12
Task 14382,Job 1,10,6,3,10,0,13,20,7,3,1,0,14382,14416,20
Task 14383,Job 0,6,10,1,10,0,7,16,9,1,1,1,14383,14417,16
Task 14383,Job 1,11,4,2,8,0,13,19,6,2,4,0,14383,14417,6
Task 14384,Job 0,2,4,3,9,0,5,11,6,3,3,0,14384,14418,13
Task 14384,Job 1,7,6,4,10,0,11,17,6,4,4,1,14384,14418,19
Task 14385,Job 0,6,8,3,7,1,9,13,4,3,4,0,14385,14419,9
Task 14385,Job 1,11,6,4,8,1,15,19,4,4,3,0,14385,14419,6
Task 14386,Job 0,6,7,3,10,0,9,16,7,3,3,2,14386,14420,8
Task 14386,Job 1,11,8,3,7,0,14,18,4,3,2,1,14386,14420,16
Task 14387,Job 0,3,8,3,10,0,6,13,7,3,4,0,14387,14420,18
Task 14387,Job 1,8,7,1,11,0,9,19,10,1,2,0,14387,14420,7
Task 14388,Job 0,8,4,1,9,0,9,17,8,1,1,0,14388,14421,14
Task 14388,Job 1,13,5,3,12,0,16,25,9,3,1,1,14388,14421,15
Task 14389,Job 0,2,9,3,10,0,5,12,7,3,2,0,14389,14422,8
Task 14389,Job 1,7,8,1,11,0,8,18,10,1,4,0,14389,14422,4
Task 14390,Job 0,5,8,3,8,0,8,13,5,3,3,0,14390,14423,10
Task 14390,Job 1,10,10,2,7,0,12,17,5,2,4,0,14390,14423,7
Task 14391,Job 0,7,5,2,11,0,9,18,9,2,1,0,14391,14424,12
Task 14391,Job 1,12,4,3,12,1,15,24,9,3,4,2,14391,14424,16
Task 14392,Job 0,1,10,2,8,0,3,9,6,2,2,2,14392,14426,16
Task 14392,Job 1,6,7,2,9,0,8,15,7,2,4,2,14392,14426,20
Task 14393,Job 0,6,8,1,9,0,7,15,8,1,2,2,14393,14427,20
Task 14393,Job 1,11,7,4,7,0,15,18,3,4,3,1,14393,14427,12
Task 14394,Job 0,5,5,1,7,1,6,12,6,1,1,0,14394,14428,7
Task 14394,Job 1,10,5,1,9,0,11,19,8,1,2,2,14394,14428,2
Task 14395,Job 0,3,4,3,6,0,6,9,3,3,2,1,14395,14428,11
Task 14395,Job 1,8,9,2,7,1,10,15,5,2,3,2,14395,14428,18
Task 14396,Job 0,9,6,4,6,0,13,15,2,4,1,2,14396,14429,20
Task 14396,Job 1,14,5,2,7,0,16,21,5,2,3,1,14396,14429,6
Task 14397,Job 0,6,6,2,9,0,8,15,7,2,2,0,14397,14430,7
Task 14397,Job 1,11,8,3,9,0,14,20,6,3,2,1,14397,14430,14
Task 14398,Job 0,6,6,4,9,0,10,15,5,4,4,1,14398,14431,9
Task 14398,Job 1,11,10,1,11,0,12,22,10,1,4,0,14398,14431,17
Task 14399,Job 0,7,4,4,9,1,11,16,5,4,4,2,14399,14432,6
Task 14399,Job 1,12,8,2,10,0,14,22,8,2,2,0,14399,14432,14
Task 14400,Job 0,1,6,1,7,0,2,8,6,1,1,2,14400,14434,4
Task 14400,Job 1,6,4,4,11,0,10,17,7,4,1,1,14400,14434,10
Task 14401,Job 0,3,10,4,11,0,7,14,7,4,1,2,14401,14435,9
Task 14401,Job 1,8,7,1,6,0,9,14,5,1,1,1,14401,14435,5
Task 14402,Job 0,10,5,1,8,1,11,18,7,1,1,2,14402,14435,8
Task 14402,Job 1,15,4,3,7,0,18,22,4,3,1,0,14402,14435,9
Task 14403,Job 0,3,8,1,12,1,4,15,11,1,4,0,14403,14437,18
Task 14403,Job 1,8,7,3,12,0,11,20,9,3,4,2,14403,14437,18
Task 14404,Job 0,8,5,2,8,0,10,16,6,2,4,1,14404,14438,20
Task 14404,Job 1,13,10,1,7,0,14,20,6,1,1,1,14404,14438,17
Task 14405,Job 0,3,7,4,9,0,7,12,5,4,2,2,14405,14439,16
Task 14405,Job 1,8,6,4,7,1,12,15,3,4,1,2,14405,14439,4
Task 14406,Job 0,10,6,1,6,0,11,16,5,1,3,2,14406,14440,12
Task 14406,Job 1,15,10,4,9,0,19,24,5,4,4,0,14406,14440,3
Task 14407,Job 0,3,4,2,8,0,5,11,6,2,2,1,14407,14440,4
Task 14407,Job 1,8,8,2,6,0,10,14,4,2,4,0,14407,14440,6
Task 14408,Job 0,10,8,1,10,0,11,20,9,1,1,0,14408,14442,13
Task 14408,Job 1,15,5,4,8,0,19,23,4,4,4,2,14408,14442,14
Task 14409,Job 0,10,10,4,7,1,14,17,3,4,3,1,14409,14442,15
Task 14409,Job 1,15,8,2,9,0,17,24,7,2,3,2,14409,14442,19
Task 14410,Job 0,5,6,1,12,0,6,17,11,1,1,0,14410,14443,2
Task 14410,Job 1,10,5,2,10,0,12,20,8,2,2,2,14410,14443,16
Task 14411,Job 0,1,8,4,10,0,5,11,6,4,4,2,14411,14445,10
Task 14411,Job 1,6,8,3,10,0,9,16,7,3,1,1,14411,14445,6
Task 14412,Job 0,2,6,2,8,1,4,10,6,2,3,2,14412,14445,16
Task 14412,Job 1,7,8,4,11,0,11,18,7,4,4,0,14412,14445,11
Task 14413,Job 0,9,4,4,10,0,13,19,6,4,4,0,14413,14447,15
Task 14413,Job 1,14,7,2,9,0,16,23,7,2,2,0,14413,14447,12
Task 14414,Job 0,9,4,3,10,0,12,19,7,3,2,1,14414,14447,8
Task 14414,Job 1,14,8,3,11,0,17,25,8,3,1,2,14414,14447,6
Task 14415,Job 0,5,4,1,6,1,6,11,5,1,3,0,14415,14448,10
Task 14415,Job 1,10,4,4,7,1,14,17,3,4,4,1,14415,14448,4
Task 14416,Job 0,10,4,2,12,0,12,22,10,2,4,2,14416,14449,19
Task 14416,Job 1,15,7,3,10,0,18,25,7,3,3,0,14416,14449,2
Task 14417,Job 0,2,6,1,10,0,3,12,9,1,3,0,14417,14450,11
Task 14417,Job 1,7,8,3,11,1,10,18,8,3,1,1,14417,14450,2
Task 14418,Job 0,8,9,4,6,0,12,14,2,4,4,1,14418,14452,5
Task 14418,Job 1,13,10,2,6,0,15,19,4,2,1,0,14418,14452,10
Task 14419,Job 0,1,7,2,8,0,3,9,6,2,2,2,14419,14453,11
Task 14419,Job 1,6,9,2,6,0,8,12,4,2,1,1,14419,14453,5
Task 14420,Job 0,2,7,2,11,0,4,13,9,2,3,1,14420,14454,17
Task 14420,Job 1,7,8,2,9,0,9,16,7,2,1,2,14420,14454,3
Task 14421,Job 0,3,6,3,12,0,6,15,9,3,2,2,14421,14455,10
Task 14421,Job 1,8,5,3,6,0,11,14,3,3,1,0,14421,14455,10
Task 14422,Job 0,6,8,1,11,0,7,17,10,1,1,1,14422,14455,13
Task 14422,Job 1,11,9,1,10,0,12,21,9,1,1,2,14422,14455,7
Task 14423,Job 0,6,7,2,7,1,8,13,5,2,4,2,14423,14456,15
Task 14423,Job 1,11,4,1,8,0,12,19,7,1,3,0,14423,14456,9
Task 14424,Job 0,2,9,4,8,0,6,10,4,4,2,1,14424,14457,10
Task 14424,Job 1,7,8,3,10,1,10,17,7,3,1,0,14424,14457,7
Task 14425,Job 0,5,8,1,11,0,6,16,10,1,2,2,14425,14459,11
Task 14425,Job 1,10,7,1,6,1,11,16,5,1,4,1,14425,14459,14
Task 14426,Job 0,9,5,4,10,1,13,19,6,4,4,0,14426,14460,12
Task 14426,Job 1,14,8,4,7,0,18,21,3,4,2,2,14426,14460,8
Task 14427,Job 0,2,6,4,8,0,6,10,4,4,4,1,14427,14461,18
Task 14427,Job 1,7,4,1,11,0,8,18,10,1,4,1,14427,14461,2
Task 14428,Job 0,9,6,3,10,0,12,19,7,3,1,1,14428,14461,4
Task 14428,Job 1,14,5,1,6,1,15,20,5,1,4,0,14428,14461,5
Task 14429,Job 0,9,6,4,7,0,13,16,3,4,3,2,14429,14462,19
Task 14429,Job 1,14,6,3,11,0,17,25,8,3,2,0,14429,14462,12
Task 14430,Job 0,6,5,2,12,0,8,18,10,2,1,2,14430,14463,18
Task 14430,Job 1,11,5,3,11,1,14,22,8,3,3,2,14430,14463,11
Task 14431,Job 0,5,10,2,11,1,7,16,9,2,3,2,14431,14464,2
Task 14431,Job 1,10,8,3,12,0,13,22,9,3,3,0,14431,14464,12
Task 14432,Job 0,1,4,2,11,0,3,12,9,2,1,2,14432,14466,20
Task 14432,Job 1,6,6,4,12,1,10,18,8,4,1,0,14432,14466,9
Task 14433,Job 0,8,5,2,9,0,10,17,7,2,4,0,14433,14467,6
Task 14433,Job 1,13,7,4,11,1,17,24,7,4,1,0,14433,14467,9
Task 14434,Job 0,5,7,1,11,0,6,16,10,1,1,2,14434,14468,17
Task 14434,Job 1,10,5,3,10,1,13,20,7,3,1,2,14434,14468,6
Task 14435,Job 0,10,9,3,8,0,13,18,5,3,1,2,14435,14468,10
Task 14435,Job 1,15,7,3,11,1,18,26,8,3,3,1,14435,14468,13
Task 14436,Job 0,3,5,2,9,0,5,12,7,2,4,1,14436,14470,4
Task 14436,Job 1,8,7,3,10,0,11,18,7,3,4,1,14436,14470,10
Task 14437,Job 0,7,9,2,9,0,9,16,7,2,1,2,14437,14471,17
Task 14437,Job 1,12,8,3,9,0,15,21,6,3,4,2,14437,14471,7
Task 14438,Job 0,4,7,4,11,0,8,15,7,4,2,2,14438,14472,9
Task 14438,Job 1,9,5,4,8,1,13,17,4,4,3,0,14438,14472,17
Task 14439,Job 0,8,7,1,10,0,9,18,9,1,4,0,14439,14473,3
Task 14439,Job 1,13,5,3,11,0,16,24,8,3,3,0,14439,14473,16
Task 14440,Job 0,9,5,3,11,0,12,20,8,3,1,1,14440,14474,13
Task 14440,Job 1,14,4,2,7,0,16,21,5,2,3,1,14440,14474,5
Task 14441,Job 0,2,6,2,8,0,4,10,6,2,4,1,14441,14474,12
Task 14441,Job 1,7,5,3,9,0,10,16,6,3,2,2,14441,14474,20
Task 14442,Job 0,4,8,4,7,0,8,11,3,4,4,0,14442,14475,6
Task 14442,Job 1,9,7,3,7,0,12,16,4,3,3,1,14442,14475,17
Task 14443,Job 0,8,5,3,9,0,11,17,6,3,4,0,14443,14476,10
Task 14443,Job 1,13,5,3,6,1,16,19,3,3,3,0,14443,14476,6
Task 14444,Job 0,8,8,3,9,0,11,17,6,3,2,1,14444,14477,5
Task 14444,Job 1,13,6,1,8,0,14,21,7,1,2,2,14444,14477,4
Task 14445,Job 0,9,4,1,12,0,10,21,11,1,1,0,14445,14478,6
Task 14445,Job 1,14,4,2,10,1,16,24,8,2,2,1,14445,14478,10
Task 14446,Job 0,6,6,4,9,0,10,15,5,4,4,0,14446,14480,20
Task 14446,Job 1,11,5,1,10,0,12,21,9,1,3,0,14446,14480,8
Task 14447,Job 0,7,6,1,12,1,8,19,11,1,3,1,14447,14480,11
Task 14447,Job 1,12,7,3,7,0,15,19,4,3,2,1,14447,14480,15
Task 14448,Job 0,10,5,2,12,1,12,22,10,2,3,0,14448,14481,6
Task 14448,Job 1,15,10,2,8,0,17,23,6,2,1,1,14448,14481,11
Task 14449,Job 0,10,9,3,12,1,13,22,9,3,3,1,14449,14483,9
Task 14449,Job 1,15,8,1,11,0,16,26,10,1,2,0,14449,14483,20
Task 14450,Job 0,7,7,3,10,1,10,17,7,3,2,2,14450,14484,17
Task 14450,Job 1,12,9,3,8,0,15,20,5,3,2,0,14450,14484,12
Task 14451,Job 0,3,10,1,11,0,4,14,10,1,1,1,14451,14485,15
Task 14451,Job 1,8,5,4,9,0,12,17,5,4,3,0,14451,14485,4
Task 14452,Job 0,4,9,1,11,0,5,15,10,1,2,2,14452,14486,13
Task 14452,Job 1,9,4,2,7,0,11,16,5,2,4,0,14452,14486,6
Task 14453,Job 0,3,4,4,7,0,7,10,3,4,4,1,14453,14487,17
Task 14453,Job 1,8,4,1,9,1,9,17,8,1,3,1,14453,14487,5
Task 14454,Job 0,10,5,1,10,1,11,20,9,1,2,1,14454,14488,8
Task 14454,Job 1,15,6,4,6,0,19,21,2,4,4,1,14454,14488,16
Task 14455,Job 0,6,6,4,12,0,10,18,8,4,2,1,14455,14488,4
Task 14455,Job 1,11,9,3,10,1,14,21,7,3,3,0,14455,14488,4
Task 14456,Job 0,5,10,1,9,1,6,14,8,1,4,1,14456,14490,17
Task 14456,Job 1,10,6,4,9,0,14,19,5,4,2,0,14456,14490,19
Task 14457,Job 0,4,6,1,12,1,5,16,11,1,3,2,14457,14491,10
Task 14457,Job 1,9,5,4,7,0,13,16,3,4,1,0,14457,14491,14
Task 14458,Job 0,10,10,4,8,0,14,18,4,4,2,1,14458,14492,19
Task 14458,Job 1,15,9,1,7,1,16,22,6,1,4,2,14458,14492,4
Task 14459,Job 0,4,6,4,10,0,8,14,6,4,4,2,14459,14493,5
Task 14459,Job 1,9,4,1,10,0,10,19,9,1,4,2,14459,14493,11
Task 14460,Job 0,9,8,4,7,0,13,16,3,4,3,0,14460,14494,6
Task 14460,Job 1,14,7,3,9,0,17,23,6,3,4,1,14460,14494,6
Task 14461,Job 0,3,5,2,9,0,5,12,7,2,2,1,14461,14494,5
Task 14461,Job 1,8,8,4,10,0,12,18,6,4,3,1,14461,14494,7
Task 14462,Job 0,2,7,3,6,0,5,8,3,3,4,1,14462,14496,8
Task 14462,Job 1,7,8,2,7,0,9,14,5,2,1,1,14462,14496,19
Task 14463,Job 0,6,7,2,10,0,8,16,8,2,2,2,14463,14497,4
Task 14463,Job 1,11,10,1,7,0,12,18,6,1,1,1,14463,14497,4
Task 14464,Job 0,5,10,4,11,0,9,16,7,4,4,1,14464,14498,7
Task 14464,Job 1,10,9,3,9,0,13,19,6,3,2,1,14464,14498,8
Task 14465,Job 0,10,9,1,12,0,11,22,11,1,1,0,14465,14499,4
Task 14465,Job 1,15,8,1,9,0,16,24,8,1,3,2,14465,14499,15
Task 14466,Job 0,10,7,2,7,1,12,17,5,2,2,0,14466,14499,5
Task 14466,Job 1,15,4,2,8,0,17,23,6,2,1,1,14466,14499,12
Task 14467,Job 0,9,4,2,6,0,11,15,4,2,4,0,14467,14500,2
Task 14467,Job 1,14,9,1,12,0,15,26,11,1,1,0,14467,14500,8
Task 14468,Job 0,2,9,2,10,1,4,12,8,2,2,1,14468,14501,16
Task 14468,Job 1,7,6,3,7,0,10,14,4,3,2,1,14468,14501,5
Task 14469,Job 0,3,7,3,12,1,6,15,9,3,3,1,14469,14503,20
Task 14469,Job 1,8,4,4,12,1,12,20,8,4,2,1,14469,14503,13
Task 14470,Job 0,3,7,4,12,0,7,15,8,4,4,1,14470,14504,15
Task 14470,Job 1,8,8,3,7,0,11,15,4,3,1,2,14470,14504,15
Task 14471,Job 0,1,6,4,6,0,5,7,2,4,3,2,14471,14505,4
Task 14471,Job 1,6,5,3,12,1,9,18,9,3,4,0,14471,14505,10
Task 14472,Job 0,9,4,1,8,0,10,17,7,1,3,2,14472,14505,6
Task 14472,Job 1,14,10,4,7,1,18,21,3,4,3,2,14472,14505,2
Task 14473,Job 0,8,4,4,12,0,12,20,8,4,1,1,14473,14506,5
Task 14473,Job 1,13,5,2,7,0,15,20,5,2,2,0,14473,14506,17
Task 14474,Job 0,8,10,3,11,0,11,19,8,3,4,1,14474,14507,18
Task 14474,Job 1,13,4,1,10,0,14,23,9,1,3,0,14474,14507,8
Task 14475,Job 0,7,10,3,7,0,10,14,4,3,4,1,14475,14509,7
Task 14475,Job 1,12,10,2,7,0,14,19,5,2,3,0,14475,14509,16
Task 14476,Job 0,9,8,1,8,0,10,17,7,1,3,2,14476,14510,13
Task 14476,Job 1,14,5,3,9,1,17,23,6,3,3,1,14476,14510,13
Task 14477,Job 0,8,7,2,7,0,10,15,5,2,3,2,14477,14510,19
Task 14477,Job 1,13,5,3,6,0,16,19,3,3,2,0,14477,14510,20
Task 14478,Job 0,1,4,3,11,0,4,12,8,3,1,2,14478,14511,7
Task 14478,Job 1,6,5,3,9,0,9,15,6,3,2,2,14478,14511,4
Task 14479,Job 0,5,10,3,12,0,8,17,9,3,2,2,14479,14513,8
Task 14479,Job 1,10,10,1,6,0,11,16,5,1,1,0,14479,14513,2
Task 14480,Job 0,8,8,2,7,0,10,15,5,2,4,0,14480,14514,8
Task 14480,Job 1,13,6,3,12,0,16,25,9,3,3,1,14480,14514,15
Task 14481,Job 0,6,10,4,8,0,10,14,4,4,3,2,14481,14514,3
Task 14481,Job 1,11,8,1,9,0,12,20,8,1,2,2,14481,14514,11
Task 14482,Job 0,10,6,4,10,0,14,20,6,4,1,1,14482,14516,2
Task 14482,Job 1,15,9,1,10,0,16,25,9,1,2,0,14482,14516,16
Task 14483,Job 0,5,4,2,10,0,7,15,8,2,4,0,14483,14516,8
Task 14483,Job 1,10,7,3,10,0,13,20,7,3,2,0,14483,14516,3
Task 14484,Job 0,6,7,3,6,1,9,12,3,3,2,0,14484,14517,7
Task 14484,Job 1,11,4,2,11,0,13,22,9,2,2,2,14484,14517,6
Task 14485,Job 0,6,10,2,9,1,8,15,7,2,2,1,14485,14518,3
Task 14485,Job 1,11,10,1,11,0,12,22,10,1,2,1,14485,14518,13
Task 14486,Job 0,8,6,4,12,0,12,20,8,4,2,2,14486,14519,11
Task 14486,Job 1,13,10,1,9,0,14,22,8,1,2,2,14486,14519,2
Task 14487,Job 0,2,9,1,8,0,3,10,7,1,4,2,14487,14520,13
Task 14487,Job 1,7,4,4,11,0,11,18,7,4,4,0,14487,14520,8
Task 14488,Job 0,10,5,4,6,0,14,16,2,4,3,2,14488,14521,13
Task 14488,Job 1,15,6,1,9,0,16,24,8,1,2,2,14488,14521,18
Task 14489,Job 0,8,7,4,8,0,12,16,4,4,4,0,14489,14523,2
Task 14489,Job 1,13,5,1,9,0,14,22,8,1,2,1,14489,14523,4
Task 14490,Job 0,9,9,3,11,0,12,20,8,3,1,2,14490,14523,11
Task 14490,Job 1,14,7,1,8,0,15,22,7,1,3,2,14490,14523,18
Task 14491,Job 0,3,8,1,7,0,4,10,6,1,1,1,14491,14524,2
Task 14491,Job 1,8,7,1,10,0,9,18,9,1,2,1,14491,14524,11
Task 14492,Job 0,6,5,1,9,0,7,15,8,1,3,2,14492,14525,7
Task 14492,Job 1,11,7,2,6,1,13,17,4,2,2,2,14492,14525,11
Task 14493,Job 0,9,6,4,12,0,13,21,8,4,4,0,14493,14526,8
Task 14493,Job 1,14,4,4,7,0,18,21,3,4,1,1,14493,14526,2
Task 14494,Job 0,4,10,1,7,0,5,11,6,1,3,0,14494,14527,17
Task 14494,Job 1,9,6,2,9,0,11,18,7,2,3,0,14494,14527,12
Task 14495,Job 0,3,4,1,7,0,4,10,6,1,4,0,14495,14529,11
Task 14495,Job 1,8,6,3,11,0,11,19,8,3,3,2,14495,14529,7
Task 14496,Job 0,3,4,3,11,0,6,14,8,3,4,2,14496,14529,8
Task 14496,Job 1,8,8,4,12,0,12,20,8,4,1,0,14496,14529,3
Task 14497,Job 0,8,4,4,6,0,12,14,2,4,1,2,14497,14530,10
Task 14497,Job 1,13,10,2,11,0,15,24,9,2,2,1,14497,14530,17
Task 14498,Job 0,2,4,2,8,0,4,10,6,2,3,2,14498,14531,18
Task 14498,Job 1,7,8,2,10,0,9,17,8,2,4,0,14498,14531,19
Task 14499,Job 0,1,6,1,9,0,2,10,8,1,4,0,14499,14532,10
Task 14499,Job 1,6,5,2,12,0,8,18,10,2,1,0,14499,14532,8
Task 14500,Job 0,1,10,4,7,0,5,8,3,4,4,1,14500,14534,14
Task 14500,Job 1,6,4,1,12,0,7,18,11,1,2,1,14500,14534,16
Task 14501,Job 0,9,7,1,7,0,10,16,6,1,1,1,14501,14534,5
Task 14501,Job 1,14,8,2,11,0,16,25,9,2,2,0,14501,14534,18
Task 14502,Job 0,4,7,4,10,0,8,14,6,4,2,0,14502,14536,5
Task 14502,Job 1,9,7,2,11,0,11,20,9,2,2,1,14502,14536,11
Task 14503,Job 0,5,10,1,11,0,6,16,10,1,2,2,14503,14537,18
Task 14503,Job 1,10,6,2,12,1,12,22,10,2,2,2,14503,14537,13
Task 14504,Job 0,2,5,4,12,1,6,14,8,4,4,1,14504,14538,7
Task 14504,Job 1,7,8,1,10,1,8,17,9,1,3,1,14504,14538,4
Task 14505,Job 0,8,6,4,9,0,12,17,5,4,1,1,14505,14538,15
Task 14505,Job 1,13,8,3,6,0,16,19,3,3,4,0,14505,14538,19
Task 14506,Job 0,7,7,3,6,0,10,13,3,3,2,0,14506,14539,11
Task 14506,Job 1,12,7,3,8,0,15,20,5,3,4,0,14506,14539,8
Task 14507,Job 0,2,7,2,9,0,4,11,7,2,4,0,14507,14540,16
Task 14507,Job 1,7,7,1,8,0,8,15,7,1,4,0,14507,14540,16
Task 14508,Job 0,7,4,2,6,0,9,13,4,2,3,1,14508,14541,16
Task 14508,Job 1,12,8,2,6,0,14,18,4,2,2,1,14508,14541,19
Task 14509,Job 0,8,4,1,6,0,9,14,5,1,3,0,14509,14543,8
Task 14509,Job 1,13,10,3,9,0,16,22,6,3,3,2,14509,14543,6
Task 14510,Job 0,10,5,4,8,0,14,18,4,4,1,1,14510,14543,10
Task 14510,Job 1,15,8,2,6,1,17,21,4,2,2,1,14510,14543,7
Task 14511,Job 0,7,9,1,10,0,8,17,9,1,2,2,14511,14544,13
Task 14511,Job 1,12,9,4,6,0,16,18,2,4,2,0,14511,14544,10
Task 14512,Job 0,1,8,1,11,1,2,12,10,1,4,1,14512,14546,7
Task 14512,Job 1,6,4,4,10,1,10,16,6,4,4,1,14512,14546,13
Task 14513,Job 0,1,6,3,12,0,4,13,9,3,4,2,14513,14547,4
Task 14513,Job 1,6,8,2,8,1,8,14,6,2,3,2,14513,14547,14
Task 14514,Job 0,10,8,4,9,0,14,19,5,4,2,1,14514,14548,6
Task 14514,Job 1,15,6,1,6,0,16,21,5,1,1,2,14514,14548,5
Task 14515,Job 0,4,6,2,12,0,6,16,10,2,3,0,14515,14549,8
Task 14515,Job 1,9,7,4,12,0,13,21,8,4,3,0,14515,14549,6
Task 14516,Job 0,8,4,4,12,1,12,20,8,4,4,0,14516,14550,3
Task 14516,Job 1,13,5,2,7,0,15,20,5,2,4,0,14516,14550,19
Task 14517,Job 0,7,9,2,10,1,9,17,8,2,3,0,14517,14551,5
Task 14517,Job 1,12,5,3,10,1,15,22,7,3,4,2,14517,14551,3
Task 14518,Job 0,3,6,4,10,0,7,13,6,4,2,1,14518,14551,15
Task 14518,Job 1,8,6,3,6,1,11,14,3,3,2,0,14518,14551,10
Task 14519,Job 0,10,6,3,11,1,13,21,8,3,4,0,14519,14552,7
Task 14519,Job 1,15,6,2,8,0,17,23,6,2,2,2,14519,14552,13
Task 14520,Job 0,6,10,2,12,0,8,18,10,2,3,2,14520,14553,20
Task 14520,Job 1,11,4,1,6,1,12,17,5,1,1,1,14520,14553,16
Task 14521,Job 0,5,7,3,6,0,8,11,3,3,4,0,14521,14555,17
Task 14521,Job 1,10,7,4,8,0,14,18,4,4,4,1,14521,14555,16
Task 14522,Job 0,1,4,1,8,1,2,9,7,1,2,1,14522,14555,17
Task 14522,Job 1,6,5,2,8,0,8,14,6,2,1,1,14522,14555,9
Task 14523,Job 0,6,9,2,7,0,8,13,5,2,2,2,14523,14556,17
Task 14523,Job 1,11,9,3,7,1,14,18,4,3,4,2,14523,14556,5
Task 14524,Job 0,2,9,3,8,0,5,10,5,3,4,2,14524,14557,20
Task 14524,Job 1,7,9,1,11,1,8,18,10,1,3,1,14524,14557,3
Task 14525,Job 0,9,10,1,6,0,10,15,5,1,3,0,14525,14559,13
Task 14525,Job 1,14,8,1,8,1,15,22,7,1,3,0,14525,14559,12
Task 14526,Job 0,9,6,2,6,0,11,15,4,2,2,0,14526,14559,13
Task 14526,Job 1,14,9,3,7,0,17,21,4,3,3,1,14526,14559,15
Task 14527,Job 0,6,5,3,11,0,9,17,8,3,2,2,14527,14560,3
Task 14527,Job 1,11,7,2,8,0,13,19,6,2,4,1,14527,14560,9
Task 14528,Job 0,9,7,2,8,0,11,17,6,2,1,2,14528,14562,19
Task 14528,Job 1,14,5,1,11,0,15,25,10,1,3,1,14528,14562,8
Task 14529,Job 0,10,4,3,7,0,13,17,4,3,4,1,14529,14562,5
Task 14529,Job 1,15,5,4,10,0,19,25,6,4,3,1,14529,14562,4
Task 14530,Job 0,3,8,3,6,0,6,9,3,3,2,0,14530,14563,11
Task 14530,Job 1,8,8,1,9,0,9,17,8,1,2,1,14530,14563,4
Task 14531,Job 0,3,5,3,7,0,6,10,4,3,2,1,14531,14565,11
Task 14531,Job 1,8,6,2,8,0,10,16,6,2,2,0,14531,14565,11
Task 14532,Job 0,5,7,3,9,0,8,14,6,3,2,1,14532,14566,20
Task 14532,Job 1,10,4,3,8,0,13,18,5,3,1,2,14532,14566,14
Task 14533,Job 0,6,6,3,6,0,9,12,3,3,2,0,14533,14566,12
Task 14533,Job 1,11,5,2,7,0,13,18,5,2,3,1,14533,14566,8
Task 14534,Job 0,1,7,4,7,0,5,8,3,4,4,1,14534,14567,16
Task 14534,Job 1,6,4,3,7,0,9,13,4,3,2,0,14534,14567,19
Task 14535,Job 0,7,4,4,7,0,11,14,3,4,3,1,14535,14568,6
Task 14535,Job 1,12,10,2,12,0,14,24,10,2,4,1,14535,14568,3
Task 14536,Job 0,4,8,4,6,0,8,10,2,4,2,2,14536,14569,11
Task 14536,Job 1,9,6,3,6,1,12,15,3,3,2,2,14536,14569,14
Task 14537,Job 0,9,7,1,11,1,10,20,10,1,3,2,14537,14571,18
Task 14537,Job 1,14,9,4,8,0,18,22,4,4,1,0,14537,14571,2
Task 14538,Job 0,10,10,1,6,0,11,16,5,1,3,2,14538,14571,9
Task 14538,Job 1,15,10,2,7,1,17,22,5,2,3,0,14538,14571,5
Task 14539,Job 0,4,8,1,6,0,5,10,5,1,2,1,14539,14572,15
Task 14539,Job 1,9,6,2,9,0,11,18,7,2,2,1,14539,14572,13
Task 14540,Job 0,10,10,2,9,1,12,19,7,2,2,0,14540,14574,5
Task 14540,Job 1,15,8,4,9,0,19,24,5,4,4,2,14540,14574,13
Task 14541,Job 0,3,9,3,9,1,6,12,6,3,3,1,14541,14574,20
Task 14541,Job 1,8,8,1,12,0,9,20,11,1,3,0,14541,14574,16
Task 14542,Job 0,3,10,2,7,1,5,10,5,2,1,0,14542,14576,17
Task 14542,Job 1,8,6,2,9,0,10,17,7,2,2,1,14542,14576,19
Task 14543,Job 0,6,6,2,9,1,8,15,7,2,2,2,14543,14577,6
Task 14543,Job 1,11,9,2,9,0,13,20,7,2,4,0,14543,14577,6
Task 14544,Job 0,4,10,4,6,1,8,10,2,4,1,2,14544,14578,6
Task 14544,Job 1,9,4,2,12,1,11,21,10,2,4,0,14544,14578,8
Task 14545,Job 0,3,4,2,8,0,5,11,6,2,2,0,14545,14578,18
Task 14545,Job 1,8,7,4,10,1,12,18,6,4,3,0,14545,14578,16
Task 14546,Job 0,9,8,2,6,0,11,15,4,2,2,2,14546,14580,18
Task 14546,Job 1,14,10,3,11,0,17,25,8,3,2,2,14546,14580,17
Task 14547,Job 0,1,6,4,10,0,5,11,6,4,2,0,14547,14581,16
Task 14547,Job 1,6,8,2,8,1,8,14,6,2,4,1,14547,14581,3
Task 14548,Job 0,1,7,2,11,0,3,12,9,2,3,0,14548,14582,6
Task 14548,Job 1,6,7,1,12,0,7,18,11,1,1,2,14548,14582,20
Task 14549,Job 0,4,7,2,10,0,6,14,8,2,3,0,14549,14583,8
Task 14549,Job 1,9,10,3,10,0,12,19,7,3,4,1,14549,14583,5
Task 14550,Job 0,8,8,1,10,1,9,18,9,1,3,0,14550,14583,4
Task 14550,Job 1,13,9,1,9,0,14,22,8,1,1,1,14550,14583,11
Task 14551,Job 0,9,6,1,9,1,10,18,8,1,1,0,14551,14584,6
Task 14551,Job 1,14,7,4,8,1,18,22,4,4,1,2,14551,14584,9
Task 14552,Job 0,7,5,1,12,0,8,19,11,1,2,1,14552,14585,8
Task 14552,Job 1,12,8,1,11,0,13,23,10,1,3,1,14552,14585,6
Task 14553,Job 0,6,6,3,8,0,9,14,5,3,4,2,14553,14587,13
Task 14553,Job 1,11,10,3,7,0,14,18,4,3,1,0,14553,14587,12
Task 14554,Job 0,9,4,4,7,0,13,16,3,4,2,2,14554,14588,11
Task 14554,Job 1,14,8,2,6,0,16,20,4,2,2,2,14554,14588,3
Task 14555,Job 0,3,8,4,7,1,7,10,3,4,1,2,14555,14588,17
Task 14555,Job 1,8,9,3,8,1,11,16,5,3,2,2,14555,14588,3
Task 14556,Job 0,8,7,4,7,0,12,15,3,4,1,2,14556,14589,9
Task 14556,Job 1,13,10,2,12,0,15,25,10,2,2,2,14556,14589,19
Task 14557,Job 0,10,7,1,9,0,11,19,8,1,3,2,14557,14591,20
Task 14557,Job 1,15,6,4,10,1,19,25,6,4,2,1,14557,14591,11
Task 14558,Job 0,2,6,3,9,0,5,11,6,3,4,2,14558,14591,9
Task 14558,Job 1,7,4,4,12,0,11,19,8,4,4,2,14558,14591,17
Task 14559,Job 0,9,7,1,9,1,10,18,8,1,3,1,14559,14593,8
Task 14559,Job 1,14,10,3,10,0,17,24,7,3,2,0,14559,14593,3
Task 14560,Job 0,1,10,1,11,1,2,12,10,1,2,1,14560,14593,4
Task 14560,Job 1,6,4,3,6,0,9,12,3,3,1,2,14560,14593,19
Task 14561,Job 0,7,8,4,8,1,11,15,4,4,1,2,14561,14595,11
Task 14561,Job 1,12,4,4,6,0,16,18,2,4,3,2,14561,14595,15
Task 14562,Job 0,2,9,4,7,0,6,9,3,4,4,0,14562,14596,16
Task 14562,Job 1,7,10,3,6,0,10,13,3,3,3,0,14562,14596,2
Task 14563,Job 0,5,8,3,10,0,8,15,7,3,3,1,14563,14596,11
Task 14563,Job 1,10,4,3,12,0,13,22,9,3,3,2,14563,14596,6
Task 14564,Job 0,4,8,4,12,0,8,16,8,4,3,2,14564,14597,14
Task 14564,Job 1,9,10,3,10,0,12,19,7,3,1,1,14564,14597,9
Task 14565,Job 0,10,8,2,11,0,12,21,9,2,1,1,14565,14599,18
Task 14565,Job 1,15,4,4,8,0,19,23,4,4,1,0,14565,14599,2
Task 14566,Job 0,9,5,1,6,0,10,15,5,1,3,2,14566,14600,19
Task 14566,Job 1,14,10,2,12,0,16,26,10,2,3,1,14566,14600,3
Task 14567,Job 0,8,6,4,7,0,12,15,3,4,3,1,14567,14601,7
Task 14567,Job 1,13,8,3,12,0,16,25,9,3,2,0,14567,14601,17
Task 14568,Job 0,10,10,1,8,0,11,18,7,1,4,1,14568,14602,12
Task 14568,Job 1,15,4,1,7,0,16,22,6,1,3,2,14568,14602,15
Task 14569,Job 0,10,8,3,9,0,13,19,6,3,1,1,14569,14602,11
Task 14569,Job 1,15,10,2,7,0,17,22,5,2,3,2,14569,14602,13
Task 14570,Job 0,1,10,4,9,0,5,10,5,4,3,2,14570,14604,5
Task 14570,Job 1,6,5,1,11,0,7,17,10,1,1,1,14570,14604,4
Task 14571,Job 0,3,5,1,9,0,4,12,8,1,2,1,14571,14605,17
Task 14571,Job 1,8,8,4,8,0,12,16,4,4,2,2,14571,14605,16
Task 14572,Job 0,2,7,1,9,0,3,11,8,1,3,1,14572,14605,19
Task 14572,Job 1,7,8,4,12,0,11,19,8,4,4,0,14572,14605,2
Task 14573,Job 0,9,10,3,9,1,12,18,6,3,4,2,14573,14606,7
Task 14573,Job 1,14,8,1,6,0,15,20,5,1,2,2,14573,14606,4
Task 14574,Job 0,1,10,1,7,1,2,8,6,1,1,0,14574,14607,9
Task 14574,Job 1,6,10,3,8,1,9,14,5,3,2,2,14574,14607,19
Task 14575,Job 0,9,5,3,10,1,12,19,7,3,1,0,14575,14609,9
Task 14575,Job 1,14,7,1,9,1,15,23,8,1,4,1,14575,14609,7
Task 14576,Job 0,5,5,3,7,0,8,12,4,3,2,2,14576,14610,6
Task 14576,Job 1,10,10,1,6,0,11,16,5,1,4,2,14576,14610,11
Task 14577,Job 0,1,6,1,11,0,2,12,10,1,1,0,14577,14610,3
Task 14577,Job 1,6,9,2,10,0,8,16,8,2,3,1,14577,14610,5
Task 14578,Job 0,10,5,1,6,1,11,16,5,1,4,2,14578,14612,17
Task 14578,Job 1,15,10,4,12,1,19,27,8,4,4,1,14578,14612,10
Task 14579,Job 0,1,5,4,7,0,5,8,3,4,4,0,14579,14613,16
Task 14579,Job 1,6,7,2,8,0,8,14,6,2,1,0,14579,14613,2
Task 14580,Job 0,4,7,2,9,1,6,13,7,2,3,1,14580,14614,13
Task 14580,Job 1,9,6,2,6,1,11,15,4,2,2,2,14580,14614,4
Task 14581,Job 0,5,4,3,10,1,8,15,7,3,2,1,14581,14614,4
Task 14581,Job 1,10,6,4,9,0,14,19,5,4,1,1,14581,14614,5
Task 14582,Job 0,6,5,4,11,0,10,17,7,4,4,1,14582,14616,7
Task 14582,Job 1,11,9,3,9,0,14,20,6,3,1,2,14582,14616,5
Task 14583,Job 0,10,4,1,9,0,11,19,8,1,2,1,14583,14616,20
Task 14583,Job 1,15,7,4,10,0,19,25,6,4,4,1,14583,14616,5
Task 14584,Job 0,8,4,3,12,0,11,20,9,3,1,0,14584,14617,12
Task 14584,Job 1,13,9,3,9,1,16,22,6,3,4,1,14584,14617,3
Task 14585,Job 0,8,5,3,6,1,11,14,3,3,2,2,14585,14618,2
Task 14585,Job 1,13,7,1,7,0,14,20,6,1,1,0,14585,14618,11
Task 14586,Job 0,7,4,3,6,1,10,13,3,3,4,0,14586,14620,4
Task 14586,Job 1,12,5,1,12,0,13,24,11,1,2,1,14586,14620,12
Task 14587,Job 0,7,6,3,9,0,10,16,6,3,4,1,14587,14620,9
Task 14587,Job 1,12,7,4,11,0,16,23,7,4,1,1,14587,14620,6
Task 14588,Job 0,4,6,3,8,0,7,12,5,3,4,2,14588,14622,5
Task 14588,Job 1,9,6,3,9,0,12,18,6,3,1,0,14588,14622,17
Task 14589,Job 0,5,10,3,12,0,8,17,9,3,3,0,14589,14623,5
Task 14589,Job 1,10,4,3,6,0,13,16,3,3,2,2,14589,14623,2
Task 14590,Job 0,4,7,3,11,0,7,15,8,3,2,0,14590,14624,15
Task 14590,Job 1,9,9,1,8,0,10,17,7,1,1,2,14590,14624,5
Task 14591,Job 0,6,4,4,6,0,10,12,2,4,4,0,14591,14625,12
Task 14591,Job 1,11,6,4,9,0,15,20,5,4,3,2,14591,14625,11
Task 14592,Job 0,7,8,4,7,1,11,14,3,4,4,2,14592,14626,2
Task 14592,Job 1,12,5,1,10,0,13,22,9,1,4,0,14592,14626,2
Task 14593,Job 0,2,10,2,11,1,4,13,9,2,1,1,14593,14626,14
Task 14593,Job 1,7,4,4,6,0,11,13,2,4,3,0,14593,14626,3
Task 14594,Job 0,1,8,1,8,1,2,9,7,1,4,0,14594,14628,6
Task 14594,Job 1,6,8,3,10,0,9,16,7,3,2,2,14594,14628,7
Task 14595,Job 0,3,6,4,11,0,7,14,7,4,3,1,14595,14628,2
Task 14595,Job 1,8,8,1,12,0,9,20,11,1,3,1,14595,14628,10
Task 14596,Job 0,9,10,1,6,1,10,15,5,1,4,2,14596,14630,10
Task 14596,Job 1,14,5,1,12,1,15,26,11,1,4,1,14596,14630,13
Task 14597,Job 0,7,6,1,9,0,8,16,8,1,1,2,14597,14630,17
Task 14597,Job 1,12,9,1,8,0,13,20,7,1,3,1,14597,14630,2
Task 14598,Job 0,5,9,2,12,0,7,17,10,2,2,1,14598,14632,3
Task 14598,Job 1,10,8,4,7,0,14,17,3,4,3,1,14598,14632,8
Task 14599,Job 0,7,10,2,6,1,9,13,4,2,4,0,14599,14632,6
Task 14599,Job 1,12,8,1,12,1,13,24,11,1,1,0,14599,14632,9
Task 14600,Job 0,9,5,3,10,1,12,19,7,3,3,0,14600,14633,8
Task 14600,Job 1,14,9,1,8,1,15,22,7,1,4,1,14600,14633,5
Task 14601,Job 0,6,9,4,8,0,10,14,4,4,4,0,14601,14634,17
Task 14601,Job 1,11,5,4,7,0,15,18,3,4,1,0,14601,14634,16
Task 14602,Job 0,5,9,3,12,0,8,17,9,3,1,2,14602,14635,16
Task 14602,Job 1,10,4,4,9,0,14,19,5,4,2,0,14602,14635,12
Task 14603,Job 0,10,10,2,7,0,12,17,5,2,1,2,14603,14636,2
Task 14603,Job 1,15,8,2,9,1,17,24,7,2,2,1,14603,14636,5
Task 14604,Job 0,5,8,1,11,0,6,16,10,1,2,0,14604,14637,16
Task 14604,Job 1,10,6,4,6,0,14,16,2,4,1,0,14604,14637,11
Task 14605,Job 0,5,9,1,8,1,6,13,7,1,1,0,14605,14638,16
Task 14605,Job 1,10,4,4,8,0,14,18,4,4,2,0,14605,14638,20
Task 14606,Job 0,4,7,2,11,0,6,15,9,2,4,1,14606,14639,18
Task 14606,Job 1,9,5,1,8,1,10,17,7,1,4,0,14606,14639,6
Task 14607,Job 0,1,8,1,7,0,2,8,6,1,4,0,14607,14641,9
Task 14607,Job 1,6,6,4,8,1,10,14,4,4,1,0,14607,14641,11
Task 14608,Job 0,7,5,4,6,0,11,13,2,4,2,0,14608,14641,19
Task 14608,Job 1,12,5,1,10,0,13,22,9,1,1,2,14608,14641,3
Task 14609,Job 0,3,5,1,10,0,4,13,9,1,2,0,14609,14642,10
Task 14609,Job 1,8,8,3,7,0,11,15,4,3,4,0,14609,14642,4
Task 14610,Job 0,7,5,3,10,1,10,17,7,3,2,1,14610,14644,7
Task 14610,Job 1,12,4,3,12,0,15,24,9,3,1,2,14610,14644,11
Task 14611,Job 0,7,4,4,6,1,11,13,2,4,4,1,14611,14644,16
Task 14611,Job 1,12,9,4,6,0,16,18,2,4,1,1,14611,14644,5
Task 14612,Job 0,7,10,4,7,0,11,14,3,4,3,0,14612,14645,11
Task 14612,Job 1,12,6,4,6,1,16,18,2,4,3,1,14612,14645,9
Task 14613,Job 0,10,9,4,9,1,14,19,5,4,1,0,14613,14647,5
Task 14613,Job 1,15,10,1,9,0,16,24,8,1,1,2,14613,14647,5
Task 14614,Job 0,8,4,4,6,0,12,14,2,4,1,2,14614,14648,10
Task 14614,Job 1,13,5,4,9,0,17,22,5,4,4,0,14614,14648,7
Task 14615,Job 0,2,4,2,8,1,4,10,6,2,4,0,14615,14649,3
Task 14615,Job 1,7,10,3,8,0,10,15,5,3,3,1,14615,14649,3
Task 14616,Job 0,3,8,2,10,0,5,13,8,2,4,2,14616,14650,10
Task 14616,Job 1,8,7,4,12,0,12,20,8,4,3,1,14616,14650,4
Task 14617,Job 0,5,6,3,11,1,8,16,8,3,4,1,14617,14651,20
Task 14617,Job 1,10,8,1,6,0,11,16,5,1,4,2,14617,14651,4
Task 14618,Job 0,9,5,1,6,0,10,15,5,1,2,0,14618,14651,6
Task 14618,Job 1,14,7,2,7,0,16,21,5,2,1,0,14618,14651,5
Task 14619,Job 0,8,6,3,12,1,11,20,9,3,2,1,14619,14652,17
Task 14619,Job 1,13,10,2,10,1,15,23,8,2,1,1,14619,14652,19
Task 14620,Job 0,7,9,3,11,0,10,18,8,3,2,1,14620,14654,8
Task 14620,Job 1,12,9,2,6,0,14,18,4,2,2,0,14620,14654,4
Task 14621,Job 0,9,6,3,11,0,12,20,8,3,4,1,14621,14654,6
Task 14621,Job 1,14,10,1,9,1,15,23,8,1,2,0,14621,14654,14
Task 14622,Job 0,3,8,3,12,0,6,15,9,3,1,1,14622,14656,8
Task 14622,Job 1,8,8,3,11,1,11,19,8,3,1,0,14622,14656,6
Task 14623,Job 0,1,10,3,6,0,4,7,3,3,4,2,14623,14657,8
Task 14623,Job 1,6,6,3,9,0,9,15,6,3,1,2,14623,14657,7
Task 14624,Job 0,4,9,4,8,0,8,12,4,4,1,1,14624,14657,15
Task 14624,Job 1,9,6,1,12,0,10,21,11,1,3,2,14624,14657,19
Task 14625,Job 0,8,4,1,8,1,9,16,7,1,1,2,14625,14658,5
Task 14625,Job 1,13,6,3,8,0,16,21,5,3,4,2,14625,14658,15
Task 14626,Job 0,8,5,3,10,0,11,18,7,3,2,2,14626,14660,10
Task 14626,Job 1,13,6,4,6,0,17,19,2,4,3,0,14626,14660,17
Task 14627,Job 0,6,6,1,11,0,7,17,10,1,2,1,14627,14661,4
Task 14627,Job 1,11,7,1,11,0,12,22,10,1,4,1,14627,14661,10
Task 14628,Job 0,6,5,3,8,0,9,14,5,3,4,1,14628,14661,18
Task 14628,Job 1,11,6,1,10,0,12,21,9,1,2,0,14628,14661,5
Task 14629,Job 0,4,6,2,7,1,6,11,5,2,1,1,14629,14663,4
Task 14629,Job 1,9,9,4,10,0,13,19,6,4,1,0,14629,14663,8
Task 14630,Job 0,1,8,3,11,0,4,12,8,3,3,2,14630,14663,17
Task 14630,Job 1,6,5,2,7,0,8,13,5,2,4,1,14630,14663,18
Task 14631,Job 0,1,4,1,10,0,2,11,9,1,2,2,14631,14665,20
Task 14631,Job 1,6,8,4,8,0,10,14,4,4,4,0,14631,14665,2
Task 14632,Job 0,6,7,3,11,0,9,17,8,3,4,1,14632,14665,4
Task 14632,Job 1,11,10,1,7,0,12,18,6,1,4,2,14632,14665,15
Task 14633,Job 0,2,9,4,9,1,6,11,5,4,3,0,14633,14666,13
Task 14633,Job 1,7,10,3,10,0,10,17,7,3,4,0,14633,14666,2
Task 14634,Job 0,8,5,4,11,1,12,19,7,4,1,0,14634,14667,16
Task 14634,Job 1,13,4,1,12,0,14,25,11,1,2,0,14634,14667,2
Task 14635,Job 0,8,4,1,9,1,9,17,8,1,2,0,14635,14668,2
Task 14635,Job 1,13,8,2,7,0,15,20,5,2,4,1,14635,14668,8
Task 14636,Job 0,7,9,3,8,0,10,15,5,3,1,0,14636,14669,16
Task 14636,Job 1,12,9,4,6,0,16,18,2,4,4,1,14636,14669,16
Task 14637,Job 0,2,9,4,9,0,6,11,5,4,2,0,14637,14670,2
Task 14637,Job 1,7,4,1,9,1,8,16,8,1,4,0,14637,14670,11
Task 14638,Job 0,6,4,1,12,1,7,18,11,1,2,1,14638,14672,18
Task 14638,Job 1,11,7,1,8,0,12,19,7,1,4,1,14638,14672,14
Task 14639,Job 0,8,8,4,7,0,12,15,3,4,1,0,14639,14673,10
Task 14639,Job 1,13,8,2,7,1,15,20,5,2,1,1,14639,14673,15
Task 14640,Job 0,6,8,3,6,1,9,12,3,3,3,1,14640,14673,5
Task 14640,Job 1,11,9,2,9,1,13,20,7,2,4,1,14640,14673,20
Task 14641,Job 0,9,8,1,8,0,10,17,7,1,4,0,14641,14674,3
Task 14641,Job 1,14,8,3,9,1,17,23,6,3,4,0,14641,14674,17
Task 14642,Job 0,5,5,2,12,1,7,17,10,2,1,1,14642,14676,6
Task 14642,Job 1,10,8,1,8,1,11,18,7,1,4,0,14642,14676,19
Task 14643,Job 0,2,8,1,9,1,3,11,8,1,2,1,14643,14676,19
Task 14643,Job 1,7,5,3,6,0,10,13,3,3,1,2,14643,14676,7
Task 14644,Job 0,9,7,3,6,0,12,15,3,3,4,1,14644,14677,6
Task 14644,Job 1,14,8,2,7,1,16,21,5,2,4,2,14644,14677,16
Task 14645,Job 0,6,10,2,7,0,8,13,5,2,4,2,14645,14678,2
Task 14645,Job 1,11,5,4,8,0,15,19,4,4,1,0,14645,14678,12
Task 14646,Job 0,7,5,3,8,0,10,15,5,3,4,0,14646,14680,14
Task 14646,Job 1,12,8,4,8,0,16,20,4,4,4,0,14646,14680,4
Task 14647,Job 0,10,8,2,11,0,12,21,9,2,1,0,14647,14681,12
Task 14647,Job 1,15,4,4,11,0,19,26,7,4,1,0,14647,14681,2
Task 14648,Job 0,4,4,4,8,1,8,12,4,4,3,1,14648,14681,7
Task 14648,Job 1,9,9,3,9,1,12,18,6,3,4,0,14648,14681,19
Task 14649,Job 0,3,5,1,12,0,4,15,11,1,2,2,14649,14682,3
Task 14649,Job 1,8,7,3,8,0,11,16,5,3,4,2,14649,14682,20
Task 14650,Job 0,3,8,3,8,0,6,11,5,3,3,0,14650,14683,19
Task 14650,Job 1,8,10,2,10,0,10,18,8,2,1,0,14650,14683,16
Task 14651,Job 0,10,8,3,12,0,13,22,9,3,3,0,14651,14684,19
Task 14651,Job 1,15,9,1,8,0,16,23,7,1,1,1,14651,14684,5
Task 14652,Job 0,7,6,4,8,0,11,15,4,4,3,2,14652,14686,15
Task 14652,Job 1,12,9,3,7,0,15,19,4,3,3,1,14652,14686,14
Task 14653,Job 0,9,9,2,10,0,11,19,8,2,4,0,14653,14686,15
Task 14653,Job 1,14,7,3,6,1,17,20,3,3,2,1,14653,14686,12
Task 14654,Job 0,3,5,3,7,0,6,10,4,3,4,1,14654,14687,6
Task 14654,Job 1,8,4,1,7,0,9,15,6,1,4,0,14654,14687,20
Task 14655,Job 0,3,4,3,7,1,6,10,4,3,3,2,14655,14689,4
Task 14655,Job 1,8,10,3,11,0,11,19,8,3,2,2,14655,14689,7
Task 14656,Job 0,1,7,4,10,0,5,11,6,4,1,1,14656,14690,19
Task 14656,Job 1,6,10,2,10,0,8,16,8,2,1,0,14656,14690,20
Task 14657,Job 0,10,10,2,10,1,12,20,8,2,3,2,14657,14691,6
Task 14657,Job 1,15,9,1,6,1,16,21,5,1,1,0,14657,14691,18
Task 14658,Job 0,9,9,2,6,0,11,15,4,2,4,1,14658,14692,8
Task 14658,Job 1,14,9,1,8,0,15,22,7,1,1,1,14658,14692,15
Task 14659,Job 0,8,10,3,7,0,11,15,4,3,1,0,14659,14693,10
Task 14659,Job 1,13,8,3,6,0,16,19,3,3,3,2,14659,14693,2
Task 14660,Job 0,2,10,1,10,0,3,12,9,1,4,2,14660,14693,6
Task 14660,Job 1,7,8,2,7,0,9,14,5,2,2,2,14660,14693,12
Task 14661,Job 0,10,6,4,8,0,14,18,4,4,2,1,14661,14694,12
Task 14661,Job 1,15,6,2,6,0,17,21,4,2,3,0,14661,14694,7
Task 14662,Job 0,4,7,4,12,0,8,16,8,4,2,0,14662,14695,10
Task 14662,Job 1,9,9,3,12,1,12,21,9,3,2,1,14662,14695,7
Task 14663,Job 0,6,6,1,7,0,7,13,6,1,3,1,14663,14696,18
Task 14663,Job 1,11,8,3,10,0,14,21,7,3,1,2,14663,14696,6
Task 14664,Job 0,9,8,4,10,0,13,19,6,4,1,2,14664,14697,3
Task 14664,Job 1,14,5,3,12,0,17,26,9,3,1,0,14664,14697,9
Task 14665,Job 0,6,5,1,9,1,7,15,8,1,1,0,14665,14699,3
Task 14665,Job 1,11,5,3,6,1,14,17,3,3,3,2,14665,14699,4
Task 14666,Job 0,4,10,1,10,0,5,14,9,1,3,1,14666,14699,12
Task 14666,Job 1,9,4,2,12,0,11,21,10,2,3,2,14666,14699,17
Task 14667,Job 0,8,10,4,7,0,12,15,3,4,3,0,14667,14700,6
Task 14667,Job 1,13,7,3,8,1,16,21,5,3,3,2,14667,14700,15
Task 14668,Job 0,6,6,3,6,0,9,12,3,3,1,1,14668,14701,7
Task 14668,Job 1,11,10,4,9,0,15,20,5,4,2,1,14668,14701,5
Task 14669,Job 0,7,7,3,11,0,10,18,8,3,1,0,14669,14702,7
Task 14669,Job 1,12,6,2,10,1,14,22,8,2,2,0,14669,14702,15
Task 14670,Job 0,5,9,4,8,0,9,13,4,4,3,2,14670,14703,19
Task 14670,Job 1,10,5,2,11,1,12,21,9,2,1,0,14670,14703,20
Task 14671,Job 0,10,5,2,9,0,12,19,7,2,4,1,14671,14705,13
Task 14671,Job 1,15,9,1,8,0,16,23,7,1,1,1,14671,14705,20
Task 14672,Job 0,8,4,1,9,0,9,17,8,1,1,1,14672,14705,18
Task 14672,Job 1,13,9,4,6,0,17,19,2,4,4,0,14672,14705,19
Task 14673,Job 0,8,5,4,11,0,12,19,7,4,3,0,14673,14706,4
Task 14673,Job 1,13,8,1,6,0,14,19,5,1,4,1,14673,14706,14
Task 14674,Job 0,7,5,4,10,0,11,17,6,4,4,2,14674,14708,3
Task 14674,Job 1,12,9,1,12,0,13,24,11,1,3,2,14674,14708,6
Task 14675,Job 0,5,10,1,6,1,6,11,5,1,4,1,14675,14708,5
Task 14675,Job 1,10,9,4,10,0,14,20,6,4,3,0,14675,14708,12
Task 14676,Job 0,9,7,2,11,0,11,20,9,2,1,2,14676,14710,8
Task 14676,Job 1,14,7,3,11,0,17,25,8,3,3,2,14676,14710,7
Task 14677,Job 0,5,9,1,7,1,6,12,6,1,2,2,14677,14711,18
Task 14677,Job 1,10,4,4,10,1,14,20,6,4,3,2,14677,14711,12
Task 14678,Job 0,6,6,2,12,0,8,18,10,2,4,2,14678,14711,20
Task 14678,Job 1,11,8,2,10,0,13,21,8,2,3,0,14678,14711,11
Task 14679,Job 0,5,8,2,9,0,7,14,7,2,3,2,14679,14712,15
Task 14679,Job 1,10,8,3,8,1,13,18,5,3,2,0,14679,14712,8
Task 14680,Job 0,5,7,2,6,0,7,11,4,2,3,0,14680,14714,18
Task 14680,Job 1,10,8,2,10,0,12,20,8,2,2,2,14680,14714,8
Task 14681,Job 0,1,8,1,9,0,2,10,8,1,2,2,14681,14714,15
Task 14681,Job 1,6,6,3,9,1,9,15,6,3,1,2,14681,14714,8
Task 14682,Job 0,1,9,1,8,0,2,9,7,1,1,1,14682,14716,9
Task 14682,Job 1,6,8,1,10,0,7,16,9,1,4,0,14682,14716,13
Task 14683,Job 0,5,4,4,7,0,9,12,3,4,1,2,14683,14717,5
Task 14683,Job 1,10,9,3,8,0,13,18,5,3,4,2,14683,14717,7
Task 14684,Job 0,9,7,2,12,0,11,21,10,2,3,0,14684,14717,5
Task 14684,Job 1,14,9,2,12,0,16,26,10,2,3,0,14684,14717,12
Task 14685,Job 0,6,10,4,9,0,10,15,5,4,1,2,14685,14719,18
Task 14685,Job 1,11,8,2,12,0,13,23,10,2,1,1,14685,14719,14
Task 14686,Job 0,9,10,4,11,0,13,20,7,4,2,1,14686,14720,20
Task 14686,Job 1,14,6,1,10,0,15,24,9,1,4,0,14686,14720,5
Task 14687,Job 0,9,4,2,8,0,11,17,6,2,1,1,14687,14721,5
Task 14687,Job 1,14,10,1,8,0,15,22,7,1,1,2,14687,14721,9
Task 14688,Job 0,5,9,4,11,0,9,16,7,4,4,2,14688,14722,16
Task 14688,Job 1,10,10,1,8,1,11,18,7,1,2,0,14688,14722,8
Task 14689,Job 0,10,4,4,11,1,14,21,7,4,4,1,14689,14723,12
Task 14689,Job 1,15,4,3,6,0,18,21,3,3,2,0,14689,14723,5
Task 14690,Job 0,6,7,2,11,0,8,17,9,2,4,0,14690,14724,17
Task 14690,Job 1,11,6,2,11,0,13,22,9,2,2,0,14690,14724,4
Task 14691,Job 0,8,10,2,7,0,10,15,5,2,1,2,14691,14724,19
Task 14691,Job 1,13,8,4,10,0,17,23,6,4,3,0,14691,14724,5
Task 14692,Job 0,5,9,4,9,0,9,14,5,4,4,1,14692,14725,3
Task 14692,Job 1,10,4,2,8,0,12,18,6,2,1,1,14692,14725,11
Task 14693,Job 0,7,9,1,9,0,8,16,8,1,2,1,14693,14726,5
Task 14693,Job 1,12,9,4,8,0,16,20,4,4,1,1,14693,14726,19
Task 14694,Job 0,9,10,2,9,1,11,18,7,2,3,0,14694,14728,13
Task 14694,Job 1,14,5,4,9,0,18,23,5,4,2,0,14694,14728,13
Task 14695,Job 0,2,7,1,10,0,3,12,9,1,1,0,14695,14729,11
Task 14695,Job 1,7,8,4,7,0,11,14,3,4,2,1,14695,14729,15
Task 14696,Job 0,1,7,3,8,1,4,9,5,3,3,1,14696,14730,4
Task 14696,Job 1,6,5,3,10,1,9,16,7,3,4,0,14696,14730,8
Task 14697,Job 0,5,4,3,12,1,8,17,9,3,1,1,14697,14730,12
Task 14697,Job 1,10,7,2,12,0,12,22,10,2,2,0,14697,14730,5
Task 14698,Job 0,2,4,3,10,1,5,12,7,3,2,0,14698,14732,14
Task 14698,Job 1,7,7,4,10,0,11,17,6,4,1,0,14698,14732,4
Task 14699,Job 0,5,4,4,8,0,9,13,4,4,1,2,14699,14732,13
Task 14699,Job 1,10,8,4,7,0,14,17,3,4,4,2,14699,14732,5
Task 14700,Job 0,2,9,3,8,1,5,10,5,3,2,0,14700,14733,16
Task 14700,Job 1,7,7,2,11,0,9,18,9,2,4,0,14700,14733,18
Task 14701,Job 0,10,9,4,11,1,14,21,7,4,4,0,14701,14735,16
Task 14701,Job 1,15,10,1,12,0,16,27,11,1,2,1,14701,14735,3
Task 14702,Job 0,9,6,3,11,1,12,20,8,3,3,2,14702,14735,16
Task 14702,Job 1,14,7,2,6,0,16,20,4,2,3,1,14702,14735,17
Task 14703,Job 0,7,5,2,8,0,9,15,6,2,2,1,14703,14737,18
Task 14703,Job 1,12,4,2,10,1,14,22,8,2,2,2,14703,14737,2
Task 14704,Job 0,5,9,2,8,0,7,13,6,2,2,1,14704,14737,9
Task 14704,Job 1,10,10,1,12,0,11,22,11,1,2,1,14704,14737,17
Task 14705,Job 0,8,9,1,9,1,9,17,8,1,2,1,14705,14739,15
Task 14705,Job 1,13,5,4,8,0,17,21,4,4,4,0,14705,14739,7
Task 14706,Job 0,2,6,2,10,1,4,12,8,2,1,1,14706,14740,10
Task 14706,Job 1,7,8,4,12,0,11,19,8,4,1,1,14706,14740,2
Task 14707,Job 0,10,6,4,7,0,14,17,3,4,1,1,14707,14740,3
Task 14707,Job 1,15,9,1,9,0,16,24,8,1,3,0,14707,14740,2
Task 14708,Job 0,2,9,2,12,1,4,14,10,2,3,1,14708,14742,18
Task 14708,Job 1,7,10,4,6,1,11,13,2,4,3,2,14708,14742,4
Task 14709,Job 0,4,8,4,7,1,8,11,3,4,2,0,14709,14743,8
Task 14709,Job 1,9,9,4,6,0,13,15,2,4,2,0,14709,14743,19
Task 14710,Job 0,7,8,3,6,1,10,13,3,3,2,0,14710,14743,13
Task 14710,Job 1,12,9,2,6,0,14,18,4,2,2,2,14710,14743,14
Task 14711,Job 0,2,8,2,12,1,4,14,10,2,4,2,14711,14744,6
Task 14711,Job 1,7,4,2,9,0,9,16,7,2,4,2,14711,14744,2
Task 14712,Job 0,10,4,3,7,0,13,17,4,3,3,1,14712,14746,8
Task 14712,Job 1,15,6,4,8,1,19,23,4,4,1,0,14712,14746,20
Task 14713,Job 0,6,8,2,9,0,8,15,7,2,2,1,14713,14747,9
Task 14713,Job 1,11,8,3,8,0,14,19,5,3,1,2,14713,14747,10
Task 14714,Job 0,10,8,4,6,1,14,16,2,4,2,2,14714,14747,3
Task 14714,Job 1,15,8,2,11,0,17,26,9,2,4,0,14714,14747,18
Task 14715,Job 0,8,7,4,11,1,12,19,7,4,4,1,14715,14749,13
Task 14715,Job 1,13,5,1,9,0,14,22,8,1,2,0,14715,14749,14
Task 14716,Job 0,4,8,1,10,0,5,14,9,1,4,0,14716,14750,18
Task 14716,Job 1,9,6,3,7,0,12,16,4,3,1,0,14716,14750,10
Task 14717,Job 0,8,10,1,10,1,9,18,9,1,4,1,14717,14750,6
Task 14717,Job 1,13,4,1,9,0,14,22,8,1,2,2,14717,14750,2
Task 14718,Job 0,7,10,1,9,0,8,16,8,1,3,2,14718,14752,10
Task 14718,Job 1,12,7,4,11,0,16,23,7,4,2,1,14718,14752,13
Task 14719,Job 0,6,9,2,6,0,8,12,4,2,1,2,14719,14753,7
Task 14719,Job 1,11,8,4,7,0,15,18,3,4,1,0,14719,14753,17
Task 14720,Job 0,6,9,4,7,0,10,13,3,4,4,0,14720,14754,5
Task 14720,Job 1,11,8,4,12,0,15,23,8,4,4,2,14720,14754,18
Task 14721,Job 0,1,7,4,12,1,5,13,8,4,3,0,14721,14755,12
Task 14721,Job 1,6,6,2,11,1,8,17,9,2,4,2,14721,14755,18
Task 14722,Job 0,9,8,1,11,0,10,20,10,1,1,2,14722,14755,20
Task 14722,Job 1,14,7,2,10,0,16,24,8,2,1,1,14722,14755,12
Task 14723,Job 0,3,5,3,12,0,6,15,9,3,4,2,14723,14756,11
Task 14723,Job 1,8,6,1,12,1,9,20,11,1,3,1,14723,14756,2
Task 14724,Job 0,7,7,3,11,1,10,18,8,3,3,0,14724,14758,16
Task 14724,Job 1,12,4,3,11,0,15,23,8,3,3,2,14724,14758,11
Task 14725,Job 0,2,10,3,8,0,5,10,5,3,4,0,14725,14759,4
Task 14725,Job 1,7,4,4,9,0,11,16,5,4,3,0,14725,14759,10
Task 14726,Job 0,3,10,4,8,0,7,11,4,4,1,2,14726,14759,17
Task 14726,Job 1,8,7,1,12,0,9,20,11,1,1,1,14726,14759,4
Task 14727,Job 0,10,6,1,8,0,11,18,7,1,2,1,14727,14761,20
Task 14727,Job 1,15,10,3,11,1,18,26,8,3,3,1,14727,14761,8
Task 14728,Job 0,4,8,3,7,0,7,11,4,3,1,1,14728,14761,11
Task 14728,Job 1,9,10,3,9,1,12,18,6,3,3,0,14728,14761,6
Task 14729,Job 0,8,4,2,6,0,10,14,4,2,3,0,14729,14763,11
Task 14729,Job 1,13,9,3,9,0,16,22,6,3,2,2,14729,14763,16
Task 14730,Job 0,2,6,2,8,0,4,10,6,2,4,0,14730,14763,16
Task 14730,Job 1,7,7,4,6,0,11,13,2,4,2,1,14730,14763,8
Task 14731,Job 0,2,8,4,7,0,6,9,3,4,2,2,14731,14765,19
Task 14731,Job 1,7,10,3,10,0,10,17,7,3,3,2,14731,14765,14
Task 14732,Job 0,10,7,4,10,1,14,20,6,4,3,1,14732,14765,8
Task 14732,Job 1,15,4,1,12,0,16,27,11,1,4,0,14732,14765,8
Task 14733,Job 0,1,5,4,11,1,5,12,7,4,4,2,14733,14766,19
Task 14733,Job 1,6,6,2,12,0,8,18,10,2,2,1,14733,14766,3
Task 14734,Job 0,2,6,1,7,0,3,9,6,1,1,2,14734,14767,10
Task 14734,Job 1,7,6,2,9,0,9,16,7,2,3,0,14734,14767,5
Task 14735,Job 0,6,9,3,10,0,9,16,7,3,2,1,14735,14768,9
Task 14735,Job 1,11,6,1,11,1,12,22,10,1,1,1,14735,14768,2
Task 14736,Job 0,2,4,2,12,0,4,14,10,2,2,2,14736,14770,7
Task 14736,Job 1,7,10,2,10,1,9,17,8,2,4,2,14736,14770,20
Task 14737,Job 0,1,4,4,12,0,5,13,8,4,3,2,14737,14770,4
Task 14737,Job 1,6,8,4,9,0,10,15,5,4,3,2,14737,14770,15
Task 14738,Job 0,7,4,1,11,0,8,18,10,1,3,0,14738,14772,5
Task 14738,Job 1,12,9,3,10,0,15,22,7,3,3,2,14738,14772,5
Task 14739,Job 0,10,4,1,12,0,11,22,11,1,3,2,14739,14772,5
Task 14739,Job 1,15,10,3,12,0,18,27,9,3,2,1,14739,14772,16
Task 14740,Job 0,3,5,1,7,0,4,10,6,1,3,1,14740,14773,8
Task 14740,Job 1,8,9,4,7,0,12,15,3,4,3,2,14740,14773,3
Task 14741,Job 0,2,8,1,8,0,3,10,7,1,3,0,14741,14775,17
Task 14741,Job 1,7,5,4,9,1,11,16,5,4,2,2,14741,14775,11
Task 14742,Job 0,9,7,4,9,0,13,18,5,4,3,2,14742,14775,6
Task 14742,Job 1,14,5,1,12,0,15,26,11,1,1,0,14742,14775,14
Task 14743,Job 0,4,6,1,12,0,5,16,11,1,1,1,14743,14777,17
Task 14743,Job 1,9,8,4,9,1,13,18,5,4,1,2,14743,14777,14
Task 14744,Job 0,4,6,1,12,1,5,16,11,1,4,0,14744,14778,8
Task 14744,Job 1,9,9,2,7,1,11,16,5,2,2,0,14744,14778,18
Task 14745,Job 0,6,5,2,11,0,8,17,9,2,1,1,14745,14779,20
Task 14745,Job 1,11,9,3,7,0,14,18,4,3,1,0,14745,14779,4
Task 14746,Job 0,3,4,3,12,0,6,15,9,3,2,0,14746,14780,7
Task 14746,Job 1,8,8,2,8,0,10,16,6,2,4,2,14746,14780,10
Task 14747,Job 0,8,8,1,11,0,9,19,10,1,2,0,14747,14780,18
Task 14747,Job 1,13,8,2,9,0,15,22,7,2,4,1,14747,14780,2
Task 14748,Job 0,6,7,4,10,0,10,16,6,4,1,0,14748,14781,13
Task 14748,Job 1,11,9,1,7,0,12,18,6,1,1,2,14748,14781,11
Task 14749,Job 0,7,4,4,11,0,11,18,7,4,2,2,14749,14783,8
Task 14749,Job 1,12,4,2,11,0,14,23,9,2,4,1,14749,14783,4
Task 14750,Job 0,1,10,3,11,0,4,12,8,3,2,0,14750,14784,4
Task 14750,Job 1,6,6,3,9,0,9,15,6,3,4,0,14750,14784,2
Task 14751,Job 0,3,8,2,12,0,5,15,10,2,2,1,14751,14785,11
Task 14751,Job 1,8,8,4,11,0,12,19,7,4,2,0,14751,14785,19
Task 14752,Job 0,8,8,4,10,0,12,18,6,4,2,2,14752,14786,16
Task 14752,Job 1,13,5,2,11,0,15,24,9,2,4,2,14752,14786,18
Task 14753,Job 0,1,9,1,9,0,2,10,8,1,1,0,14753,14787,12
Task 14753,Job 1,6,10,3,9,0,9,15,6,3,4,1,14753,14787,4
Task 14754,Job 0,6,5,1,6,1,7,12,5,1,4,0,14754,14788,2
Task 14754,Job 1,11,8,1,6,0,12,17,5,1,4,2,14754,14788,12
Task 14755,Job 0,8,4,2,9,0,10,17,7,2,1,0,14755,14789,9
Task 14755,Job 1,13,10,3,11,1,16,24,8,3,4,1,14755,14789,16
Task 14756,Job 0,3,6,2,11,0,5,14,9,2,4,2,14756,14790,16
Task 14756,Job 1,8,4,4,10,0,12,18,6,4,3,2,14756,14790,10
Task 14757,Job 0,9,7,1,10,0,10,19,9,1,3,0,14757,14791,12
Task 14757,Job 1,14,9,1,9,0,15,23,8,1,2,2,14757,14791,18
Task 14758,Job 0,3,8,2,11,0,5,14,9,2,1,2,14758,14792,15
Task 14758,Job 1,8,5,4,10,0,12,18,6,4,1,2,14758,14792,9
Task 14759,Job 0,4,9,2,12,1,6,16,10,2,3,2,14759,14792,15
Task 14759,Job 1,9,5,1,12,1,10,21,11,1,4,1,14759,14792,19
Task 14760,Job 0,10,8,2,10,0,12,20,8,2,4,1,14760,14793,10
Task 14760,Job 1,15,6,1,8,1,16,23,7,1,4,0,14760,14793,19
Task 14761,Job 0,7,4,1,8,0,8,15,7,1,4,0,14761,14794,13
Task 14761,Job 1,12,9,3,7,1,15,19,4,3,1,1,14761,14794,6
Task 14762,Job 0,1,9,4,7,0,5,8,3,4,2,1,14762,14795,13
Task 14762,Job 1,6,5,3,12,0,9,18,9,3,2,1,14762,14795,20
Task 14763,Job 0,6,6,4,12,0,10,18,8,4,1,2,14763,14797,20
Task 14763,Job 1,11,10,1,7,0,12,18,6,1,4,2,14763,14797,5
Task 14764,Job 0,9,4,3,6,1,12,15,3,3,3,2,14764,14798,19
Task 14764,Job 1,14,9,4,8,1,18,22,4,4,4,2,14764,14798,15
Task 14765,Job 0,6,7,3,6,1,9,12,3,3,1,1,14765,14798,5
Task 14765,Job 1,11,5,4,12,0,15,23,8,4,3,2,14765,14798,15
Task 14766,Job 0,4,9,4,11,1,8,15,7,4,1,2,14766,14799,9
Task 14766,Job 1,9,5,3,6,1,12,15,3,3,4,2,14766,14799,14
Task 14767,Job 0,7,5,4,8,0,11,15,4,4,2,1,14767,14801,15
Task 14767,Job 1,12,4,1,10,0,13,22,9,1,4,0,14767,14801,13
Task 14768,Job 0,9,10,3,6,0,12,15,3,3,3,2,14768,14802,15
Task 14768,Job 1,14,9,4,10,0,18,24,6,4,1,1,14768,14802,5
Task 14769,Job 0,8,10,3,11,0,11,19,8,3,4,0,14769,14802,8
Task 14769,Job 1,13,4,2,12,0,15,25,10,2,1,1,14769,14802,5
Task 14770,Job 0,3,8,1,11,1,4,14,10,1,4,2,14770,14804,3
Task 14770,Job 1,8,5,1,9,0,9,17,8,1,3,1,14770,14804,15
Task 14771,Job 0,1,8,2,12,0,3,13,10,2,1,1,14771,14805,2
Task 14771,Job 1,6,9,1,12,1,7,18,11,1,4,0,14771,14805,4
Task 14772,Job 0,10,5,4,12,0,14,22,8,4,4,2,14772,14805,2
Task 14772,Job 1,15,4,1,6,0,16,21,5,1,4,0,14772,14805,4
Task 14773,Job 0,7,9,2,12,0,9,19,10,2,3,2,14773,14806,13
Task 14773,Job 1,12,6,2,12,0,14,24,10,2,4,0,14773,14806,15
Task 14774,Job 0,6,4,1,10,1,7,16,9,1,4,0,14774,14808,5
Task 14774,Job 1,11,4,1,9,0,12,20,8,1,3,2,14774,14808,3
Task 14775,Job 0,4,10,1,9,0,5,13,8,1,1,1,14775,14809,17
Task 14775,Job 1,9,10,2,6,0,11,15,4,2,3,1,14775,14809,6
Task 14776,Job 0,1,6,3,9,0,4,10,6,3,4,0,14776,14810,19
Task 14776,Job 1,6,6,4,7,0,10,13,3,4,3,0,14776,14810,4
Task 14777,Job 0,4,6,2,7,0,6,11,5,2,3,1,14777,14811,7
Task 14777,Job 1,9,5,4,12,0,13,21,8,4,4,1,14777,14811,2
Task 14778,Job 0,2,10,4,6,1,6,8,2,4,3,0,14778,14812,6
Task 14778,Job 1,7,4,2,7,1,9,14,5,2,3,2,14778,14812,13
Task 14779,Job 0,6,5,3,7,0,9,13,4,3,2,0,14779,14813,8
Task 14779,Job 1,11,4,3,11,0,14,22,8,3,3,1,14779,14813,6
Task 14780,Job 0,7,7,3,8,1,10,15,5,3,4,2,14780,14814,20
Task 14780,Job 1,12,8,2,7,0,14,19,5,2,1,2,14780,14814,11
Task 14781,Job 0,2,7,1,12,0,3,14,11,1,4,2,14781,14814,2
Task 14781,Job 1,7,7,4,8,1,11,15,4,4,4,0,14781,14814,7
Task 14782,Job 0,4,7,2,12,0,6,16,10,2,2,2,14782,14815,15
Task 14782,Job 1,9,7,2,7,0,11,16,5,2,4,0,14782,14815,11
Task 14783,Job 0,1,7,3,8,1,4,9,5,3,3,2,14783,14817,18
Task 14783,Job 1,6,7,4,7,1,10,13,3,4,4,1,14783,14817,19
Task 14784,Job 0,4,9,4,12,0,8,16,8,4,1,0,14784,14818,15
Task 14784,Job 1,9,6,1,9,0,10,18,8,1,2,1,14784,14818,11
Task 14785,Job 0,7,6,1,8,0,8,15,7,1,3,1,14785,14819,10
Task 14785,Job 1,12,9,4,12,1,16,24,8,4,3,2,14785,14819,6
Task 14786,Job 0,5,6,2,10,0,7,15,8,2,1,1,14786,14820,9
Task 14786,Job 1,10,5,3,12,0,13,22,9,3,2,2,14786,14820,8
Task 14787,Job 0,1,10,1,11,0,2,12,10,1,1,0,14787,14820,6
Task 14787,Job 1,6,4,1,10,0,7,16,9,1,4,1,14787,14820,14
Task 14788,Job 0,4,9,3,8,0,7,12,5,3,3,0,14788,14822,5
Task 14788,Job 1,9,5,3,8,0,12,17,5,3,1,2,14788,14822,17
Task 14789,Job 0,5,7,4,8,1,9,13,4,4,3,1,14789,14823,3
Task 14789,Job 1,10,8,4,9,0,14,19,5,4,3,0,14789,14823,15
Task 14790,Job 0,8,4,2,8,1,10,16,6,2,2,0,14790,14824,15
Task 14790,Job 1,13,9,4,6,0,17,19,2,4,4,0,14790,14824,7
Task 14791,Job 0,8,4,3,11,0,11,19,8,3,3,1,14791,14825,12
Task 14791,Job 1,13,4,1,12,0,14,25,11,1,2,1,14791,14825,16
Task 14792,Job 0,9,5,2,11,1,11,20,9,2,1,0,14792,14826,7
Task 14792,Job 1,14,10,3,6,1,17,20,3,3,3,2,14792,14826,3
Task 14793,Job 0,5,9,1,7,0,6,12,6,1,4,1,14793,14827,14
Task 14793,Job 1,10,4,3,6,1,13,16,3,3,2,1,14793,14827,2
Task 14794,Job 0,3,7,1,10,1,4,13,9,1,4,0,14794,14828,17
Task 14794,Job 1,8,9,3,6,0,11,14,3,3,4,2,14794,14828,2
Task 14795,Job 0,8,4,2,10,0,10,18,8,2,3,2,14795,14828,17
Task 14795,Job 1,13,9,2,11,0,15,24,9,2,4,1,14795,14828,14
Task 14796,Job 0,8,5,1,10,0,9,18,9,1,1,1,14796,14829,18
Task 14796,Job 1,13,6,2,6,0,15,19,4,2,4,2,14796,14829,7
Task 14797,Job 0,2,4,4,12,1,6,14,8,4,3,1,14797,14830,15
Task 14797,Job 1,7,5,2,10,0,9,17,8,2,2,1,14797,14830,5
Task 14798,Job 0,9,7,2,8,0,11,17,6,2,2,0,14798,14831,10
Task 14798,Job 1,14,7,2,12,0,16,26,10,2,2,1,14798,14831,19
Task 14799,Job 0,9,6,4,9,0,13,18,5,4,4,0,14799,14832,18
Task 14799,Job 1,14,8,2,9,0,16,23,7,2,4,2,14799,14832,17
Task 14800,Job 0,6,5,2,10,1,8,16,8,2,4,0,14800,14833,12
Task 14800,Job 1,11,8,1,11,1,12,22,10,1,4,1,14800,14833,12
Task 14801,Job 0,8,4,2,6,0,10,14,4,2,3,1,14801,14834,4
Task 14801,Job 1,13,7,3,11,0,16,24,8,3,4,0,14801,14834,20
Task 14802,Job 0,5,10,4,8,1,9,13,4,4,4,2,14802,14835,15
Task 14802,Job 1,10,9,1,11,1,11,21,10,1,2,2,14802,14835,9
Task 14803,Job 0,6,9,1,6,0,7,12,5,1,1,1,14803,14836,11
Task 14803,Job 1,11,5,2,7,0,13,18,5,2,2,2,14803,14836,12
Task 14804,Job 0,10,10,2,7,0,12,17,5,2,4,0,14804,14838,3
Task 14804,Job 1,15,10,4,7,0,19,22,3,4,2,2,14804,14838,3
Task 14805,Job 0,1,10,4,11,0,5,12,7,4,3,2,14805,14839,4
Task 14805,Job 1,6,5,4,7,0,10,13,3,4,3,1,14805,14839,17
Task 14806,Job 0,10,10,3,9,0,13,19,6,3,3,2,14806,14840,14
Task 14806,Job 1,15,7,3,12,0,18,27,9,3,1,0,14806,14840,18
Task 14807,Job 0,6,5,4,12,0,10,18,8,4,2,0,14807,14841,6
Task 14807,Job 1,11,4,3,8,1,14,19,5,3,4,1,14807,14841,11
Task 14808,Job 0,10,7,3,12,0,13,22,9,3,1,1,14808,14842,19
Task 14808,Job 1,15,10,1,11,0,16,26,10,1,2,1,14808,14842,12
Task 14809,Job 0,7,9,4,10,0,11,17,6,4,3,2,14809,14842,4
Task 14809,Job 1,12,9,3,10,1,15,22,7,3,3,1,14809,14842,5
Task 14810,Job 0,7,7,2,7,0,9,14,5,2,4,1,14810,14843,3
Task 14810,Job 1,12,7,3,8,0,15,20,5,3,1,1,14810,14843,11
Task 14811,Job 0,2,6,3,6,0,5,8,3,3,1,0,14811,14845,13
Task 14811,Job 1,7,8,1,7,1,8,14,6,1,2,1,14811,14845,19
Task 14812,Job 0,8,9,3,6,1,11,14,3,3,4,0,14812,14845,6
Task 14812,Job 1,13,4,4,11,0,17,24,7,4,2,0,14812,14845,17
Task 14813,Job 0,3,9,2,8,0,5,11,6,2,4,0,14813,14846,8
Task 14813,Job 1,8,6,3,7,1,11,15,4,3,4,1,14813,14846,10
Task 14814,Job 0,3,10,3,9,1,6,12,6,3,1,1,14814,14847,19
Task 14814,Job 1,8,4,3,7,1,11,15,4,3,1,1,14814,14847,15
Task 14815,Job 0,6,4,3,12,0,9,18,9,3,4,0,14815,14849,13
Task 14815,Job 1,11,7,4,11,1,15,22,7,4,1,1,14815,14849,20
Task 14816,Job 0,8,5,3,6,1,11,14,3,3,4,2,14816,14849,8
Task 14816,Job 1,13,8,4,9,1,17,22,5,4,4,2,14816,14849,16
Task 14817,Job 0,5,9,1,12,0,6,17,11,1,3,1,14817,14851,9
Task 14817,Job 1,10,7,1,10,0,11,20,9,1,1,2,14817,14851,10
Task 14818,Job 0,4,10,4,12,0,8,16,8,4,4,1,14818,14851,5
Task 14818,Job 1,9,4,3,7,1,12,16,4,3,4,0,14818,14851,15
Task 14819,Job 0,4,8,4,9,0,8,13,5,4,1,2,14819,14852,3
Task 14819,Job 1,9,7,2,6,0,11,15,4,2,4,0,14819,14852,6
Task 14820,Job 0,6,6,2,8,1,8,14,6,2,1,0,14820,14853,6
Task 14820,Job 1,11,5,4,9,0,15,20,5,4,2,0,14820,14853,13
Task 14821,Job 0,6,8,1,6,1,7,12,5,1,4,1,14821,14854,20
Task 14821,Job 1,11,6,4,11,1,15,22,7,4,3,2,14821,14854,16
Task 14822,Job 0,9,9,1,6,0,10,15,5,1,2,1,14822,14856,13
Task 14822,Job 1,14,4,2,8,1,16,22,6,2,3,2,14822,14856,19
Task 14823,Job 0,8,5,4,10,0,12,18,6,4,1,0,14823,14857,9
Task 14823,Job 1,13,6,1,9,1,14,22,8,1,2,0,14823,14857,18
Task 14824,Job 0,2,4,2,12,1,4,14,10,2,3,1,14824,14857,20
Task 14824,Job 1,7,5,3,7,1,10,14,4,3,1,0,14824,14857,10
Task 14825,Job 0,4,9,2,12,0,6,16,10,2,1,2,14825,14859,8
Task 14825,Job 1,9,4,1,11,0,10,20,10,1,1,0,14825,14859,6
Task 14826,Job 0,3,4,1,6,0,4,9,5,1,2,2,14826,14859,17
Task 14826,Job 1,8,9,4,11,0,12,19,7,4,3,0,14826,14859,15
Task 14827,Job 0,4,5,4,7,0,8,11,3,4,4,0,14827,14861,2
Task 14827,Job 1,9,7,4,9,0,13,18,5,4,3,2,14827,14861,14
Task 14828,Job 0,10,10,4,12,0,14,22,8,4,2,1,14828,14861,18
Task 14828,Job 1,15,4,3,12,0,18,27,9,3,2,0,14828,14861,3
Task 14829,Job 0,2,7,4,7,0,6,9,3,4,3,0,14829,14863,5
Task 14829,Job 1,7,5,2,8,0,9,15,6,2,2,2,14829,14863,18
Task 14830,Job 0,9,9,2,8,0,11,17,6,2,4,1,14830,14864,19
Task 14830,Job 1,14,10,3,7,0,17,21,4,3,4,1,14830,14864,2
Task 14831,Job 0,4,4,3,11,1,7,15,8,3,3,1,14831,14865,11
Task 14831,Job 1,9,4,1,11,1,10,20,10,1,4,0,14831,14865,10
Task 14832,Job 0,4,10,2,6,0,6,10,4,2,3,1,14832,14866,19
Task 14832,Job 1,9,10,1,11,0,10,20,10,1,1,2,14832,14866,3
Task 14833,Job 0,3,9,3,6,0,6,9,3,3,1,2,14833,14867,18
Task 14833,Job 1,8,10,1,12,0,9,20,11,1,2,1,14833,14867,3
Task 14834,Job 0,8,4,4,7,1,12,15,3,4,2,1,14834,14867,6
Task 14834,Job 1,13,8,1,9,0,14,22,8,1,4,1,14834,14867,11
Task 14835,Job 0,6,8,2,8,0,8,14,6,2,1,1,14835,14868,13
Task 14835,Job 1,11,7,2,6,0,13,17,4,2,4,1,14835,14868,9
Task 14836,Job 0,8,4,1,10,0,9,18,9,1,1,2,14836,14869,19
Task 14836,Job 1,13,6,2,9,0,15,22,7,2,2,1,14836,14869,13
Task 14837,Job 0,3,4,4,11,0,7,14,7,4,4,1,14837,14871,19
Task 14837,Job 1,8,5,4,7,1,12,15,3,4,4,0,14837,14871,17
Task 14838,Job 0,9,5,4,9,1,13,18,5,4,4,1,14838,14871,9
Task 14838,Job 1,14,8,2,10,0,16,24,8,2,1,1,14838,14871,19
Task 14839,Job 0,5,5,3,11,0,8,16,8,3,4,0,14839,14872,12
Task 14839,Job 1,10,7,4,7,1,14,17,3,4,3,1,14839,14872,2
Task 14840,Job 0,3,9,3,8,0,6,11,5,3,1,2,14840,14873,11
Task 14840,Job 1,8,6,2,11,0,10,19,9,2,2,2,14840,14873,20
Task 14841,Job 0,4,10,2,6,0,6,10,4,2,3,1,14841,14874,14
Task 14841,Job 1,9,8,1,6,1,10,15,5,1,4,2,14841,14874,12
Task 14842,Job 0,10,4,3,11,0,13,21,8,3,1,2,14842,14876,3
Task 14842,Job 1,15,5,4,9,1,19,24,5,4,2,1,14842,14876,2
Task 14843,Job 0,8,10,1,7,0,9,15,6,1,1,0,14843,14876,9
Task 14843,Job 1,13,7,4,10,0,17,23,6,4,1,1,14843,14876,5
Task 14844,Job 0,8,7,2,6,1,10,14,4,2,4,2,14844,14878,7
Task 14844,Job 1,13,8,4,8,0,17,21,4,4,4,0,14844,14878,7
Task 14845,Job 0,5,4,2,10,0,7,15,8,2,2,1,14845,14878,18
Task 14845,Job 1,10,7,1,12,0,11,22,11,1,1,1,14845,14878,3
Task 14846,Job 0,2,9,3,7,0,5,9,4,3,1,2,14846,14880,20
Task 14846,Job 1,7,6,1,8,0,8,15,7,1,3,0,14846,14880,8
Task 14847,Job 0,6,10,2,7,0,8,13,5,2,2,0,14847,14880,4
Task 14847,Job 1,11,4,2,6,0,13,17,4,2,2,0,14847,14880,19
Task 14848,Job 0,10,9,1,12,0,11,22,11,1,1,0,14848,14881,6
Task 14848,Job 1,15,7,3,9,0,18,24,6,3,3,2,14848,14881,12
Task 14849,Job 0,3,9,4,6,0,7,9,2,4,2,0,14849,14882,7
Task 14849,Job 1,8,10,3,6,0,11,14,3,3,2,1,14849,14882,8
Task 14850,Job 0,7,7,4,9,0,11,16,5,4,2,2,14850,14883,4
Task 14850,Job 1,12,5,3,11,0,15,23,8,3,2,0,14850,14883,11
Task 14851,Job 0,8,5,1,12,0,9,20,11,1,1,0,14851,14885,18
Task 14851,Job 1,13,10,3,12,0,16,25,9,3,2,0,14851,14885,8
Task 14852,Job 0,8,8,1,7,0,9,15,6,1,2,2,14852,14886,6
Task 14852,Job 1,13,8,4,7,0,17,20,3,4,3,2,14852,14886,2
Task 14853,Job 0,4,6,1,10,0,5,14,9,1,1,2,14853,14887,6
Task 14853,Job 1,9,7,1,10,1,10,19,9,1,1,0,14853,14887,17
Task 14854,Job 0,5,4,1,7,0,6,12,6,1,2,0,14854,14887,2
Task 14854,Job 1,10,10,3,8,0,13,18,5,3,2,2,14854,14887,17
Task 14855,Job 0,1,10,4,7,1,5,8,3,4,4,1,14855,14889,9
Task 14855,Job 1,6,4,3,12,0,9,18,9,3,1,2,14855,14889,19
Task 14856,Job 0,7,7,1,9,0,8,16,8,1,3,1,14856,14890,13
Task 14856,Job 1,12,8,4,6,0,16,18,2,4,2,1,14856,14890,11
Task 14857,Job 0,7,9,1,7,1,8,14,6,1,1,1,14857,14890,15
Task 14857,Job 1,12,5,4,7,1,16,19,3,4,2,0,14857,14890,9
Task 14858,Job 0,6,5,1,11,0,7,17,10,1,2,1,14858,14892,12
Task 14858,Job 1,11,10,1,10,1,12,21,9,1,4,0,14858,14892,10
Task 14859,Job 0,4,5,2,11,0,6,15,9,2,2,2,14859,14892,6
Task 14859,Job 1,9,5,1,8,0,10,17,7,1,1,2,14859,14892,5
Task 14860,Job 0,5,6,1,11,1,6,16,10,1,1,2,14860,14893,3
Task 14860,Job 1,10,8,4,11,1,14,21,7,4,2,2,14860,14893,6
Task 14861,Job 0,5,7,1,12,0,6,17,11,1,4,2,14861,14895,5
Task 14861,Job 1,10,4,3,6,0,13,16,3,3,4,0,14861,14895,5
Task 14862,Job 0,6,4,3,8,0,9,14,5,3,1,1,14862,14895,12
Task 14862,Job 1,11,10,2,11,1,13,22,9,2,3,2,14862,14895,9
Task 14863,Job 0,6,5,3,12,0,9,18,9,3,3,1,14863,14897,14
Task 14863,Job 1,11,8,2,12,1,13,23,10,2,1,2,14863,14897,3
Task 14864,Job 0,6,9,4,10,0,10,16,6,4,3,0,14864,14897,5
Task 14864,Job 1,11,4,3,7,0,14,18,4,3,4,1,14864,14897,4
Task 14865,Job 0,6,8,2,10,0,8,16,8,2,3,0,14865,14899,20
Task 14865,Job 1,11,7,1,9,0,12,20,8,1,4,0,14865,14899,14
Task 14866,Job 0,4,7,3,10,0,7,14,7,3,4,0,14866,14900,6
Task 14866,Job 1,9,10,2,10,0,11,19,8,2,3,0,14866,14900,20
Task 14867,Job 0,8,5,1,11,1,9,19,10,1,1,2,14867,14900,20
Task 14867,Job 1,13,10,2,7,0,15,20,5,2,3,2,14867,14900,15
Task 14868,Job 0,9,6,2,7,1,11,16,5,2,2,0,14868,14902,19
Task 14868,Job 1,14,4,3,10,0,17,24,7,3,4,1,14868,14902,5
Task 14869,Job 0,3,10,2,11,0,5,14,9,2,3,2,14869,14903,6
Task 14869,Job 1,8,5,1,10,0,9,18,9,1,4,2,14869,14903,18
Task 14870,Job 0,9,5,1,6,0,10,15,5,1,3,2,14870,14904,17
Task 14870,Job 1,14,4,1,8,0,15,22,7,1,1,1,14870,14904,14
Task 14871,Job 0,4,6,2,12,0,6,16,10,2,1,0,14871,14905,15
Task 14871,Job 1,9,5,3,9,1,12,18,6,3,1,1,14871,14905,10
Task 14872,Job 0,3,4,2,12,1,5,15,10,2,3,2,14872,14906,7
Task 14872,Job 1,8,4,3,10,1,11,18,7,3,4,1,14872,14906,14
Task 14873,Job 0,7,5,4,7,0,11,14,3,4,1,2,14873,14906,15
Task 14873,Job 1,12,10,3,8,0,15,20,5,3,3,0,14873,14906,14
Task 14874,Job 0,9,4,4,7,0,13,16,3,4,1,0,14874,14907,20
Task 14874,Job 1,14,9,2,10,0,16,24,8,2,2,2,14874,14907,14
Task 14875,Job 0,1,10,2,8,0,3,9,6,2,4,0,14875,14909,17
Task 14875,Job 1,6,6,2,6,1,8,12,4,2,2,1,14875,14909,10
Task 14876,Job 0,2,9,2,6,1,4,8,4,2,2,0,14876,14910,15
Task 14876,Job 1,7,8,3,8,1,10,15,5,3,3,2,14876,14910,20
Task 14877,Job 0,10,10,4,6,1,14,16,2,4,2,0,14877,14911,14
Task 14877,Job 1,15,6,1,8,0,16,23,7,1,4,1,14877,14911,12
Task 14878,Job 0,2,10,2,11,0,4,13,9,2,2,1,14878,14911,4
Task 14878,Job 1,7,9,4,9,0,11,16,5,4,2,0,14878,14911,12
Task 14879,Job 0,1,7,3,8,0,4,9,5,3,1,1,14879,14913,14
Task 14879,Job 1,6,9,2,6,0,8,12,4,2,1,0,14879,14913,18
Task 14880,Job 0,3,8,2,12,0,5,15,10,2,4,2,14880,14914,13
Task 14880,Job 1,8,8,3,11,0,11,19,8,3,3,2,14880,14914,10
Task 14881,Job 0,9,7,4,10,0,13,19,6,4,4,1,14881,14915,16
Task 14881,Job 1,14,4,3,8,1,17,22,5,3,2,0,14881,14915,11
Task 14882,Job 0,6,5,1,12,1,7,18,11,1,3,0,14882,14915,10
Task 14882,Job 1,11,9,1,12,0,12,23,11,1,1,0,14882,14915,5
Task 14883,Job 0,3,10,1,11,1,4,14,10,1,2,2,14883,14917,19
Task 14883,Job 1,8,8,3,11,0,11,19,8,3,4,0,14883,14917,17
Task 14884,Job 0,3,4,1,10,1,4,13,9,1,1,2,14884,14917,3
Task 14884,Job 1,8,7,1,6,0,9,14,5,1,3,0,14884,14917,5
Task 14885,Job 0,9,6,1,9,1,10,18,8,1,1,2,14885,14919,16
Task 14885,Job 1,14,4,2,8,0,16,22,6,2,3,0,14885,14919,19
Task 14886,Job 0,3,7,2,12,0,5,15,10,2,1,0,14886,14920,18
Task 14886,Job 1,8,10,1,9,1,9,17,8,1,1,1,14886,14920,12
Task 14887,Job 0,7,8,1,6,0,8,13,5,1,3,1,14887,14920,10
Task 14887,Job 1,12,4,4,6,0,16,18,2,4,2,1,14887,14920,10
Task 14888,Job 0,2,7,1,12,0,3,14,11,1,3,2,14888,14922,8
Task 14888,Job 1,7,10,4,8,1,11,15,4,4,1,1,14888,14922,18
Task 14889,Job 0,3,5,4,7,1,7,10,3,4,2,1,14889,14923,19
Task 14889,Job 1,8,7,3,7,0,11,15,4,3,4,2,14889,14923,11
Task 14890,Job 0,7,6,4,12,0,11,19,8,4,3,1,14890,14924,14
Task 14890,Job 1,12,9,2,11,1,14,23,9,2,3,0,14890,14924,13
Task 14891,Job 0,1,9,3,6,0,4,7,3,3,1,0,14891,14925,19
Task 14891,Job 1,6,10,4,10,1,10,16,6,4,4,1,14891,14925,5
Task 14892,Job 0,7,7,1,11,0,8,18,10,1,1,1,14892,14925,20
Task 14892,Job 1,12,4,3,8,0,15,20,5,3,4,0,14892,14925,16
Task 14893,Job 0,3,6,1,9,0,4,12,8,1,3,0,14893,14927,5
Task 14893,Job 1,8,7,4,7,0,12,15,3,4,4,0,14893,14927,14
Task 14894,Job 0,6,5,1,8,1,7,14,7,1,4,0,14894,14927,9
Task 14894,Job 1,11,6,2,6,0,13,17,4,2,2,2,14894,14927,14
Task 14895,Job 0,4,10,1,12,0,5,16,11,1,1,1,14895,14928,9
Task 14895,Job 1,9,5,1,8,0,10,17,7,1,1,2,14895,14928,8
Task 14896,Job 0,7,10,4,8,0,11,15,4,4,3,0,14896,14930,6
Task 14896,Job 1,12,4,1,10,1,13,22,9,1,4,2,14896,14930,5
Task 14897,Job 0,4,8,4,6,0,8,10,2,4,3,1,14897,14931,14
Task 14897,Job 1,9,5,3,11,1,12,20,8,3,2,2,14897,14931,3
Task 14898,Job 0,2,10,2,9,0,4,11,7,2,4,2,14898,14932,3
Task 14898,Job 1,7,4,2,9,0,9,16,7,2,2,1,14898,14932,9
Task 14899,Job 0,5,10,4,11,0,9,16,7,4,3,1,14899,14932,13
Task 14899,Job 1,10,10,3,9,1,13,19,6,3,4,0,14899,14932,16
Task 14900,Job 0,9,6,4,7,1,13,16,3,4,4,2,14900,14933,2
Task 14900,Job 1,14,9,1,8,0,15,22,7,1,2,1,14900,14933,12
Task 14901,Job 0,2,10,1,10,1,3,12,9,1,1,0,14901,14935,15
Task 14901,Job 1,7,10,3,10,0,10,17,7,3,1,0,14901,14935,15
Task 14902,Job 0,8,7,1,8,1,9,16,7,1,3,1,14902,14935,9
Task 14902,Job 1,13,7,4,12,1,17,25,8,4,4,2,14902,14935,7
Task 14903,Job 0,7,4,2,6,0,9,13,4,2,2,0,14903,14936,17
Task 14903,Job 1,12,9,4,8,0,16,20,4,4,4,1,14903,14936,17
Task 14904,Job 0,4,10,3,9,0,7,13,6,3,2,1,14904,14937,10
Task 14904,Job 1,9,5,1,9,0,10,18,8,1,1,2,14904,14937,4
Task 14905,Job 0,9,10,2,10,0,11,19,8,2,1,2,14905,14938,5
Task 14905,Job 1,14,7,3,9,1,17,23,6,3,4,1,14905,14938,3
Task 14906,Job 0,4,6,3,12,1,7,16,9,3,3,0,14906,14940,4
Task 14906,Job 1,9,4,2,8,0,11,17,6,2,4,0,14906,14940,9
Task 14907,Job 0,3,4,3,6,0,6,9,3,3,3,1,14907,14941,10
Task 14907,Job 1,8,6,2,9,1,10,17,7,2,4,0,14907,14941,17
Task 14908,Job 0,5,5,1,7,0,6,12,6,1,1,1,14908,14941,14
Task 14908,Job 1,10,10,3,12,0,13,22,9,3,4,1,14908,14941,7
Task 14909,Job 0,2,5,3,12,0,5,14,9,3,2,2,14909,14942,18
Task 14909,Job 1,7,7,4,11,0,11,18,7,4,3,0,14909,14942,12
Task 14910,Job 0,7,4,3,11,1,10,18,8,3,2,2,14910,14943,3
Task 14910,Job 1,12,5,3,8,1,15,20,5,3,4,2,14910,14943,11
Task 14911,Job 0,3,8,3,6,0,6,9,3,3,3,0,14911,14945,19
Task 14911,Job 1,8,9,1,8,1,9,16,7,1,1,2,14911,14945,15
Task 14912,Job 0,8,7,3,10,1,11,18,7,3,1,1,14912,14945,20
Task 14912,Job 1,13,7,1,6,0,14,19,5,1,3,1,14912,14945,11
Task 14913,Job 0,1,9,3,9,1,4,10,6,3,3,1,14913,14946,13
Task 14913,Job 1,6,7,2,6,0,8,12,4,2,3,2,14913,14946,11
Task 14914,Job 0,9,6,2,11,0,11,20,9,2,4,2,14914,14947,12
Task 14914,Job 1,14,7,1,7,1,15,21,6,1,1,0,14914,14947,3
Task 14915,Job 0,4,10,4,10,1,8,14,6,4,2,2,14915,14948,3
Task 14915,Job 1,9,7,2,7,1,11,16,5,2,2,2,14915,14948,16
Task 14916,Job 0,10,8,2,8,0,12,18,6,2,2,1,14916,14949,6
Task 14916,Job 1,15,4,1,9,0,16,24,8,1,2,1,14916,14949,5
Task 14917,Job 0,5,5,3,6,0,8,11,3,3,3,1,14917,14950,14
Task 14917,Job 1,10,6,3,11,0,13,21,8,3,4,1,14917,14950,4
Task 14918,Job 0,7,4,1,6,1,8,13,5,1,4,1,14918,14951,7
Task 14918,Job 1,12,7,2,6,1,14,18,4,2,2,2,14918,14951,13
Task 14919,Job 0,7,8,1,11,0,8,18,10,1,2,2,14919,14953,10
Task 14919,Job 1,12,7,4,9,0,16,21,5,4,3,1,14919,14953,13
Task 14920,Job 0,9,10,2,12,0,11,21,10,2,4,0,14920,14954,5
Task 14920,Job 1,14,10,4,11,0,18,25,7,4,2,0,14920,14954,20
Task 14921,Job 0,6,7,2,8,0,8,14,6,2,3,0,14921,14955,20
Task 14921,Job 1,11,7,4,9,0,15,20,5,4,4,1,14921,14955,6
Task 14922,Job 0,2,6,2,6,1,4,8,4,2,4,0,14922,14956,10
Task 14922,Job 1,7,6,3,10,0,10,17,7,3,1,0,14922,14956,4
Task 14923,Job 0,8,8,3,11,0,11,19,8,3,1,0,14923,14956,20
Task 14923,Job 1,13,6,3,8,0,16,21,5,3,3,0,14923,14956,11
Task 14924,Job 0,4,5,4,11,0,8,15,7,4,2,2,14924,14957,3
Task 14924,Job 1,9,4,4,12,0,13,21,8,4,4,2,14924,14957,15
Task 14925,Job 0,3,10,2,6,0,5,9,4,2,1,1,14925,14959,7
Task 14925,Job 1,8,4,4,7,0,12,15,3,4,1,2,14925,14959,13
Task 14926,Job 0,10,4,4,11,0,14,21,7,4,2,2,14926,14960,13
Task 14926,Job 1,15,5,4,9,0,19,24,5,4,3,2,14926,14960,9
Task 14927,Job 0,9,4,4,9,1,13,18,5,4,2,2,14927,14961,6
Task 14927,Job 1,14,4,2,8,0,16,22,6,2,4,2,14927,14961,15
Task 14928,Job 0,2,8,2,10,0,4,12,8,2,2,0,14928,14962,14
Task 14928,Job 1,7,6,1,6,0,8,13,5,1,3,0,14928,14962,6
Task 14929,Job 0,7,5,2,6,0,9,13,4,2,2,1,14929,14963,6
Task 14929,Job 1,12,5,1,7,0,13,19,6,1,4,0,14929,14963,5
Task 14930,Job 0,8,9,4,6,0,12,14,2,4,1,0,14930,14964,5
Task 14930,Job 1,13,7,2,6,0,15,19,4,2,1,1,14930,14964,4
Task 14931,Job 0,4,5,4,9,0,8,13,5,4,1,0,14931,14964,14
Task 14931,Job 1,9,4,4,6,0,13,15,2,4,3,2,14931,14964,8
Task 14932,Job 0,3,4,2,9,0,5,12,7,2,1,2,14932,14965,14
Task 14932,Job 1,8,10,1,9,0,9,17,8,1,3,0,14932,14965,14
Task 14933,Job 0,2,9,4,7,0,6,9,3,4,4,1,14933,14967,16
Task 14933,Job 1,7,4,4,11,0,11,18,7,4,4,2,14933,14967,16
Task 14934,Job 0,8,9,2,11,1,10,19,9,2,2,1,14934,14968,18
Task 14934,Job 1,13,8,2,8,0,15,21,6,2,4,2,14934,14968,20
Task 14935,Job 0,7,4,1,10,0,8,17,9,1,2,2,14935,14969,14
Task 14935,Job 1,12,5,3,8,1,15,20,5,3,3,0,14935,14969,4
Task 14936,Job 0,6,10,2,10,0,8,16,8,2,3,0,14936,14969,2
Task 14936,Job 1,11,7,4,11,0,15,22,7,4,4,1,14936,14969,6
Task 14937,Job 0,1,8,1,6,0,2,7,5,1,3,2,14937,14970,6
Task 14937,Job 1,6,7,2,11,0,8,17,9,2,1,2,14937,14970,4
Task 14938,Job 0,6,6,1,11,0,7,17,10,1,2,0,14938,14971,7
Task 14938,Job 1,11,9,4,8,0,15,19,4,4,1,2,14938,14971,19
Task 14939,Job 0,2,6,4,12,0,6,14,8,4,1,2,14939,14973,11
Task 14939,Job 1,7,4,1,6,1,8,13,5,1,2,2,14939,14973,9
Task 14940,Job 0,8,10,1,8,0,9,16,7,1,4,0,14940,14973,14
Task 14940,Job 1,13,5,2,12,0,15,25,10,2,2,2,14940,14973,7
Task 14941,Job 0,2,4,2,7,1,4,9,5,2,3,0,14941,14974,3
Task 14941,Job 1,7,5,3,9,1,10,16,6,3,4,2,14941,14974,9
Task 14942,Job 0,6,10,2,11,0,8,17,9,2,2,1,14942,14976,8
Task 14942,Job 1,11,7,1,7,1,12,18,6,1,3,1,14942,14976,9
Task 14943,Job 0,4,4,4,9,0,8,13,5,4,3,0,14943,14977,13
Task 14943,Job 1,9,8,2,11,0,11,20,9,2,4,1,14943,14977,6
Task 14944,Job 0,4,5,1,8,1,5,12,7,1,2,2,14944,14978,17
Task 14944,Job 1,9,4,1,11,1,10,20,10,1,2,0,14944,14978,2
Task 14945,Job 0,6,9,3,7,1,9,13,4,3,4,1,14945,14978,6
Task 14945,Job 1,11,8,1,12,1,12,23,11,1,3,0,14945,14978,19
Task 14946,Job 0,7,9,2,12,0,9,19,10,2,2,1,14946,14980,12
Task 14946,Job 1,12,5,1,12,0,13,24,11,1,4,0,14946,14980,4
Task 14947,Job 0,10,6,3,9,0,13,19,6,3,4,0,14947,14980,11
Task 14947,Job 1,15,5,4,12,0,19,27,8,4,2,0,14947,14980,8
Task 14948,Job 0,6,8,1,6,1,7,12,5,1,3,2,14948,14981,8
Task 14948,Job 1,11,4,3,11,0,14,22,8,3,3,2,14948,14981,11
Task 14949,Job 0,10,6,2,12,1,12,22,10,2,3,0,14949,14982,13
Task 14949,Job 1,15,8,4,6,0,19,21,2,4,3,2,14949,14982,12
Task 14950,Job 0,3,8,2,11,0,5,14,9,2,1,2,14950,14984,12
Task 14950,Job 1,8,5,3,10,1,11,18,7,3,3,0,14950,14984,12
Task 14951,Job 0,3,7,3,12,1,6,15,9,3,4,1,14951,14985,12
Task 14951,Job 1,8,6,1,11,1,9,19,10,1,3,1,14951,14985,12
Task 14952,Job 0,10,7,4,6,0,14,16,2,4,1,0,14952,14986,6
Task 14952,Job 1,15,4,4,9,1,19,24,5,4,4,1,14952,14986,13
Task 14953,Job 0,7,8,1,12,0,8,19,11,1,3,2,14953,14986,20
Task 14953,Job 1,12,7,3,6,1,15,18,3,3,3,2,14953,14986,7
Task 14954,Job 0,5,10,4,6,0,9,11,2,4,4,2,14954,14987,13
Task 14954,Job 1,10,10,4,7,0,14,17,3,4,4,1,14954,14987,3
Task 14955,Job 0,9,4,3,8,0,12,17,5,3,2,0,14955,14988,8
Task 14955,Job 1,14,8,2,6,0,16,20,4,2,3,2,14955,14988,3
Task 14956,Job 0,3,10,4,11,0,7,14,7,4,3,1,14956,14989,9
Task 14956,Job 1,8,6,1,11,0,9,19,10,1,3,0,14956,14989,12
Task 14957,Job 0,1,6,4,9,0,5,10,5,4,1,1,14957,14990,4
Task 14957,Job 1,6,9,1,12,0,7,18,11,1,2,2,14957,14990,4
Task 14958,Job 0,1,8,3,11,0,4,12,8,3,4,0,14958,14991,10
Task 14958,Job 1,6,5,2,12,1,8,18,10,2,1,0,14958,14991,10
Task 14959,Job 0,6,4,3,10,0,9,16,7,3,2,0,14959,14993,14
Task 14959,Job 1,11,7,2,9,1,13,20,7,2,1,0,14959,14993,3
Task 14960,Job 0,10,4,2,11,0,12,21,9,2,4,1,14960,14994,7
Task 14960,Job 1,15,5,4,8,0,19,23,4,4,3,0,14960,14994,11
Task 14961,Job 0,9,5,4,8,1,13,17,4,4,2,1,14961,14995,11
Task 14961,Job 1,14,4,4,9,1,18,23,5,4,4,2,14961,14995,16
Task 14962,Job 0,8,10,1,9,1,9,17,8,1,4,1,14962,14995,2
Task 14962,Job 1,13,6,2,9,1,15,22,7,2,4,2,14962,14995,17
Task 14963,Job 0,9,5,1,11,0,10,20,10,1,2,2,14963,14997,15
Task 14963,Job 1,14,8,2,12,0,16,26,10,2,4,0,14963,14997,14
Task 14964,Job 0,7,5,3,9,0,10,16,6,3,1,0,14964,14998,15
Task 14964,Job 1,12,9,1,7,0,13,19,6,1,3,2,14964,14998,16
Task 14965,Job 0,7,6,2,10,0,9,17,8,2,2,1,14965,14998,3
Task 14965,Job 1,12,9,1,11,0,13,23,10,1,3,2,14965,14998,4
Task 14966,Job 0,8,9,4,9,0,12,17,5,4,3,2,14966,14999,8
Task 14966,Job 1,13,5,2,7,1,15,20,5,2,2,0,14966,14999,12
Task 14967,Job 0,6,8,1,7,1,7,13,6,1,3,1,14967,15000,13
Task 14967,Job 1,11,8,4,8,0,15,19,4,4,4,2,14967,15000,14
Task 14968,Job 0,3,9,3,8,0,6,11,5,3,4,0,14968,15001,13
Task 14968,Job 1,8,6,4,11,0,12,19,7,4,1,0,14968,15001,3
Task 14969,Job 0,1,8,4,10,1,5,11,6,4,2,0,14969,15003,16
Task 14969,Job 1,6,9,4,9,1,10,15,5,4,4,2,14969,15003,17
Task 14970,Job 0,4,10,4,9,1,8,13,5,4,1,1,14970,15004,7
Task 14970,Job 1,9,4,3,7,0,12,16,4,3,2,2,14970,15004,17
Task 14971,Job 0,2,9,4,9,0,6,11,5,4,3,0,14971,15004,6
Task 14971,Job 1,7,10,3,6,0,10,13,3,3,3,2,14971,15004,20
Task 14972,Job 0,6,8,1,11,0,7,17,10,1,3,2,14972,15006,5
Task 14972,Job 1,11,7,3,12,0,14,23,9,3,1,2,14972,15006,19
Task 14973,Job 0,2,6,4,11,1,6,13,7,4,3,2,14973,15007,17
Task 14973,Job 1,7,10,1,6,0,8,13,5,1,3,2,14973,15007,7
Task 14974,Job 0,4,7,4,8,0,8,12,4,4,3,2,14974,15007,12
Task 14974,Job 1,9,5,4,12,0,13,21,8,4,2,0,14974,15007,4
Task 14975,Job 0,10,10,3,10,0,13,20,7,3,1,1,14975,15009,17
Task 14975,Job 1,15,9,4,10,1,19,25,6,4,2,2,14975,15009,20
Task 14976,Job 0,4,8,2,8,0,6,12,6,2,1,2,14976,15009,20
Task 14976,Job 1,9,10,3,7,0,12,16,4,3,4,1,14976,15009,20
Task 14977,Job 0,10,6,2,8,1,12,18,6,2,1,0,14977,15011,17
Task 14977,Job 1,15,4,2,12,0,17,27,10,2,3,0,14977,15011,10
Task 14978,Job 0,4,10,3,12,0,7,16,9,3,1,1,14978,15011,17
Task 14978,Job 1,9,9,3,8,0,12,17,5,3,4,2,14978,15011,16
Task 14979,Job 0,10,9,2,12,0,12,22,10,2,1,0,14979,15012,15
Task 14979,Job 1,15,6,2,9,1,17,24,7,2,2,2,14979,15012,10
Task 14980,Job 0,6,8,3,11,0,9,17,8,3,4,0,14980,15013,14
Task 14980,Job 1,11,8,3,9,1,14,20,6,3,2,0,14980,15013,9
Task 14981,Job 0,5,8,1,6,0,6,11,5,1,2,0,14981,15014,18
Task 14981,Job 1,10,10,1,12,1,11,22,11,1,3,1,14981,15014,3
Task 14982,Job 0,10,8,4,10,0,14,20,6,4,2,1,14982,15016,4
Task 14982,Job 1,15,10,4,11,1,19,26,7,4,1,1,14982,15016,19
Task 14983,Job 0,5,7,2,11,0,7,16,9,2,2,1,14983,15017,6
Task 14983,Job 1,10,7,1,9,0,11,19,8,1,3,1,14983,15017,10
Task 14984,Job 0,10,10,3,12,0,13,22,9,3,2,0,14984,15018,16
Task 14984,Job 1,15,5,4,8,1,19,23,4,4,1,2,14984,15018,10
Task 14985,Job 0,1,7,4,9,1,5,10,5,4,2,1,14985,15019,18
Task 14985,Job 1,6,9,4,11,0,10,17,7,4,4,1,14985,15019,9
Task 14986,Job 0,7,8,1,6,0,8,13,5,1,1,2,14986,15020,8
Task 14986,Job 1,12,9,3,11,0,15,23,8,3,1,0,14986,15020,9
Task 14987,Job 0,10,10,2,12,0,12,22,10,2,4,1,14987,15020,7
Task 14987,Job 1,15,9,1,9,0,16,24,8,1,2,1,14987,15020,16
Task 14988,Job 0,1,8,2,12,1,3,13,10,2,1,2,14988,15021,4
Task 14988,Job 1,6,9,3,11,0,9,17,8,3,1,1,14988,15021,2
Task 14989,Job 0,2,8,4,8,1,6,10,4,4,3,2,14989,15022,14
Task 14989,Job 1,7,9,4,9,0,11,16,5,4,2,0,14989,15022,14
Task 14990,Job 0,2,10,2,10,0,4,12,8,2,4,2,14990,15024,9
Task 14990,Job 1,7,6,4,7,0,11,14,3,4,3,2,14990,15024,18
Task 14991,Job 0,7,9,4,7,0,11,14,3,4,3,1,14991,15024,14
Task 14991,Job 1,12,7,4,6,0,16,18,2,4,3,0,14991,15024,10
Task 14992,Job 0,2,7,4,6,1,6,8,2,4,4,0,14992,15026,8
Task 14992,Job 1,7,10,1,9,0,8,16,8,1,4,0,14992,15026,16
Task 14993,Job 0,6,10,2,7,0,8,13,5,2,3,0,14993,15026,20
Task 14993,Job 1,11,7,2,9,0,13,20,7,2,1,2,14993,15026,18
Task 14994,Job 0,2,8,1,6,0,3,8,5,1,4,1,14994,15028,9
Task 14994,Job 1,7,4,1,7,0,8,14,6,1,4,1,14994,15028,6
Task 14995,Job 0,2,6,4,8,0,6,10,4,4,1,0,14995,15029,17
Task 14995,Job 1,7,6,1,6,1,8,13,5,1,3,0,14995,15029,20
Task 14996,Job 0,9,7,4,6,0,13,15,2,4,4,0,14996,15030,5
Task 14996,Job 1,14,5,3,12,1,17,26,9,3,1,2,14996,15030,7
Task 14997,Job 0,8,5,2,9,0,10,17,7,2,2,2,14997,15030,4
Task 14997,Job 1,13,10,3,8,0,16,21,5,3,3,2,14997,15030,5
Task 14998,Job 0,9,10,2,9,0,11,18,7,2,1,1,14998,15031,3
Task 14998,Job 1,14,5,1,12,0,15,26,11,1,1,1,14998,15031,8
Task 14999,Job 0,3,5,2,8,1,5,11,6,2,3,1,14999,15033,4
Task 14999,Job 1,8,8,2,11,1,10,19,9,2,2,2,14999,15033,8
Task 15000,Job 0,1,4,2,7,0,3,8,5,2,1,1,15000,15034,2
Task 15000,Job 1,6,5,3,7,0,9,13,4,3,4,2,15000,15034,15
